1700: 0130 { 180 3 ---  186 3 ---  183 3 ---  186 3 xy- }
1701: 0130 { 183 3 x--  186 3 -y-  180 3 x--  186 3 x-- }
1702: 0130 { 180 3 ---  186 3 ---  183 3 ---  193 3 --- }
1703: 0130 { 183 3 x--  193 3 x--  180 3 x--  186 3 x-- }
1704: 0130 { 180 3 ---  190 3 ---  186 3 ---  186 3 xy- }
1705: 0130 { 186 3 x--  186 3 -y-  180 3 x--  190 3 x-- }
1706: 0130 { 180 3 ---  186 3 ---  180 3 x--  186 3 x-- }
1707: 0130 { 180 3 ---  180 3 -y-  183 3 ---  182 3 -y- }
1708: 0130 { 183 3 ---  182 3 -y-  182 3 ---  183 3 -y- }
1709: 0130 { 183 3 x--  182 3 xy-  180 3 x--  180 3 xy- }
170A: 0130 { 004 3 ---  004 3 ---  004 3 ---  004 3 --- }
170B: 0130 { 186 3 ---  192 3 -y-  186 3 x--  193 3 -y- }
170C: 0130 { 004 3 ---  004 3 ---  004 3 ---  004 3 --- }
170D: 0130 { 004 3 ---  004 3 ---  004 3 ---  004 3 --- }
170E: 0130 { 004 3 ---  004 3 ---  004 3 ---  004 3 --- }
170F: 0130 { 004 3 ---  004 3 ---  004 3 ---  004 3 --- }
1710: 0130 { 186 3 -y-  180 3 -y-  186 3 x--  183 3 -y- }
1711: 0130 { 186 3 ---  183 3 xy-  186 3 xy-  180 3 xy- }
1712: 0130 { 186 3 -y-  180 3 -y-  193 3 -y-  183 3 -y- }
1713: 0130 { 193 3 xy-  183 3 xy-  186 3 xy-  180 3 xy- }
1714: 0130 { 190 3 -y-  180 3 -y-  186 3 x--  186 3 -y- }
1715: 0130 { 186 3 ---  186 3 xy-  190 3 xy-  180 3 xy- }
1716: 0130 { 186 3 -y-  180 3 -y-  186 3 xy-  180 3 xy- }
1717: 0130 { 180 3 ---  180 3 -y-  186 3 ---  186 3 -y- }
1718: 0130 { 186 3 x--  186 3 xy-  180 3 x--  180 3 xy- }
1719: 0130 { 180 3 ---  190 3 ---  180 3 x--  190 3 x-- }
171A: 0130 { 004 3 ---  004 3 ---  004 3 ---  004 3 --- }
171B: 0130 { 004 3 ---  004 3 ---  004 3 ---  004 3 --- }
171C: 0130 { 004 3 ---  004 3 ---  004 3 ---  004 3 --- }
171D: 002B { 06C 3 ---  06E 3 ---  06D 3 ---  06F 3 --- }
171E: 0130 { 06C 3 ---  06E 3 ---  06D 3 ---  06F 3 --- }
171F: 0130 { 004 3 ---  004 3 ---  004 3 ---  004 3 --- }
1720: 0130 { 060 6 ---  182 3 ---  061 6 ---  183 3 --- }
1721: 0130 { 030 4 ---  182 3 ---  031 4 ---  183 3 --- }
1722: 0130 { 180 3 ---  190 3 ---  186 3 ---  193 3 --- }
1723: 0130 { 186 3 x--  193 3 x--  180 3 x--  190 3 x-- }
1724: 0130 { 186 3 ---  186 3 -y-  186 3 x--  186 3 xy- }
1725: 0130 { 182 3 ---  186 3 -y-  183 3 ---  186 3 xy- }
1726: 0130 { 186 3 ---  186 3 -y-  190 3 x--  190 3 x-- }
1727: 0130 { 182 3 ---  192 3 ---  183 3 ---  186 3 xy- }
1728: 0130 { 182 3 ---  186 3 -y-  183 3 ---  193 3 --- }
1729: 0130 { 190 3 ---  190 3 ---  190 3 x--  190 3 xy- }
172A: 0130 { 004 3 ---  004 3 ---  004 3 ---  004 3 --- }
172B: 0130 { 004 3 ---  004 3 ---  004 3 ---  004 3 --- }
172C: 0130 { 004 3 ---  004 3 ---  004 3 ---  004 3 --- }
172D: 0130 { 004 3 ---  004 3 ---  004 3 ---  004 3 --- }
172E: 0130 { 004 3 ---  004 3 ---  004 3 ---  004 3 --- }
172F: 0130 { 004 3 ---  004 3 ---  004 3 ---  004 3 --- }
1730: 0130 { 058 6 ---  182 3 ---  059 6 ---  183 3 --- }
1731: 0130 { 068 6 ---  182 3 ---  069 6 ---  183 3 --- }
1732: 0130 { 190 3 -y-  180 3 -y-  193 3 -y-  186 3 -y- }
1733: 0130 { 193 3 xy-  186 3 xy-  190 3 xy-  180 3 xy- }
1734: 0130 { 186 3 ---  182 3 -y-  186 3 x--  183 3 -y- }
1735: 0130 { 186 3 xy-  186 3 x--  186 3 -y-  186 3 --- }
1736: 0130 { 190 3 ---  190 3 ---  186 3 x--  186 3 xy- }
1737: 0130 { 192 3 -y-  182 3 -y-  186 3 x--  183 3 -y- }
1738: 0130 { 186 3 ---  182 3 -y-  193 3 -y-  183 3 -y- }
1739: 0130 { 190 3 -y-  180 3 -y-  190 3 xy-  180 3 xy- }
173A: 0130 { 191 3 ---  190 3 ---  191 3 x--  190 3 x-- }
173B: 0159 { 1DE 3 -y-  1CE 3 -y-  1DE 3 -y-  1CE 3 -y- }
173C: 0130 { 004 3 ---  004 3 ---  004 3 ---  004 3 --- }
173D: 0130 { 190 3 ---  190 3 ---  190 3 x--  190 3 x-- }
173E: 0130 { 004 3 ---  004 3 ---  004 3 ---  004 3 --- }
173F: 0130 { 004 3 ---  004 3 ---  004 3 ---  004 3 --- }
1740: 01EC { 192 3 -y-  186 3 -y-  193 3 -y-  195 3 -y- }
1741: 01ED { 192 3 -y-  194 3 -y-  193 3 -y-  186 3 xy- }
1742: 01EE { 192 3 -y-  18C 3 -y-  193 3 -y-  1B3 3 -y- }
1743: 0044 { 194 3 ---  192 3 ---  195 3 ---  193 3 --- }
1744: 0044 { 192 3 -y-  194 3 -y-  193 3 -y-  195 3 -y- }
1745: 01EF { 192 3 -y-  1B3 3 xy-  193 3 -y-  18C 3 xy- }
1746: 0130 { 190 3 ---  190 3 ---  193 3 -y-  186 3 xy- }
1747: 0130 { 192 3 -y-  186 3 -y-  190 3 x--  190 3 x-- }
1748: 0130 { 180 3 ---  190 3 ---  183 3 ---  186 3 xy- }
1749: 0130 { 182 3 ---  186 3 -y-  180 3 x--  190 3 x-- }
174A: 0130 { 190 3 ---  190 3 ---  190 3 x--  190 3 xy- }
174B: 0130 { 004 3 ---  004 3 ---  004 3 ---  004 3 --- }
174C: 0130 { 004 3 ---  004 3 ---  004 3 ---  004 3 --- }
174D: 0142 { 03A 3 -y-  02A 3 -y-  03B 3 -y-  02B 3 -y- }
174E: 0130 { 004 3 ---  004 3 ---  004 3 ---  004 3 --- }
174F: 0130 { 004 3 ---  004 3 ---  004 3 ---  004 3 --- }
1750: 01C4 { 196 3 -y-  0F8 3 ---  197 3 -y-  187 3 -y- }
1751: 01C5 { 197 3 xy-  187 3 xy-  196 3 xy-  0F8 3 --- }
1752: 01C6 { 19B 3 -y-  0F8 3 ---  19C 3 -y-  0F8 3 --- }
1753: 01C7 { 19D 3 -y-  19B 3 -y-  19E 3 -y-  18E 3 -y- }
1754: 01C8 { 19E 3 xy-  18E 3 xy-  19D 3 xy-  19B 3 xy- }
1755: 01C9 { 19C 3 xy-  0F8 3 ---  19B 3 xy-  0F8 3 --- }
1756: 0130 { 190 3 -y-  190 3 ---  186 3 x--  193 3 -y- }
1757: 0130 { 186 3 ---  192 3 -y-  190 3 xy-  190 3 x-- }
1758: 0130 { 190 3 -y-  180 3 -y-  186 3 x--  183 3 -y- }
1759: 0130 { 186 3 ---  182 3 -y-  190 3 xy-  180 3 xy- }
175A: 0130 { 190 3 -y-  191 3 -y-  190 3 xy-  191 3 xy- }
175B: 0130 { 004 3 ---  004 3 ---  004 3 ---  004 3 --- }
175C: 0130 { 194 3 ---  192 3 ---  186 3 x--  186 3 xy- }
175D: 0130 { 190 3 ---  190 3 ---  186 3 x--  186 3 xy- }
175E: 0130 { 186 3 ---  186 3 -y-  190 3 x--  190 3 xy- }
175F: 0130 { 004 3 ---  004 3 ---  004 3 ---  004 3 --- }
1760: 0145 { 180 3 ---  190 3 ---  183 3 ---  193 3 --- }
1761: 0146 { 191 3 ---  190 3 ---  183 3 ---  193 3 --- }
1762: 0147 { 1D7 3 ---  190 3 ---  183 3 ---  193 3 --- }
1763: 0148 { 182 3 ---  192 3 ---  180 3 x--  190 3 x-- }
1764: 0149 { 182 3 ---  192 3 ---  191 3 x--  190 3 x-- }
1765: 014A { 182 3 ---  192 3 ---  1D7 3 x--  190 3 x-- }
1766: 014B { 184 3 ---  190 3 ---  195 3 ---  193 3 --- }
1767: 014C { 194 3 ---  192 3 ---  184 3 x--  190 3 x-- }
1768: 014D { 190 3 -y-  180 3 -y-  193 3 -y-  183 3 -y- }
1769: 014E { 192 3 -y-  182 3 -y-  193 3 -y-  183 3 -y- }
176A: 014F { 192 3 -y-  182 3 -y-  190 3 xy-  180 3 xy- }
176B: 0130 { 004 3 ---  004 3 ---  004 3 ---  004 3 --- }
176C: 0130 { 004 3 ---  004 3 ---  004 3 ---  004 3 --- }
176D: 0130 { 004 3 ---  004 3 ---  004 3 ---  004 3 --- }
176E: 0130 { 004 3 ---  004 3 ---  004 3 ---  004 3 --- }
176F: 0130 { 004 3 ---  004 3 ---  004 3 ---  004 3 --- }
1770: 0145 { 180 3 ---  180 3 -y-  180 3 x--  180 3 xy- }
1771: 0148 { 182 3 ---  192 3 ---  180 3 x--  190 3 x-- }
1772: 0130 { 004 3 ---  004 3 ---  004 3 ---  004 3 --- }
1773: 0130 { 004 3 ---  004 3 ---  004 3 ---  004 3 --- }
1774: 0130 { 004 3 ---  004 3 ---  004 3 ---  004 3 --- }
1775: 0130 { 004 3 ---  004 3 ---  004 3 ---  004 3 --- }
1776: 0153 { 1F4 6 ---  1F6 6 ---  1F5 6 ---  1F7 6 --- }
1777: 0154 { 1F8 6 ---  1F8 6 ---  1F9 6 ---  1F9 6 --- }
1778: 0155 { 1F6 6 -y-  1F4 6 -y-  1F7 6 -y-  1F5 6 -y- }
1779: 0130 { 004 3 ---  004 3 ---  004 3 ---  004 3 --- }
177A: 0130 { 004 3 ---  004 3 ---  004 3 ---  004 3 --- }
177B: 0130 { 004 3 ---  004 3 ---  004 3 ---  004 3 --- }
177C: 0130 { 004 3 ---  004 3 ---  004 3 ---  004 3 --- }
177D: 0130 { 180 3 ---  190 3 ---  180 3 x--  190 3 xy- }
177E: 0130 { 004 4 ---  004 4 ---  004 3 ---  004 3 --- }
177F: 0130 { 004 3 ---  004 3 ---  004 3 ---  004 3 --- }
1780: 0130 { 004 3 ---  004 3 ---  004 3 ---  004 3 --- }
1781: 0130 { 004 3 ---  004 3 ---  004 3 ---  004 3 --- }
1782: 0130 { 004 3 ---  004 3 ---  004 3 ---  004 3 --- }
1783: 0141 { 00A 3 ---  01A 3 ---  00A 3 x--  01A 3 x-- }
1784: 0142 { 02A 3 ---  03A 3 ---  02B 3 ---  03B 3 --- }
1785: 0143 { 083 3 ---  083 3 ---  084 3 ---  084 3 --- }
1786: 0130 { 004 3 ---  004 3 ---  004 3 ---  004 3 --- }
1787: 0130 { 004 3 ---  004 3 ---  004 3 ---  004 3 --- }
1788: 0130 { 004 3 ---  004 3 ---  004 3 ---  004 3 --- }
1789: 0130 { 004 3 ---  004 3 ---  004 3 ---  004 3 --- }
178A: 0130 { 191 3 ---  190 3 ---  183 3 ---  186 3 xy- }
178B: 0130 { 183 3 ---  186 3 -y-  191 3 x--  190 3 x-- }
178C: 0130 { 004 3 ---  004 3 ---  004 3 ---  004 3 --- }
178D: 0130 { 186 3 ---  192 3 -y-  190 3 xy-  190 3 xy- }
178E: 0130 { 004 4 ---  004 4 ---  004 3 ---  004 3 --- }
178F: 0130 { 004 3 ---  004 3 ---  004 3 ---  004 3 --- }
1790: 0130 { 004 3 ---  004 3 ---  004 3 ---  004 3 --- }
1791: 0130 { 004 3 ---  004 3 ---  004 3 ---  004 3 --- }
1792: 0130 { 004 3 ---  004 3 ---  004 3 ---  004 3 --- }
1793: 0130 { 004 3 ---  004 3 ---  004 3 ---  004 3 --- }
1794: 0130 { 004 3 ---  004 3 ---  004 3 ---  004 3 --- }
1795: 0130 { 004 3 ---  004 3 ---  004 3 ---  004 3 --- }
1796: 0130 { 004 3 ---  004 3 ---  004 3 ---  004 3 --- }
1797: 0130 { 004 3 ---  004 3 ---  004 3 ---  004 3 --- }
1798: 0130 { 004 3 ---  004 3 ---  004 3 ---  004 3 --- }
1799: 0130 { 004 3 ---  004 3 ---  004 3 ---  004 3 --- }
179A: 0130 { 190 3 -y-  191 3 -y-  186 3 x--  183 3 -y- }
179B: 0130 { 186 3 ---  183 3 -y-  190 3 xy-  191 3 xy- }
179C: 0130 { 004 3 ---  004 3 ---  004 3 ---  004 3 --- }
179D: 0130 { 004 3 ---  004 3 ---  004 3 ---  004 3 --- }
179E: 0130 { 004 3 ---  004 3 ---  004 3 ---  004 3 --- }
179F: 0130 { 004 3 ---  004 3 ---  004 3 ---  004 3 --- }
17A0: 0002 { 070 6 ---  072 6 ---  071 6 ---  073 6 --- }
17A1: 0002 { 0FD 6 ---  0FD 6 ---  0FD 6 ---  0FD 6 --- }
17A2: ~
17A3: ~
17A4: ~
17A5: ~
17A6: 0133 { 000 1 ---  010 1 ---  001 1 ---  011 1 --- }
17A7: 0134 { 002 1 ---  012 1 ---  003 1 ---  013 1 --- }
17A8: 0130 { 006 6 ---  016 6 ---  007 6 ---  017 6 --- }
17A9: 0137 { 000 6 ---  010 6 ---  001 6 ---  011 6 --- }
17AA: 0138 { 002 6 ---  012 6 ---  003 6 ---  013 6 --- }
17AB: 0135 { 020 7 ---  020 7 ---  021 7 ---  021 7 --- }
17AC: 0136 { 022 7 ---  022 7 ---  023 7 ---  023 7 --- }
17AD: 0135 { 020 6 ---  020 6 ---  021 6 ---  021 6 --- }
17AE: 0136 { 022 6 ---  022 6 ---  023 6 ---  023 6 --- }
17AF: ~
17B0: 011C { 006 6 ---  016 6 ---  007 6 ---  017 6 --- }
17B1: 0123 { 006 6 ---  016 6 ---  007 6 ---  017 6 --- }
17B2: 016B { 006 6 ---  016 6 ---  007 6 ---  017 6 --- }
17B3: 011F { 006 6 ---  016 6 ---  007 6 ---  017 6 --- }
17B4: 011A { 006 6 ---  016 6 ---  007 6 ---  017 6 --- }
17B5: ~
17B6: 0135 { 020 1 ---  020 1 ---  021 1 ---  021 1 --- }
17B7: 0136 { 022 1 ---  022 1 ---  023 1 ---  023 1 --- }
17B8: ~
17B9: ~
17BA: ~
17BB: ~
17BC: ~
17BD: ~
17BE: ~
17BF: ~
17C0: 0100 { 182 3 ---  192 3 ---  183 3 ---  193 3 --- }
17C1: 01AF { 187 3 x--  197 3 x--  0F8 3 ---  196 3 x-- }
17C2: ~
17C3: ~
17C4: ~
17C5: ~
17C6: 01AA { 0F8 3 ---  196 3 ---  187 3 ---  197 3 --- }
17C7: 01A0 { 18E 3 x--  19E 3 x--  19B 3 x--  19D 3 x-- }
17C8: 01A5 { 0F8 3 ---  19C 3 x--  0F8 3 ---  19B 3 x-- }
17C9: ~
17CA: ~
17CB: ~
17CC: ~
17CD: 0196 { 0F8 3 ---  19B 3 ---  0F8 3 ---  19C 3 --- }
17CE: 019B { 19B 3 ---  19D 3 ---  18E 3 ---  19E 3 --- }
17CF: ~
17D0: 0044 { 192 3 -y-  194 3 -y-  193 3 -y-  195 3 -y- }
17D1: 01E4 { 194 3 ---  192 3 ---  186 3 x--  193 3 --- }
17D2: 01AF { 187 3 x--  197 3 x--  0F8 3 ---  196 3 x-- }
17D3: ~
17D4: ~
17D5: 01AA { 0F8 3 ---  196 3 ---  187 3 ---  197 3 --- }
17D6: 01E2 { 186 3 ---  192 3 ---  195 3 ---  193 3 --- }
17D7: 0044 { 192 3 -y-  194 3 -y-  193 3 -y-  195 3 -y- }
17D8: 01E0 { 1B3 3 x--  192 3 ---  18C 3 x--  193 3 --- }
17D9: 01A0 { 18E 3 x--  19E 3 x--  19B 3 x--  19D 3 x-- }
17DA: 01A5 { 0F8 3 ---  19C 3 x--  0F8 3 ---  19B 3 x-- }
17DB: 0196 { 0F8 3 ---  19B 3 ---  0F8 3 ---  19C 3 --- }
17DC: 019B { 19B 3 ---  19D 3 ---  18E 3 ---  19E 3 --- }
17DD: 01DE { 18C 3 ---  192 3 ---  1B3 3 ---  193 3 --- }
17DE: 01E6 { 194 3 ---  192 3 ---  195 3 ---  193 3 --- }
17DF: ~
17E0: 0044 { 192 3 -y-  194 3 -y-  193 3 -y-  195 3 -y- }
17E1: 0044 { 192 3 -y-  194 3 -y-  193 3 -y-  195 3 -y- }
17E2: 01E4 { 194 3 ---  192 3 ---  186 3 x--  193 3 --- }
17E3: 01AF { 187 3 x--  197 3 x--  0F8 3 ---  196 3 x-- }
17E4: 01AA { 0F8 3 ---  196 3 ---  187 3 ---  197 3 --- }
17E5: 01E2 { 186 3 ---  192 3 ---  195 3 ---  193 3 --- }
17E6: 0044 { 192 3 -y-  194 3 -y-  193 3 -y-  195 3 -y- }
17E7: 0044 { 192 3 -y-  194 3 -y-  193 3 -y-  195 3 -y- }
17E8: 0044 { 192 3 -y-  194 3 -y-  193 3 -y-  195 3 -y- }
17E9: 0044 { 192 3 -y-  194 3 -y-  193 3 -y-  195 3 -y- }
17EA: 01E0 { 1B3 3 x--  192 3 ---  18C 3 x--  193 3 --- }
17EB: 01DE { 18C 3 ---  192 3 ---  1B3 3 ---  193 3 --- }
17EC: 01E6 { 194 3 ---  192 3 ---  195 3 ---  193 3 --- }
17ED: 0044 { 192 3 -y-  194 3 -y-  193 3 -y-  195 3 -y- }
17EE: 0044 { 192 3 -y-  194 3 -y-  193 3 -y-  195 3 -y- }
17EF: ~
17F0: 0044 { 192 3 -y-  194 3 -y-  193 3 -y-  195 3 -y- }
17F1: 0044 { 192 3 -y-  194 3 -y-  193 3 -y-  195 3 -y- }
17F2: 0044 { 192 3 -y-  194 3 -y-  193 3 -y-  195 3 -y- }
17F3: 01E4 { 194 3 ---  192 3 ---  186 3 x--  193 3 --- }
17F4: 01E2 { 186 3 ---  192 3 ---  195 3 ---  193 3 --- }
17F5: 0044 { 192 3 -y-  194 3 -y-  193 3 -y-  195 3 -y- }
17F6: 0044 { 192 3 -y-  194 3 -y-  193 3 -y-  195 3 -y- }
17F7: 0044 { 192 3 -y-  194 3 -y-  193 3 -y-  195 3 -y- }
17F8: 0044 { 192 3 -y-  194 3 -y-  193 3 -y-  195 3 -y- }
17F9: 0044 { 192 3 -y-  194 3 -y-  193 3 -y-  195 3 -y- }
17FA: 0044 { 192 3 -y-  194 3 -y-  193 3 -y-  195 3 -y- }
17FB: 0044 { 192 3 -y-  194 3 -y-  193 3 -y-  195 3 -y- }
17FC: 0044 { 192 3 -y-  194 3 -y-  193 3 -y-  195 3 -y- }
17FD: 0044 { 192 3 -y-  194 3 -y-  193 3 -y-  195 3 -y- }
17FE: 0044 { 192 3 -y-  194 3 -y-  193 3 -y-  195 3 -y- }
17FF: ~
