2900: 0130 { 1C8 4 ---  1D8 4 ---  1C9 4 ---  1D9 4 --- }
2901: 0049 { 0A0 1 --p  0A0 1 --p  0A0 1 --p  0A0 1 --p }
2902: 0049 { 0FA 1 ---  0FA 1 ---  0FA 1 ---  0FA 1 --- }
2903: 0049 { 0A0 1 --p  07F 1 --p  0A0 1 --p  0A0 1 --p }
2904: 0049 { 0A0 1 --p  0A0 1 -yp  0A0 1 x-p  0A0 1 xyp }
2905: 0049 { 0A0 1 --p  0A2 1 --p  0A2 1 --p  0A0 1 --p }
2906: 0049 { 0A3 1 --p  0A2 1 --p  0A2 1 --p  0A3 1 --p }
2907: 01E4 { 192 2 -y-  194 2 -y-  193 2 -y-  186 2 xy- }
2908: 01E4 { 193 2 xy-  186 2 -y-  192 2 xy-  194 2 xy- }
2909: 0049 { 0A0 3 --p  0A2 3 --p  0A2 3 --p  0A0 3 --p }
290A: 0049 { 0A0 3 --p  07F 3 --p  0A2 3 --p  0A0 3 --p }
290B: 0049 { 0A2 3 x-p  0A0 3 x-p  0A0 3 x-p  07F 3 x-p }
290C: ~
290D: ~
290E: ~
290F: ~
2910: 0049 { 087 5 ---  123 6 ---  088 5 ---  123 6 x-- }
2911: ~
2912: ~
2913: ~
2914: ~
2915: ~
2916: 0049 { 0A0 1 --p  07F 1 --p  0A2 1 --p  0A0 1 --p }
2917: 0049 { 0A0 1 --p  0A0 1 --p  0A0 1 --p  0A0 1 x-p }
2918: 0049 { 0A0 1 --p  0A0 1 --p  0A0 1 --p  0A0 1 -yp }
2919: 01E3 { 1D0 2 -y-  18B 2 -y-  193 2 -y-  195 2 x-- }
291A: 0049 { 07F 3 -yp  0A0 3 -yp  0A0 3 -yp  0A2 3 -yp }
291B: 0049 { 0A0 3 xyp  0A2 3 xyp  07F 3 xyp  0A0 3 xyp }
291C: ~
291D: ~
291E: ~
291F: ~
2920: 0049 { 04C 6 ---  04E 6 ---  04C 6 x--  04E 6 x-- }
2921: 0100 { 155 5 ---  147 5 ---  156 5 ---  156 5 -y- }
2922: 0100 { 156 5 x--  156 5 xy-  155 5 x--  147 5 x-- }
2923: 0100 { 156 5 x--  156 5 xy-  156 5 x--  156 5 -y- }
2924: 0100 { 100 5 ---  111 5 ---  156 5 ---  156 5 -y- }
2925: 0100 { 156 5 x--  156 5 xy-  100 5 x--  111 5 x-- }
2926: 0049 { 0A0 1 --p  0A2 1 --p  07F 1 --p  0A0 1 --p }
2927: 0139 { 000 5 ---  010 5 ---  001 5 ---  011 5 --- }
2928: 013A { 002 5 ---  012 5 ---  003 5 ---  013 5 --- }
2929: ~
292A: ~
292B: ~
292C: ~
292D: ~
292E: ~
292F: ~
2930: 0049 { 123 6 -y-  07E 6 xy-  123 6 xy-  07E 6 xy- }
2931: 0049 { 145 7 ---  145 7 ---  145 7 xy-  145 7 x-- }
2932: 0049 { 146 7 ---  146 7 ---  146 7 ---  146 7 --- }
2933: 0049 { 145 7 ---  145 7 ---  146 7 ---  146 7 --- }
2934: 0049 { 146 7 x--  146 7 x--  145 7 x--  145 7 x-- }
2935: 0000 { 070 1 ---  072 1 ---  071 1 ---  073 1 --- }
2936: 0146 { 190 2 -y-  191 2 -y-  193 2 -y-  183 2 -y- }
2937: 0146 { 193 2 xy-  183 2 xy-  190 2 xy-  191 2 xy- }
2938: 0049 { 1D1 2 xy-  07E 2 ---  1D1 2 -y-  07E 2 --- }
2939: 0049 { 07E 2 xy-  1D1 2 x--  07E 2 xy-  1D1 2 --- }
293A: 0025 { 083 4 -y-  083 4 ---  083 4 xy-  083 4 x-- }
293B: 0025 { 083 4 -y-  083 4 ---  083 4 xy-  083 4 x-- }
293C: 0029 { 02D 4 ---  02D 4 -y-  02D 4 x--  02D 4 xy- }
293D: ~
293E: ~
293F: ~
2940: 0049 { 123 6 -y-  07E 6 xy-  123 6 xy-  07E 6 xy- }
2941: 0049 { 07E 1 ---  123 6 ---  07E 1 x--  123 6 x-- }
2942: 002B { 02D 4 ---  02D 4 -y-  02D 4 x--  02D 4 xy- }
2943: 0049 { 145 7 --p  145 7 --p  146 7 --p  146 7 --p }
2944: 0049 { 146 7 --p  146 7 --p  146 7 --p  146 7 --p }
2945: 0049 { 146 7 x-p  146 7 x-p  145 7 x-p  145 7 x-p }
2946: 0130 { 08E 1 ---  08E 1 -y-  08E 1 x--  08E 1 xy- }
2947: 0117 { 068 6 ---  068 6 -y-  068 6 x--  068 6 xy- }
2948: 0100 { 156 5 x-p  156 5 xyp  156 5 x-p  156 5 -yp }
2949: 0100 { 100 5 --p  111 5 --p  156 5 --p  156 5 -yp }
294A: 0100 { 156 5 x-p  156 5 xyp  100 5 x-p  111 5 x-p }
294B: ~
294C: ~
294D: ~
294E: ~
294F: ~
2950: 0049 { 156 5 -y-  07E 5 xy-  111 5 x--  07E 5 x-- }
2951: 0049 { 111 5 ---  07E 5 ---  156 5 xy-  07E 5 -y- }
2952: 0049 { 156 5 -y-  145 7 ---  156 5 xy-  145 7 xy- }
2953: 0000 { 145 7 --p  145 7 --p  146 7 --p  146 7 --p }
2954: 0000 { 146 7 --p  146 7 --p  146 7 --p  146 7 --p }
2955: 0000 { 146 7 x-p  146 7 x-p  145 7 x-p  145 7 x-p }
2956: 0130 { 08E 0 ---  08E 0 -y-  08E 0 x--  08E 0 xy- }
2957: 0132 { 058 6 ---  059 6 xy-  059 6 ---  059 6 -y- }
2958: 0029 { 08F 6 ---  08F 6 -y-  08F 6 x--  08F 6 xy- }
2959: ~
295A: ~
295B: ~
295C: ~
295D: ~
295E: ~
295F: ~
2960: 0100 { 182 3 ---  192 3 ---  183 3 ---  193 3 --- }
2961: 0101 { 181 3 ---  1D0 3 ---  183 3 ---  193 3 --- }
2962: 0102 { 18D 3 ---  1D0 3 ---  183 3 ---  193 3 --- }
2963: 0103 { 182 3 ---  192 3 ---  181 3 x--  1D0 3 x-- }
2964: 0104 { 182 3 ---  192 3 ---  18D 3 x--  1D0 3 x-- }
2965: 01F0 { 192 3 -y-  194 3 -y-  193 3 -y-  195 3 -y- }
2966: 01FA { 194 3 ---  1B0 3 -y-  1F3 3 x--  193 3 --- }
2967: ~
2968: ~
2969: ~
296A: ~
296B: ~
296C: ~
296D: ~
296E: ~
296F: ~
2970: 01E7 { 1C0 3 ---  1D0 3 ---  195 3 ---  193 3 --- }
2971: 01E8 { 194 3 ---  192 3 ---  1C0 3 x--  1D0 3 x-- }
2972: 0049 { 1D1 3 xy-  07E 3 ---  1D1 3 -y-  07E 3 --- }
2973: 0049 { 07E 3 xy-  1D1 3 x--  07E 3 xy-  1D1 3 --- }
2974: 01E4 { 192 3 -y-  194 3 -y-  193 3 -y-  186 3 xy- }
2975: 01E4 { 193 3 xy-  186 3 -y-  192 3 xy-  194 3 xy- }
2976: 01E3 { 1D0 3 -y-  18B 3 -y-  193 3 -y-  195 3 x-- }
2977: 00A2 { 1F2 3 ---  193 3 ---  194 3 ---  1B0 3 --- }
2978: ~
2979: ~
297A: ~
297B: ~
297C: ~
297D: ~
297E: ~
297F: ~
2980: 01B0 { 189 3 x--  197 3 x--  195 3 ---  188 3 x-- }
2981: 01AB { 194 3 ---  188 3 ---  189 3 ---  197 3 --- }
2982: 01A1 { 1A1 3 x--  19E 3 x--  1EC 3 x--  19D 3 x-- }
2983: 01A6 { 194 3 ---  1B1 3 x--  195 3 ---  1A0 3 x-- }
2984: 0197 { 194 3 ---  1A0 3 ---  195 3 ---  1B1 3 --- }
2985: 019C { 1EC 3 ---  19D 3 ---  1A1 3 ---  19E 3 --- }
2986: 00AC { 194 3 ---  1D1 3 -y-  1D1 3 -y-  0F8 3 --- }
2987: 00AC { 1D1 3 xy-  0F8 3 x--  194 3 x--  1D1 3 xy- }
2988: ~
2989: ~
298A: ~
298B: ~
298C: ~
298D: ~
298E: ~
298F: ~
2990: 0085 { 1E7 3 ---  1EA 3 ---  1E8 3 ---  1F0 3 --- }
2991: 0086 { 1E8 3 ---  1F0 3 ---  1E9 3 ---  1F1 3 --- }
2992: 0087 { 1E8 3 ---  1F0 3 ---  1E7 3 x--  1EA 3 x-- }
2993: 01E2 { 186 3 ---  192 3 ---  195 3 ---  193 3 --- }
2994: 01E4 { 194 3 ---  192 3 ---  186 3 x--  193 3 --- }
2995: 00B0 { 194 3 ---  1B0 3 x--  1F2 3 x--  195 3 --- }
2996: ~
2997: ~
2998: ~
2999: ~
299A: ~
299B: ~
299C: ~
299D: ~
299E: ~
299F: ~
29A0: 00AA { 194 3 ---  1B0 3 x--  1B0 3 x--  195 3 --- }
29A1: 00A4 { 1B0 3 xy-  193 3 ---  193 3 ---  1B0 3 xy- }
29A2: 01E0 { 1B3 3 x--  192 3 ---  18C 3 x--  193 3 --- }
29A3: 01DE { 18C 3 ---  192 3 ---  1B3 3 ---  193 3 --- }
29A4: 01C2 { 18A 3 x--  19A 3 x--  0F8 3 ---  196 3 x-- }
29A5: 01AF { 187 3 x--  197 3 x--  0F8 3 ---  196 3 x-- }
29A6: ~
29A7: ~
29A8: ~
29A9: ~
29AA: ~
29AB: ~
29AC: ~
29AD: ~
29AE: ~
29AF: ~
29B0: ~
29B1: ~
29B2: ~
29B3: ~
29B4: ~
29B5: ~
29B6: ~
29B7: ~
29B8: ~
29B9: ~
29BA: ~
29BB: ~
29BC: ~
29BD: ~
29BE: ~
29BF: ~
29C0: ~
29C1: ~
29C2: ~
29C3: ~
29C4: ~
29C5: ~
29C6: ~
29C7: ~
29C8: ~
29C9: ~
29CA: ~
29CB: ~
29CC: ~
29CD: ~
29CE: ~
29CF: ~
29D0: ~
29D1: ~
29D2: ~
29D3: ~
29D4: ~
29D5: ~
29D6: ~
29D7: ~
29D8: ~
29D9: ~
29DA: ~
29DB: ~
29DC: ~
29DD: ~
29DE: ~
29DF: ~
29E0: ~
29E1: ~
29E2: ~
29E3: ~
29E4: ~
29E5: ~
29E6: ~
29E7: ~
29E8: ~
29E9: ~
29EA: ~
29EB: ~
29EC: ~
29ED: ~
29EE: ~
29EF: ~
29F0: ~
29F1: ~
29F2: ~
29F3: ~
29F4: ~
29F5: ~
29F6: ~
29F7: ~
29F8: ~
29F9: ~
29FA: ~
29FB: ~
29FC: ~
29FD: ~
29FE: ~
29FF: ~
