2100: 0130 { 232 2 ---  23A 2 ---  251 2 ---  1B1 3 xy- }
2101: 0130 { 251 2 ---  27F 3 -y-  251 2 ---  27F 3 -y- }
2102: 0130 { 251 2 ---  27F 3 -y-  251 2 ---  174 2 --- }
2103: 0130 { 251 2 ---  175 2 ---  251 2 ---  1B1 3 xy- }
2104: 0130 { 251 2 ---  1B1 3 -y-  233 2 ---  23A 2 --- }
2105: 0130 { 1DB 2 --p  1CB 2 --p  1DC 2 --p  1CC 2 --p }
2106: 0130 { 1DC 2 --p  1CD 2 --p  1DC 2 --p  1CC 2 --p }
2107: 0130 { 1DC 2 --p  1CD 2 --p  1DF 2 --p  1CE 2 --p }
2108: 0025 { 0F8 3 ---  0F8 3 ---  0F8 3 ---  0F8 3 --- }
2109: 0025 { 0F8 3 ---  1E4 2 ---  0F8 3 ---  0F8 3 --- }
210A: 0025 { 0F8 3 x--  0F8 3 x--  0F8 3 x--  1E4 2 --- }
210B: 0025 { 0F8 3 x--  0F8 3 x--  0F8 3 x--  0F8 3 x-- }
210C: 0130 { 004 3 --p  014 3 --p  005 3 --p  015 3 --p }
210D: 0130 { 02E 3 --p  03E 3 --p  02E 3 --p  03E 3 --p }
210E: 0130 { 005 3 x-p  015 3 x-p  004 3 x-p  014 3 x-p }
210F: ~
2110: 0130 { 23A 2 ---  23A 2 ---  1F8 3 x--  1F8 3 x-- }
2111: 0130 { 1FF 3 x--  1FE 3 ---  1FE 3 x--  1FF 3 --- }
2112: 0130 { 1FF 3 x--  1FE 3 ---  172 2 ---  170 2 --- }
2113: 0130 { 173 2 ---  171 2 ---  1F8 3 x--  1F8 3 x-- }
2114: 0130 { 1F8 3 ---  1F8 3 ---  23A 2 ---  23A 2 --- }
2115: 0130 { 1D7 2 --p  1D7 2 -yp  1D8 2 --p  1D8 2 -yp }
2116: 0130 { 1D9 2 --p  1D9 2 -yp  1D8 2 --p  1D8 2 -yp }
2117: 0130 { 1D9 2 --p  1D9 2 -yp  1DA 2 --p  1DA 2 -yp }
2118: 0025 { 0F8 3 ---  1E4 3 ---  0F8 3 ---  21B 3 --- }
2119: 0025 { 1E2 2 ---  1E2 2 ---  0F8 3 ---  0F8 3 --- }
211A: 0025 { 0F8 3 x--  0F8 3 x--  1E2 2 ---  1E2 2 --- }
211B: 0025 { 0F8 3 x--  21B 3 ---  0F8 3 x--  1E4 3 --- }
211C: 0130 { 024 3 --p  034 3 --p  025 3 --p  035 3 --p }
211D: 0130 { 02F 3 --p  03F 3 --p  02F 3 --p  03F 3 --p }
211E: 0130 { 025 3 x-p  035 3 x-p  024 3 x-p  034 3 x-p }
211F: ~
2120: 0130 { 23A 2 ---  234 2 ---  1B1 3 x--  251 2 --- }
2121: 0130 { 27F 3 ---  251 2 ---  27F 3 ---  251 2 --- }
2122: 0130 { 27F 3 ---  251 2 ---  174 2 ---  251 2 --- }
2123: 0130 { 175 2 ---  251 2 ---  1B1 3 x--  251 2 --- }
2124: 0130 { 1B1 3 ---  251 2 ---  23A 2 ---  235 2 --- }
2125: 0130 { 1CB 2 -yp  1CB 2 --p  1CC 2 -yp  1CC 2 --p }
2126: 0130 { 1CD 2 -yp  1CD 2 --p  1CC 2 -yp  1CC 2 --p }
2127: 0130 { 1CD 2 -yp  1CD 2 --p  1CE 2 -yp  1CE 2 --p }
2128: 0025 { 1E0 2 ---  1E4 2 ---  1E1 2 ---  0F8 3 --- }
2129: 0025 { 1E2 2 ---  1E2 2 ---  0F8 3 ---  0F8 3 --- }
212A: 0025 { 0F8 3 x--  0F8 3 x--  1E2 2 ---  1E2 2 --- }
212B: 0025 { 1E1 2 x--  0F8 3 x--  1E0 2 x--  1E4 2 --- }
212C: 0133 { 000 3 --p  010 3 --p  001 3 --p  011 3 --p }
212D: 0134 { 002 3 --p  012 3 --p  003 3 --p  013 3 --p }
212E: 0130 { 282 4 --p  292 4 --p  283 4 --p  293 4 --p }
212F: 0130 { 282 5 --p  292 5 --p  283 5 --p  293 5 --p }
2130: 0130 { 1EA 2 x--  1B1 2 x--  27B 2 ---  27F 2 --- }
2131: 0130 { 27C 2 ---  27F 2 ---  27B 2 ---  27F 2 --- }
2132: 0130 { 27C 2 ---  27F 2 ---  1EA 2 ---  1B1 2 --- }
2133: 0130 { 235 2 ---  27F 3 -y-  1F8 3 x--  14F 5 x-- }
2134: 0130 { 1F8 3 ---  14F 5 ---  234 2 ---  27F 3 -y- }
2135: 0025 { 1D7 2 --p  1D7 2 -yp  1D8 2 --p  1D8 2 -yp }
2136: 0025 { 1D9 2 --p  1D9 2 -yp  1D8 2 --p  1D8 2 -yp }
2137: 0025 { 1D9 2 --p  1D9 2 -yp  1DA 2 --p  1DA 2 -yp }
2138: 0025 { 1EB 3 ---  1ED 3 ---  1EC 3 ---  1DD 3 --- }
2139: 0025 { 1EC 3 x--  1DD 3 x--  1EB 3 x--  1ED 3 x-- }
213A: 0025 { 0F8 3 x--  0F8 3 x--  0F8 3 x--  1E4 2 --- }
213B: 0025 { 0F8 3 x--  1E4 2 ---  0F8 3 x--  0F8 3 x-- }
213C: 0135 { 020 3 --p  020 3 --p  021 3 --p  021 3 --p }
213D: 0136 { 022 3 --p  022 3 --p  023 3 --p  023 3 --p }
213E: 0130 { 294 4 --p  292 4 --p  295 4 --p  293 4 --p }
213F: 0130 { 294 5 --p  292 5 --p  295 5 --p  293 5 --p }
2140: 0025 { 0F8 2 ---  0F8 2 ---  20E 3 ---  20E 2 --- }
2141: 0025 { 196 2 -y-  196 3 -y-  197 2 -y-  197 3 -y- }
2142: 0025 { 20E 3 ---  20E 2 ---  0F8 2 ---  0F8 2 --- }
2143: 0130 { 27F 3 ---  233 2 ---  14F 5 xy-  1F8 3 xy- }
2144: 0130 { 14F 5 -y-  1F8 3 -y-  27F 3 ---  232 2 --- }
2145: 0025 { 1CB 2 -yp  1CB 2 --p  1CC 2 -yp  1CC 2 --p }
2146: 0025 { 1CD 2 -yp  1CD 2 --p  1CC 2 -yp  1CC 2 --p }
2147: 0025 { 1CD 2 -yp  1CD 2 --p  1CE 2 -yp  1CE 2 --p }
2148: 0025 { 1DD 3 x--  1DD 3 x--  1DD 3 ---  1EF 3 --- }
2149: 0025 { 1DD 3 x--  1EF 3 x--  1DD 3 ---  1DD 3 --- }
214A: 0025 { 0F8 3 x--  0F8 3 x--  1E2 2 ---  1E2 2 --- }
214B: 0025 { 1E2 2 ---  1E2 2 ---  0F8 3 x--  0F8 3 x-- }
214C: 0133 { 010 3 -yp  000 3 -yp  011 3 -yp  001 3 -yp }
214D: 0134 { 012 3 -yp  002 3 -yp  013 3 -yp  003 3 -yp }
214E: 0130 { 294 4 --p  292 4 --p  295 4 --p  293 4 --p }
214F: ~
2150: 0025 { 0F8 3 ---  0F8 3 ---  0F8 3 ---  0F8 3 --- }
2151: 0025 { 0F8 3 ---  0F8 3 ---  0F8 3 ---  1E4 2 --- }
2152: 0025 { 0F8 3 x--  1E4 2 x--  0F8 3 x--  0F8 3 x-- }
2153: 0025 { 0F8 3 x--  0F8 3 x--  0F8 3 x--  0F8 3 x-- }
2154: 0006 { 087 1 ---  088 1 x--  088 1 ---  087 1 x-- }
2155: 0025 { 1CB 2 -yp  1E6 2 --p  1CC 2 -yp  1D2 2 -yp }
2156: 0025 { 1CD 2 -yp  1D1 2 -yp  1CC 2 -yp  1D2 2 -yp }
2157: 0025 { 1CD 2 -yp  1D1 2 -yp  1CE 2 -yp  1E7 2 --p }
2158: 0025 { 1DD 3 x--  1EE 3 ---  1DD 3 ---  1EE 3 x-- }
2159: 0025 { 1DD 3 x--  1EE 3 ---  1DD 3 ---  1EE 3 x-- }
215A: 012F { 24E 2 ---  25E 2 ---  24E 2 ---  25E 2 --- }
215B: 012F { 26D 2 x--  26D 2 x--  26C 2 x--  26C 2 x-- }
215C: 012F { 26C 2 ---  26C 2 ---  26D 2 ---  26D 2 --- }
215D: 0130 { 2E7 4 --p  2EA 4 --p  2E8 4 --p  2F0 4 --p }
215E: 0130 { 2E9 4 --p  2F1 4 --p  2E8 4 --p  2F0 4 --p }
215F: 0130 { 2E9 4 --p  2F1 4 --p  2E7 4 x-p  2EA 4 x-p }
2160: 0025 { 0F8 3 ---  0F8 3 ---  0F8 3 ---  1E4 3 --- }
2161: 0025 { 0F8 3 ---  21B 3 ---  1E2 2 ---  1E2 2 --- }
2162: 0025 { 1E2 2 x--  1E2 2 x--  0F8 3 x--  21B 3 x-- }
2163: 0025 { 0F8 3 x--  1E4 3 x--  0F8 3 x--  0F8 3 x-- }
2164: 0130 { 1EA 2 x--  1B1 2 x--  1EA 2 ---  1B1 2 --- }
2165: 0025 { 1E8 2 --p  0F8 2 --p  1C2 2 -yp  0F8 2 --p }
2166: 0025 { 1C1 2 -yp  0F8 2 --p  1C2 2 -yp  0F8 2 --p }
2167: 0025 { 1C1 2 -yp  0F8 2 --p  1E9 2 --p  0F8 2 --p }
2168: ~
2169: ~
216A: 012F { 25E 2 -y-  24E 2 -y-  25E 2 -y-  24E 2 -y- }
216B: ~
216C: 0025 { 0F8 6 ---  0F8 6 ---  0F8 6 ---  2F5 6 --- }
216D: 0025 { 2E6 6 ---  2F6 6 ---  2E7 6 ---  2F7 6 --- }
216E: 0025 { 2E8 6 ---  2F8 6 ---  0F8 6 ---  0F8 6 --- }
216F: 0025 { 0F8 6 ---  0F8 6 ---  0F8 6 ---  0F8 6 --- }
2170: 0025 { 0F8 3 ---  0F8 3 ---  1E0 2 ---  1E4 2 --- }
2171: 0025 { 1E1 2 ---  0F8 3 ---  1E2 2 ---  1E2 2 --- }
2172: 0025 { 1E2 2 x--  1E2 2 x--  1E1 2 x--  0F8 3 x-- }
2173: 0025 { 1E0 2 x--  1E4 2 x--  0F8 3 x--  0F8 3 x-- }
2174: 0025 { 000 7 --p  010 7 --p  001 7 --p  011 7 --p }
2175: 0025 { 002 7 --p  012 7 --p  003 7 --p  013 7 --p }
2176: 01AA { 0F8 4 ---  216 2 ---  207 2 ---  217 2 --- }
2177: 01AF { 207 2 x--  217 2 x--  0F8 4 x--  216 2 x-- }
2178: 0025 { 0F8 3 ---  1E0 2 ---  0F8 3 ---  1E1 2 --- }
2179: 0025 { 0F8 3 x--  1E1 2 x--  0F8 3 ---  1E1 2 --- }
217A: 0025 { 0F8 3 x--  1E1 2 x--  0F8 3 ---  1E1 2 --- }
217B: 0025 { 0F8 3 x--  1E1 2 x--  0F8 3 ---  1E0 2 x-- }
217C: 0025 { 0F8 6 ---  298 6 ---  289 6 ---  299 6 --- }
217D: 0025 { 28A 6 ---  29A 6 ---  28B 6 ---  29B 6 --- }
217E: 0025 { 28C 6 ---  29C 6 ---  0F8 6 ---  0F8 6 --- }
217F: 0025 { 0F8 6 ---  29E 6 ---  0F8 6 ---  29F 6 --- }
2180: 0025 { 0F8 3 x--  0F8 3 x--  0F8 3 x--  0F8 3 x-- }
2181: 0130 { 232 2 ---  23A 2 ---  251 2 ---  1B1 3 xy- }
2182: 0130 { 251 2 ---  1B1 3 -y-  233 2 ---  23A 2 --- }
2183: 0025 { 0F8 3 x--  0F8 3 x--  0F8 3 x--  0F8 3 x-- }
2184: 0025 { 020 7 --p  020 7 --p  021 7 --p  021 7 --p }
2185: 0025 { 022 7 --p  022 7 --p  023 7 --p  023 7 --p }
2186: 01E2 { 206 2 ---  0F8 4 ---  0F8 4 ---  0F8 4 --- }
2187: 01E4 { 0F8 4 x--  0F8 4 x--  206 2 x--  0F8 4 x-- }
2188: 0025 { 1E4 2 ---  1E2 2 ---  0F8 3 ---  0F8 3 --- }
2189: 0025 { 1E4 3 x--  1E2 3 x--  0F8 3 ---  0F8 3 --- }
218A: 0025 { 0F8 3 x--  0F8 3 x--  1E4 3 ---  1E2 3 --- }
218B: 0025 { 0F8 3 x--  0F8 3 x--  1E4 2 ---  1E2 2 --- }
218C: 0025 { 2A8 6 ---  2B8 6 ---  2A9 6 ---  2B9 6 --- }
218D: 0025 { 2AA 6 ---  2BA 6 ---  2AB 6 ---  2BB 6 --- }
218E: 0025 { 2AC 6 ---  2BC 6 ---  2AD 6 ---  2BD 6 --- }
218F: 0025 { 2AE 6 ---  2BE 6 ---  2AF 6 ---  2BF 6 --- }
2190: 0130 { 251 2 ---  27F 3 -y-  251 2 ---  27F 3 -y- }
2191: 0130 { 235 2 ---  27F 3 -y-  1F8 3 x--  14F 5 x-- }
2192: 0130 { 1F8 3 ---  14F 5 ---  234 2 ---  27F 3 -y- }
2193: 0130 { 251 2 ---  27F 3 -y-  251 2 ---  27F 3 -y- }
2194: 0025 { 1D6 5 x--  1D6 5 xy-  0FA 5 ---  0FA 5 --- }
2195: 0025 { 0FA 5 ---  0FA 5 ---  0FA 5 ---  0FA 5 --- }
2196: 0025 { 0FA 5 ---  0FA 5 ---  1D6 5 ---  1D6 5 -y- }
2197: 0100 { 1D9 2 --p  1D9 2 -yp  1D8 2 --p  1D8 2 -yp }
2198: 0025 { 28A 6 ---  2B5 6 ---  28B 6 ---  2B6 6 --- }
2199: 0025 { 0F8 2 ---  0F8 2 ---  1EB 2 ---  1ED 2 --- }
219A: 0025 { 1EC 2 ---  1DD 2 ---  1EC 2 x--  1DD 2 x-- }
219B: 0025 { 1EB 2 x--  1ED 2 x--  0F8 2 x--  0F8 2 x-- }
219C: 0025 { 2C8 6 ---  2D8 6 ---  2C9 6 ---  2D9 6 --- }
219D: 0025 { 2CA 6 ---  2DA 6 ---  2CB 6 ---  2DB 6 --- }
219E: 0025 { 2CC 6 ---  2DC 6 ---  2CD 6 ---  0F8 6 --- }
219F: 0025 { 2CE 6 ---  0F8 6 ---  0F8 6 ---  0F8 6 --- }
21A0: 0130 { 1FF 3 x--  1FE 3 ---  1FE 3 x--  1FF 3 --- }
21A1: 0130 { 1FF 3 x--  1FE 3 ---  1FE 3 x--  1FF 3 --- }
21A2: 0130 { 1FF 3 x--  1FE 3 ---  1FE 3 x--  1FF 3 --- }
21A3: 0130 { 1FF 3 x--  1FE 3 ---  1FE 3 x--  1FF 3 --- }
21A4: 0201 { 0F8 6 ---  0F8 6 ---  0F8 6 ---  0F8 6 --- }
21A5: 0025 { 0BE 2 -yp  0AE 2 ---  0BF 2 -yp  0FB 4 --- }
21A6: 0025 { 0BF 2 -yp  0FB 4 ---  0BE 2 xyp  0AE 2 --p }
21A7: ~
21A8: 0025 { 2C5 6 ---  2BA 6 ---  2C6 6 ---  2BB 6 --- }
21A9: 0025 { 0F8 2 ---  0F8 2 ---  1DD 2 x--  1DD 2 x-- }
21AA: 0020 { 1DD 2 ---  1EF 2 ---  1DD 2 x--  1EF 2 x-- }
21AB: 0025 { 1DD 2 ---  1DD 2 ---  0F8 2 x--  0F8 2 x-- }
21AC: 0025 { 0F8 6 ---  0F8 6 ---  2E9 6 ---  2F9 6 --- }
21AD: 0025 { 2EA 6 ---  2FA 6 ---  2EB 6 ---  2FB 6 --- }
21AE: 0025 { 2EC 6 ---  2FC 6 ---  2ED 6 ---  2FD 6 --- }
21AF: 0025 { 0F8 6 ---  0F8 6 ---  0F8 6 ---  0F8 6 --- }
21B0: 0135 { 020 7 ---  020 7 ---  021 7 ---  021 7 --- }
21B1: 0136 { 022 7 ---  022 7 ---  023 7 ---  023 7 --- }
21B2: 0130 { 000 7 ---  010 7 ---  001 7 ---  011 7 --- }
21B3: 0130 { 002 7 ---  012 7 ---  003 7 ---  013 7 --- }
21B4: ~
21B5: 0025 { 0AE 2 ---  0BE 2 -yp  0FB 4 ---  0BF 2 -yp }
21B6: 0025 { 0FB 4 ---  0BF 2 -yp  0AE 2 --p  0BE 2 xyp }
21B7: ~
21B8: ~
21B9: 0025 { 0F8 2 ---  0F8 2 ---  1DD 2 x--  1EE 2 --- }
21BA: 0020 { 1DD 2 ---  1EE 2 x--  1DD 2 x--  1EE 2 --- }
21BB: 0025 { 1DD 2 ---  1EE 2 x--  0F8 2 x--  0F8 2 x-- }
21BC: 0025 { 2EE 6 ---  2FE 6 ---  2EF 6 ---  2FF 6 --- }
21BD: 0025 { 2EF 6 ---  2FF 6 ---  2EF 6 ---  2FF 6 --- }
21BE: 0025 { 2EF 6 ---  2FF 6 ---  2EE 6 x--  2FE 6 x-- }
21BF: 0025 { 0F8 6 ---  0F8 6 ---  0F8 6 ---  0F8 6 --- }
21C0: 0135 { 020 7 ---  020 7 ---  021 7 ---  021 7 --- }
21C1: 0136 { 022 7 ---  022 7 ---  023 7 ---  023 7 --- }
21C2: 0135 { 020 7 ---  020 7 ---  021 7 ---  021 7 --- }
21C3: 0136 { 022 7 ---  022 7 ---  023 7 ---  023 7 --- }
21C4: ~
21C5: 0025 { 28F 7 x--  29F 7 x--  281 7 ---  291 7 --- }
21C6: 0025 { 282 7 ---  292 7 ---  283 6 ---  293 6 --- }
21C7: 0025 { 284 6 ---  294 6 ---  285 6 ---  295 6 --- }
21C8: 0025 { 286 6 ---  296 6 ---  287 6 ---  297 6 --- }
21C9: 0025 { 288 6 ---  298 6 ---  289 6 ---  299 6 --- }
21CA: 0025 { 28A 7 ---  29A 7 ---  28B 7 ---  29B 7 --- }
21CB: 0025 { 28C 7 ---  29C 7 ---  28D 7 ---  0FD 7 --- }
21CC: 0025 { 28D 7 ---  0FD 7 ---  28F 7 ---  29F 7 --- }
21CD: 0025 { 0F8 6 ---  2E0 6 ---  0F8 6 ---  2E1 6 --- }
21CE: 0025 { 0F8 6 ---  2E2 6 ---  0F8 6 ---  2E3 6 --- }
21CF: 0025 { 0F8 6 ---  2E4 6 ---  0F8 6 ---  2E5 6 --- }
21D0: 0137 { 000 7 ---  010 7 ---  001 7 ---  011 7 --- }
21D1: 0138 { 002 7 ---  012 7 ---  003 7 ---  013 7 --- }
21D2: 0135 { 020 7 ---  020 7 ---  021 7 ---  021 7 --- }
21D3: 0136 { 022 7 ---  022 7 ---  023 7 ---  023 7 --- }
21D4: ~
21D5: 0025 { 29F 7 x--  29F 7 x--  2A1 7 ---  2B1 7 --- }
21D6: 0025 { 2A2 7 ---  2B2 7 ---  2A3 6 ---  2B3 6 --- }
21D7: 0025 { 2A4 6 ---  2B4 6 ---  2A5 6 ---  2B5 6 --- }
21D8: 0025 { 2A6 6 ---  2B6 6 ---  2A7 6 ---  2B7 6 --- }
21D9: 0025 { 2A8 6 ---  2B8 6 ---  2A9 6 ---  2B9 6 --- }
21DA: 0025 { 2AA 7 ---  2BA 7 ---  2AB 7 ---  2BB 7 --- }
21DB: 0025 { 29C 7 ---  2BC 7 ---  0FD 7 ---  2BD 7 --- }
21DC: 0025 { 0FD 7 ---  2BE 7 ---  29F 7 ---  2BF 7 --- }
21DD: 0025 { 0F8 6 ---  2EC 5 ---  0F8 6 ---  2ED 5 --- }
21DE: 0130 { 0BF 2 -yp  0BF 2 -yp  0BE 2 xyp  0BF 2 -yp }
21DF: 0130 { 013 2 -y-  0BE 2 xyp  013 2 -y-  013 2 -y- }
21E0: 0025 { 280 6 ---  0F8 6 ---  290 6 ---  0F8 6 --- }
21E1: 0025 { 2A0 6 ---  2C0 6 ---  280 6 ---  290 6 --- }
21E2: 0025 { 2B0 6 ---  2F0 6 ---  290 6 ---  2AC 6 --- }
21E3: 0025 { 2C0 6 ---  2AD 6 ---  2D0 6 ---  2A0 6 --- }
21E4: ~
21E5: 0025 { 29F 7 x--  29F 7 x--  2C1 7 ---  2D1 7 --- }
21E6: 0025 { 2C2 7 ---  2D2 7 ---  2C3 6 ---  2D3 6 --- }
21E7: 0025 { 2C4 6 ---  2D4 6 ---  2C5 6 ---  2D5 6 --- }
21E8: 0025 { 2C6 6 ---  2D6 6 ---  2C7 6 ---  2D7 6 --- }
21E9: 0025 { 2C8 6 ---  2D8 6 ---  2C9 6 ---  2D9 6 --- }
21EA: 0025 { 2CA 7 ---  2DA 7 ---  2CB 7 ---  2DB 7 --- }
21EB: 0025 { 2CC 7 ---  2DC 7 ---  2CD 7 ---  2DD 7 --- }
21EC: 0025 { 2CE 7 ---  2DE 7 ---  2CF 7 ---  2DF 7 --- }
21ED: 0025 { 2FC 5 ---  1E1 2 x--  2FD 5 ---  1E1 2 --- }
21EE: 0130 { 013 2 -y-  013 2 -y-  013 2 -y-  0BE 2 -yp }
21EF: 0130 { 0BE 2 -yp  0BF 2 -yp  0BF 2 -yp  0BF 2 -yp }
21F0: 0025 { 0F8 6 ---  2AE 6 ---  0F8 6 ---  2AF 6 --- }
21F1: 0025 { 2A0 6 ---  0F8 6 ---  2E0 6 ---  0F8 6 --- }
21F2: ~
21F3: ~
21F4: ~
21F5: 0025 { 29F 7 x--  28F 7 xy-  2E1 7 ---  2F1 7 --- }
21F6: 0025 { 2E2 7 ---  2F2 7 ---  2E3 6 ---  2F3 6 --- }
21F7: 0025 { 2E4 6 ---  2F4 6 ---  2E5 6 ---  2F5 6 --- }
21F8: 0025 { 2E6 6 ---  2F6 6 ---  2E7 6 ---  2F7 6 --- }
21F9: 0025 { 2E8 6 ---  2F8 6 ---  2E9 6 ---  2F9 6 --- }
21FA: 0025 { 2EA 7 ---  2FA 7 ---  2EB 7 ---  2FB 7 --- }
21FB: 0025 { 29C 7 ---  28D 7 -y-  0FD 7 ---  28D 7 -y- }
21FC: 0025 { 0FD 7 ---  28D 7 -y-  29F 7 -y-  28F 7 -y- }
21FD: ~
21FE: ~
21FF: ~
