6300: 0106 { 281 5 x--  291 5 x--  280 5 x--  290 5 x-- }
6301: 0106 { 280 5 ---  290 5 ---  280 5 x--  290 5 x-- }
6302: 0106 { 280 5 ---  290 5 ---  281 5 ---  291 5 --- }
6303: 0025 { 2A2 5 ---  2B2 5 ---  2A3 5 ---  2B3 5 --- }
6304: 0025 { 2C2 5 ---  2D2 5 ---  2C3 5 ---  2D3 5 --- }
6305: 0130 { 2A4 5 ---  2B4 5 ---  2A5 5 ---  2B5 5 --- }
6306: 0130 { 2A6 5 ---  2B4 5 ---  2A7 5 ---  2B5 5 --- }
6307: 0130 { 2F1 5 ---  2F1 5 ---  2E3 5 ---  2F3 5 --- }
6308: 0130 { 2E4 5 ---  2F4 5 ---  2E5 5 ---  2F5 5 --- }
6309: 0130 { 2E7 5 ---  2F4 5 ---  2E8 5 ---  2F5 5 --- }
630A: 0130 { 2E4 5 ---  2F7 5 ---  2E5 5 ---  2F8 5 --- }
630B: 0025 { 0F8 5 ---  0F8 5 ---  28C 5 ---  0F8 5 --- }
630C: 0025 { 28A 5 ---  29A 5 ---  28B 5 ---  29B 5 --- }
630D: 0025 { 2B9 5 xy-  2A9 5 xy-  2B8 5 xy-  2A8 5 xy- }
630E: 0025 { 2B8 5 -y-  2A8 5 -y-  2B9 5 -y-  2A9 5 -y- }
630F: 0025 { 28E 5 ---  29E 5 ---  28F 5 ---  29F 5 --- }
6310: 0130 { 2F4 5 ---  2D6 5 ---  2D7 5 ---  2B4 5 --- }
6311: 0025 { 2A0 5 ---  2B0 5 ---  2A1 5 ---  2B1 5 --- }
6312: 0130 { 2D7 5 x--  2B4 5 x--  2F4 5 x--  2D6 5 x-- }
6313: 0025 { 0F8 5 ---  283 5 ---  283 5 ---  293 5 --- }
6314: 0025 { 284 5 ---  294 5 ---  285 5 ---  0F8 5 --- }
6315: 0130 { 2C4 5 ---  2F1 5 ---  2C5 5 ---  2F1 5 --- }
6316: 0130 { 2C4 5 ---  2F1 5 ---  2C5 5 ---  2F1 5 --- }
6317: 0130 { 2F1 5 ---  2F1 5 ---  2E3 5 ---  2F3 5 --- }
6318: 0130 { 2E4 5 ---  2F4 5 ---  2E6 5 ---  2F6 5 --- }
6319: 0130 { 2E9 5 ---  2F4 5 ---  2EA 5 ---  2F6 5 --- }
631A: 0130 { 2E4 5 ---  2F9 5 ---  2E6 5 ---  2FA 5 --- }
631B: 0130 { 2EC 5 ---  2FC 5 ---  2ED 5 ---  2FD 5 --- }
631C: 0025 { 2AA 5 ---  0F8 5 ---  2AB 5 ---  0F8 5 --- }
631D: 0025 { 299 5 xy-  289 5 xy-  298 5 xy-  288 5 xy- }
631E: 0025 { 298 5 -y-  288 5 -y-  299 5 -y-  289 5 -y- }
631F: 0025 { 2AE 5 ---  2BE 5 ---  2AF 5 ---  2BF 5 --- }
6320: 0130 { 2D4 5 ---  2F1 5 ---  2C5 5 ---  2F1 5 --- }
6321: 0025 { 2C0 5 ---  2D0 5 ---  2C1 5 ---  2D1 5 --- }
6322: 0130 { 2D5 5 x--  2F1 5 ---  2C4 5 x--  2F1 5 --- }
6323: 0025 { 285 5 x--  0F8 5 ---  284 5 x--  294 5 x-- }
6324: 0025 { 283 5 x--  293 5 x--  0F8 5 ---  283 5 x-- }
6325: 0130 { 286 5 ---  296 5 ---  2A5 5 ---  2B5 5 --- }
6326: 0130 { 2C4 5 ---  2F1 5 -y-  2F3 5 -y-  2E3 5 -y- }
6327: 0130 { 2E5 5 x--  2F5 5 x--  2E4 5 x--  2F4 5 x-- }
6328: 0130 { 2E3 5 x--  2F3 5 x--  2F1 5 x--  2F1 5 x-- }
6329: 0130 { 2F1 5 xy-  2C5 5 xy-  2F1 5 xy-  2C4 5 xy- }
632A: 0130 { 2F1 5 xy-  2C5 5 xy-  2F1 5 xy-  2C4 5 xy- }
632B: 0130 { 2E3 5 x--  2F3 5 x--  2F1 5 x--  2C4 5 xy- }
632C: 0130 { 2FC 5 -y-  2EC 5 -y-  2FD 5 -y-  2ED 5 -y- }
632D: 0130 { 2A6 5 ---  2B4 5 ---  2A7 5 ---  2B5 5 --- }
632E: 0130 { 2FD 5 xy-  2ED 5 xy-  2FC 5 xy-  2EC 5 xy- }
632F: 0025 { 2CE 5 ---  2DE 5 ---  2CF 5 ---  2DF 5 --- }
6330: 0020 { 2E0 5 ---  2F0 5 ---  2E1 5 ---  2F1 5 --- }
6331: 0020 { 2E1 5 x--  2F1 5 x--  2E0 5 x--  2F0 5 x-- }
6332: 0130 { 2F1 5 xy-  2C4 5 -y-  2F1 5 xy-  2D5 5 -y- }
6333: 0129 { 060 6 ---  062 6 ---  061 6 ---  063 6 --- }
6334: 0130 { 2C4 5 ---  2C5 5 xy-  2D5 5 ---  2C4 5 xy- }
6335: 0130 { 2A4 5 ---  2B4 5 ---  287 5 ---  297 5 --- }
6336: 0025 { 20A 5 x--  21A 5 x--  209 5 x--  219 5 x-- }
6337: 0130 { 2E6 5 x--  2F6 5 x--  2E4 5 x--  2F4 5 x-- }
6338: 0130 { 2E3 5 x--  2F3 5 x--  2F1 5 x--  2F1 5 x-- }
6339: 0130 { 2B4 5 -y-  2A4 5 -y-  2B5 5 -y-  2A5 5 -y- }
633A: 0130 { 2B4 5 -y-  2A6 5 -y-  2B5 5 -y-  2A7 5 -y- }
633B: 0130 { 2F1 5 ---  2C4 5 -y-  2E3 5 ---  2F3 5 --- }
633C: 0130 { 2E5 5 x--  2F5 5 x--  2E4 5 x--  2F4 5 x-- }
633D: ~
633E: 0130 { 2E4 5 ---  2F4 5 ---  2E6 5 ---  2F6 5 --- }
633F: 0130 { 2F3 5 xy-  2E3 5 xy-  2F3 5 -y-  2E3 5 -y- }
6340: 0020 { 2E2 5 ---  2F2 5 ---  2F1 5 ---  2F1 5 --- }
6341: 0020 { 2F1 5 x--  2F1 5 x--  2E2 5 x--  2F2 5 x-- }
6342: 0130 { 2B4 5 xy-  2D7 5 xy-  2D6 5 xy-  2F4 5 xy- }
6343: 0130 { 2D6 5 -y-  2F4 5 -y-  2B4 5 -y-  2D7 5 -y- }
6344: 0025 { 229 5 ---  239 5 ---  22A 5 ---  23A 5 --- }
6345: 0025 { 20A 5 x--  21A 5 x--  209 5 x--  219 5 x-- }
6346: 0130 { 200 6 ---  210 6 ---  201 6 ---  211 6 --- }
6347: 0025 { 2EF 6 x--  2FF 6 x--  2EE 6 x--  2FE 6 x-- }
6348: 0025 { 0F8 6 --p  2E8 6 ---  247 6 --p  2E8 6 x-- }
6349: 0025 { 208 5 x--  218 5 x--  207 5 x--  217 5 x-- }
634A: 0130 { 22A 5 ---  23A 5 ---  22A 5 ---  23A 5 --- }
634B: 0130 { 2F3 5 xy-  2E3 5 xy-  2C4 5 x--  2F1 5 xy- }
634C: 0130 { 2EC 5 ---  2FC 5 ---  2ED 5 ---  2FD 5 --- }
634D: 0130 { 2B4 5 -y-  2A6 5 -y-  2B5 5 -y-  2A7 5 -y- }
634E: 0130 { 2ED 5 x--  2FD 5 x--  2EC 5 x--  2FC 5 x-- }
634F: 0130 { 2E3 5 x--  2F3 5 x--  2E3 5 ---  2F3 5 --- }
6350: 0130 { 2F1 5 ---  2F1 5 ---  2F1 5 x--  2F1 5 x-- }
6351: 0025 { 2EF 6 x--  2FF 6 x--  2EE 6 x--  2FE 6 x-- }
6352: 0025 { 2AD 5 x--  2BD 5 x--  2AD 5 ---  2BD 5 --- }
6353: 0025 { 2BA 6 x--  2BB 6 x--  2BA 6 ---  2BB 6 --- }
6354: 0025 { 2AC 6 ---  2BC 6 ---  2AC 6 x--  2BC 6 x-- }
6355: 0025 { 28D 6 x--  29D 6 x--  28D 6 ---  29D 6 --- }
6356: 0025 { 202 5 x--  202 5 x--  220 5 ---  202 5 --- }
6357: 0025 { 221 5 ---  202 5 x--  0F8 5 ---  0F8 5 --- }
6358: 0025 { 22A 5 x--  23A 5 x--  229 5 x--  239 5 x-- }
6359: 0025 { 228 5 x--  238 5 x--  0F8 5 ---  0F8 5 --- }
635A: 0025 { 20A 7 ---  21A 7 ---  20B 7 ---  21B 7 --- }
635B: 0025 { 228 6 --p  238 6 --p  229 6 --p  239 6 --p }
635C: 0025 { 208 7 --p  218 7 --p  209 7 --p  219 7 --p }
635D: 0025 { 0F8 5 ---  0F8 5 ---  0F8 5 ---  282 6 --- }
635E: 0025 { 0F8 5 ---  295 6 ---  0F8 5 ---  295 6 x-- }
635F: 0025 { 0F8 5 ---  282 6 x--  0F8 5 ---  0F8 5 --- }
6360: 0025 { 0F8 5 ---  0F8 5 ---  2A0 5 ---  2B0 5 --- }
6361: 0025 { 2A1 5 ---  2B1 5 ---  0F8 5 ---  0F8 5 --- }
6362: 0025 { 0F8 5 ---  0F8 5 ---  28E 5 ---  29E 5 --- }
6363: 0025 { 28F 5 ---  29F 5 ---  0F8 5 ---  0F8 5 --- }
6364: 0025 { 0F8 5 ---  0F8 5 ---  0F8 5 ---  212 5 --- }
6365: 0025 { 203 5 ---  213 5 ---  204 5 ---  214 5 --- }
6366: 0025 { 205 5 ---  215 5 ---  206 5 ---  216 5 --- }
6367: 0025 { 207 5 ---  217 5 ---  208 5 ---  218 5 --- }
6368: 0025 { 209 5 ---  219 5 ---  20A 5 ---  21A 5 --- }
6369: 0025 { 207 7 --p  217 7 --p  236 7 --p  200 7 --p }
636A: 0025 { 24A 7 --p  22B 7 --p  20C 7 --p  21C 7 --p }
636B: 0025 { 0F8 6 --p  256 6 --p  247 6 --p  257 6 --p }
636C: 0025 { 248 6 --p  258 6 --p  249 6 --p  259 6 --p }
636D: 0025 { 0F8 5 ---  0F8 5 ---  292 6 ---  292 6 -y- }
636E: ~
636F: 0025 { 292 6 x--  292 6 xy-  0F8 5 ---  0F8 5 --- }
6370: 0025 { 0F8 5 ---  0F8 5 ---  2C0 5 ---  2D0 5 --- }
6371: 0025 { 2C1 5 ---  2D1 5 ---  0F8 5 ---  0F8 5 --- }
6372: 0025 { 0F8 5 ---  0F8 5 ---  2AE 5 ---  2BE 5 --- }
6373: 0025 { 2AF 5 ---  2BF 5 ---  0F8 5 ---  0F8 5 --- }
6374: 0025 { 0F8 5 ---  0F8 5 ---  222 5 ---  0F8 5 --- }
6375: 0025 { 223 5 ---  233 5 ---  224 5 ---  234 5 --- }
6376: 0025 { 225 5 ---  235 5 ---  226 5 ---  0F8 5 --- }
6377: 0025 { 0F8 5 ---  0F8 5 ---  232 5 ---  232 5 --- }
6378: 0025 { 202 5 x--  202 5 x--  0F8 5 ---  0F8 5 --- }
6379: 0025 { 227 7 --p  237 7 --p  22A 7 --p  23A 7 --p }
637A: 0025 { 23B 7 --p  24B 7 --p  21D 7 --p  224 7 --p }
637B: 0025 { 266 6 --p  276 6 --p  267 6 --p  277 6 --p }
637C: 0025 { 268 6 --p  278 6 --p  246 6 --p  0F8 6 --p }
637D: 0025 { 0F8 5 ---  0F8 5 ---  282 6 -y-  0F8 5 --- }
637E: 0025 { 295 6 -y-  0F8 5 ---  295 6 xy-  0F8 5 --- }
637F: 0025 { 282 6 xy-  0F8 5 ---  0F8 5 ---  0F8 5 --- }
6380: 0025 { 284 5 x--  294 5 x--  2A0 5 ---  2B0 5 --- }
6381: 0025 { 2A1 5 ---  2B1 5 ---  284 5 ---  294 5 --- }
6382: 0025 { 0F8 5 ---  0F8 5 ---  2CE 5 ---  2DE 5 --- }
6383: 0025 { 2CF 5 ---  2DF 5 ---  0F8 5 ---  0F8 5 --- }
6384: 0025 { 0F8 5 ---  0F8 5 ---  0F8 5 ---  282 5 --- }
6385: 0025 { 0F8 5 ---  295 5 ---  0F8 5 ---  295 5 x-- }
6386: 0025 { 0F8 5 ---  282 5 x--  0F8 5 ---  0F8 5 --- }
6387: 0025 { 220 5 ---  202 5 ---  221 5 ---  202 5 x-- }
6388: 0025 { 0F8 5 ---  0F8 5 ---  0F8 5 ---  210 5 --- }
6389: 0025 { 201 5 ---  211 5 ---  202 5 ---  212 5 --- }
638A: 0025 { 203 5 ---  213 5 ---  204 5 ---  214 5 --- }
638B: 0025 { 205 5 ---  215 5 ---  206 5 ---  216 5 --- }
638C: 0025 { 206 5 x--  216 5 x--  205 5 x--  215 5 x-- }
638D: 0025 { 204 5 x--  214 5 x--  203 5 x--  183 5 x-- }
638E: 0025 { 202 5 x--  182 5 x--  201 5 x--  211 5 x-- }
638F: 0025 { 0F8 5 ---  210 5 x--  0F8 5 x--  0F8 5 x-- }
6390: 0025 { 0F8 5 ---  0F8 5 ---  285 5 x--  0F8 5 --- }
6391: 0025 { 285 5 ---  0F8 5 ---  0F8 5 ---  0F8 5 --- }
6392: 0025 { 207 5 ---  217 5 ---  208 5 ---  218 5 --- }
6393: 0025 { 209 5 ---  219 5 ---  20A 5 ---  21A 5 --- }
6394: 0025 { 0F8 5 ---  0F8 5 ---  292 5 ---  292 5 -y- }
6395: 0025 { 004 4 ---  004 4 -y-  004 4 x--  004 4 xy- }
6396: 0025 { 292 5 x--  292 5 xy-  0F8 5 ---  0F8 5 --- }
6397: 0025 { 202 5 ---  202 5 ---  202 5 x--  202 5 x-- }
6398: 0025 { 0F8 5 ---  0F8 5 ---  220 5 ---  230 5 --- }
6399: 0025 { 221 5 ---  231 5 ---  222 5 ---  232 5 --- }
639A: 0025 { 223 5 ---  233 5 ---  180 4 ---  234 5 --- }
639B: 0025 { 225 5 ---  235 5 ---  226 5 ---  0F8 5 --- }
639C: 0025 { 226 5 x--  0F8 5 ---  225 5 x--  235 5 x-- }
639D: 0025 { 194 5 x--  1A4 5 x--  193 5 x--  1A3 5 x-- }
639E: 0025 { 192 5 x--  1A2 5 x--  221 5 x--  231 5 x-- }
639F: 0025 { 220 5 x--  230 5 x--  0F8 5 x--  0F8 5 x-- }
63A0: 0025 { 0F8 5 ---  0F8 5 ---  0F8 5 ---  287 5 --- }
63A1: 0025 { 0F8 5 ---  288 5 ---  0F8 5 ---  289 5 --- }
63A2: 0025 { 0F8 5 ---  2BA 5 ---  0F8 5 ---  2BB 5 --- }
63A3: 0025 { 0F8 5 ---  0F8 5 ---  228 5 ---  238 5 --- }
63A4: 0025 { 0F8 5 ---  0F8 5 ---  282 5 -y-  0F8 5 --- }
63A5: 0025 { 295 5 -y-  0F8 5 ---  295 5 xy-  0F8 5 --- }
63A6: 0025 { 282 5 xy-  0F8 5 ---  0F8 5 ---  0F8 5 --- }
63A7: 0025 { 0F8 5 ---  0A6 3 ---  0F8 5 ---  0A7 3 --- }
63A8: 0025 { 0F8 5 ---  0F8 5 ---  240 5 ---  250 5 --- }
63A9: 0025 { 241 5 ---  251 5 ---  242 5 ---  252 5 --- }
63AA: 0025 { 243 5 ---  253 5 ---  244 5 ---  254 5 --- }
63AB: 0025 { 245 5 ---  255 5 ---  0F8 5 ---  0F8 5 --- }
63AC: 0025 { 0F8 5 ---  0F8 5 ---  245 5 x--  255 5 x-- }
63AD: 0025 { 1B4 5 x--  254 5 x--  1B3 5 x--  1C3 5 x-- }
63AE: 0025 { 1B2 5 x--  1C2 5 x--  241 5 x--  251 5 x-- }
63AF: 0025 { 240 5 x--  250 5 x--  0F8 5 x--  0F8 5 x-- }
63B0: 0025 { 296 5 ---  29C 5 ---  297 5 ---  29D 5 --- }
63B1: 0025 { 298 5 ---  2BC 5 ---  299 5 ---  2BD 5 --- }
63B2: 0025 { 2CA 5 ---  2DA 5 ---  2CB 5 ---  2DB 5 --- }
63B3: 0025 { 220 5 ---  230 5 ---  221 5 ---  231 5 --- }
63B4: 0025 { 0F8 5 ---  0F8 5 ---  2A2 5 ---  2B2 5 --- }
63B5: 0025 { 2A3 5 ---  2B3 5 ---  2A3 5 x--  2B3 5 x-- }
63B6: 0025 { 2A2 5 x--  2B2 5 x--  0F8 5 ---  0F8 5 --- }
63B7: 0025 { 0B6 3 ---  1F0 5 ---  0B7 3 ---  1F1 5 --- }
63B8: 0025 { 0F8 5 ---  0F8 5 ---  260 5 ---  270 5 --- }
63B9: 0025 { 261 5 ---  271 5 ---  262 5 ---  272 5 --- }
63BA: 0025 { 263 5 ---  273 5 ---  264 5 ---  274 5 --- }
63BB: 0025 { 265 5 ---  275 5 ---  0F8 5 ---  0F8 5 --- }
63BC: 0025 { 0F8 5 ---  0F8 5 ---  265 5 x--  275 5 x-- }
63BD: 0025 { 264 5 x--  274 5 x--  263 5 x--  273 5 x-- }
63BE: 0025 { 262 5 x--  272 5 x--  261 5 x--  271 5 x-- }
63BF: 0025 { 260 5 x--  270 5 x--  0F8 5 x--  0F8 5 x-- }
63C0: 0025 { 2AC 5 ---  286 5 ---  2AD 5 ---  2F3 5 --- }
63C1: 0025 { 2CC 5 ---  2C8 5 ---  2CD 5 ---  2D8 5 --- }
63C2: 0025 { 2DC 5 ---  2E6 5 ---  2DD 5 ---  2E7 5 --- }
63C3: 0025 { 240 5 ---  0F8 5 x--  241 5 ---  0F8 5 x-- }
63C4: 0025 { 0F8 5 ---  0F8 5 ---  2B2 5 -y-  2A2 5 -y- }
63C5: 0025 { 2E3 5 ---  2A3 5 -y-  2E3 5 x--  2A3 5 xy- }
63C6: 0025 { 2B2 5 xy-  2A2 5 xy-  0F8 5 ---  0F8 5 --- }
63C7: 0025 { 0F8 5 ---  1E2 5 -y-  0F8 5 ---  1E3 5 -y- }
63C8: 0025 { 25B 4 x--  26B 4 x--  25A 4 x--  26A 4 x-- }
63C9: 0025 { 259 4 x--  269 4 x--  0F8 5 ---  0F8 5 --- }
63CA: 0025 { 0F8 5 ---  0F8 5 ---  259 7 ---  269 7 --- }
63CB: 0025 { 25A 7 ---  26A 7 ---  25B 7 ---  26B 7 --- }
63CC: 0025 { 20D 4 --p  0F8 5 ---  26C 4 --p  27C 4 --p }
63CD: 0025 { 26D 4 --p  27D 4 --p  0F8 5 --p  0F8 5 --p }
63CE: 0025 { 22F 4 x--  23F 4 x--  22E 4 x--  23E 4 x-- }
63CF: 0025 { 20D 4 x--  0F8 5 ---  0F8 5 ---  0F8 5 --- }
63D0: 0130 { 2A4 5 ---  2B4 5 ---  2A5 5 ---  2B5 5 --- }
63D1: 0130 { 2A6 5 ---  2B6 5 ---  2A7 5 ---  2B7 5 --- }
63D2: 0130 { 2A8 5 ---  2B8 5 ---  2A9 5 ---  2B9 5 --- }
63D3: 0137 { 000 4 ---  010 4 ---  001 4 ---  011 4 --- }
63D4: 0138 { 002 4 ---  012 4 ---  003 4 ---  013 4 --- }
63D5: 0025 { 2A2 5 ---  2B2 5 ---  2A3 5 ---  2B3 5 --- }
63D6: 0025 { 2A3 5 x--  2B3 5 x--  2A2 5 x--  2B2 5 x-- }
63D7: 0025 { 1D2 5 -y-  1F0 5 ---  1D3 5 -y-  1F1 5 --- }
63D8: 0025 { 27B 4 x--  0F8 5 ---  27A 4 x--  0F8 5 --- }
63D9: 0025 { 279 4 x--  0F8 5 ---  0F8 5 ---  0F8 5 --- }
63DA: 0025 { 0F8 5 ---  0F8 5 ---  279 7 ---  0F8 5 --- }
63DB: 0025 { 27A 7 ---  0F8 5 ---  27B 7 ---  0F8 5 --- }
63DC: 0025 { 26D 4 x-p  27D 4 x-p  26C 4 x-p  27C 4 x-p }
63DD: 0025 { 20D 4 x-p  0F8 5 ---  0F8 5 --p  0F8 5 --p }
63DE: 0025 { 0F8 5 x--  0F8 5 x--  20D 4 ---  0F8 5 --- }
63DF: 0025 { 20E 4 ---  21E 4 ---  20F 4 ---  21F 4 --- }
63E0: 0130 { 2C4 5 ---  2D4 5 ---  2C5 5 ---  2D5 5 --- }
63E1: 0130 { 2F1 5 ---  2F1 5 ---  2F1 5 ---  2F1 5 --- }
63E2: 0130 { 2F1 5 ---  2F1 5 ---  2C9 5 ---  2D9 5 --- }
63E3: 0163 { 020 4 ---  020 4 ---  021 4 ---  021 4 --- }
63E4: 0164 { 022 4 ---  022 4 ---  023 4 ---  023 4 --- }
63E5: 0025 { 2B2 5 -y-  2A2 5 -y-  2E3 5 ---  2A3 5 -y- }
63E6: 0025 { 2E3 5 x--  2A3 5 xy-  2B2 5 xy-  2A2 5 xy- }
63E7: 0025 { 0F8 5 --p  26D 4 x-p  0F8 5 --p  26C 4 x-p }
63E8: 0025 { 0F8 5 --p  20D 4 x-p  0F8 5 --p  0F8 5 --p }
63E9: 0025 { 1B0 5 ---  1C0 5 ---  1B1 5 ---  1C1 5 --- }
63EA: 0025 { 1D1 4 x--  1E1 4 x--  1D0 4 x--  1E0 4 x-- }
63EB: 0025 { 1A0 4 -y-  190 4 -y-  1A1 4 -y-  191 4 -y- }
63EC: 0025 { 26D 4 ---  27D 4 ---  240 5 ---  250 5 --- }
63ED: 0025 { 24D 4 x--  25D 4 x--  24C 4 x--  25C 4 x-- }
63EE: 0025 { 24C 4 --p  25C 4 --p  24D 4 --p  25D 4 --p }
63EF: 0025 { 24E 4 ---  25E 4 ---  24F 4 ---  25F 4 --- }
63F0: 0130 { 2E4 5 ---  2F4 5 ---  2E5 5 ---  2F5 5 --- }
63F1: 0130 { 2F1 5 ---  2F6 5 ---  2F1 5 ---  2F7 5 --- }
63F2: 0130 { 2F1 5 ---  2F8 5 ---  2E9 5 ---  2F9 5 --- }
63F3: 0130 { 2F1 5 ---  2D6 5 ---  2F1 5 ---  2F1 5 --- }
63F4: 0130 { 2F1 5 ---  2F1 5 ---  2F1 5 ---  2D7 5 --- }
63F5: 0130 { 2F1 5 ---  2F1 5 ---  2C7 5 ---  2F1 5 --- }
63F6: 0130 { 2C6 5 ---  2F1 5 ---  2F1 5 ---  2F1 5 --- }
63F7: 0025 { 27D 4 x-p  1F0 5 --p  27C 4 x-p  1F1 5 --p }
63F8: 0025 { 1D1 4 x--  1E1 4 x--  1D0 4 x--  1E0 4 x-- }
63F9: 0025 { 0F8 5 ---  1C1 5 xy-  0F8 5 ---  1C0 5 xy- }
63FA: 0025 { 1E3 5 xy-  1D3 5 xy-  1E2 5 xy-  1D2 5 xy- }
63FB: 0025 { 22C 6 --p  23C 6 --p  22D 6 --p  23D 6 --p }
63FC: 0025 { 23C 7 -y-  22C 7 -y-  23D 7 -y-  22D 7 -y- }
63FD: 0025 { 20D 4 ---  0F8 5 ---  26C 4 ---  27C 4 --- }
63FE: 0025 { 0F8 5 xy-  0F8 5 xy-  0F8 5 ---  20D 4 -y- }
63FF: 0025 { 26E 4 ---  27E 4 ---  26F 4 ---  27F 4 --- }
