7900: 0130 { 16E 3 ---  1A8 2 ---  16F 3 ---  1A9 3 --- }
7901: 0130 { 170 0 ---  1AA 3 ---  171 0 ---  1AB 3 --- }
7902: 0130 { 172 0 ---  1AC 3 ---  173 0 ---  1AD 3 --- }
7903: 0130 { 174 3 ---  1AE 3 ---  175 3 ---  1AF 3 --- }
7904: 0130 { 176 0 ---  1B0 3 ---  177 0 ---  1B1 3 --- }
7905: 0130 { 176 0 ---  1B0 3 ---  178 3 ---  1B2 3 --- }
7906: 0130 { 179 3 ---  1B3 3 ---  17A 0 ---  1B4 3 --- }
7907: 0130 { 17B 0 ---  1B5 2 ---  17C 0 ---  1B6 2 --- }
7908: 0130 { 17D 0 ---  1B7 2 ---  17E 0 ---  1B8 2 --- }
7909: 0130 { 17F 3 ---  1B9 3 ---  19F 3 ---  1BA 3 --- }
790A: 0130 { 1A0 3 ---  1BB 3 ---  1A1 3 ---  1BC 3 --- }
790B: 0130 { 1A2 3 ---  1BD 3 ---  1A3 3 ---  1BE 3 --- }
790C: 0130 { 1A4 3 ---  1BF 3 ---  1A5 0 ---  1C0 2 --- }
790D: 0130 { 1A6 0 ---  1C1 2 ---  1A7 0 ---  1C2 2 --- }
790E: 0130 { 004 4 ---  3FF 7 xyp  3FF 7 xyp  004 4 --- }
790F: 0130 { 004 4 ---  3FF 7 xyp  3FF 7 xyp  004 4 --- }
7910: 0130 { 100 2 ---  117 2 ---  101 1 ---  118 1 --- }
7911: 0130 { 102 1 ---  119 1 ---  103 1 ---  11A 1 --- }
7912: 0130 { 104 1 ---  11B 1 ---  105 1 ---  11C 1 --- }
7913: 0130 { 106 1 ---  11D 1 ---  107 1 ---  11E 3 --- }
7914: 0130 { 107 1 ---  11F 1 ---  107 1 ---  120 1 --- }
7915: 0130 { 107 1 ---  121 1 ---  108 1 ---  122 3 --- }
7916: 0130 { 109 1 ---  123 1 ---  10A 1 ---  124 1 --- }
7917: 0130 { 10B 1 ---  125 1 ---  10B 1 ---  126 1 --- }
7918: 0130 { 10C 1 ---  127 1 ---  10D 1 ---  128 1 --- }
7919: 0130 { 10E 2 ---  129 3 ---  10F 3 ---  12A 3 --- }
791A: 0130 { 110 3 ---  12B 3 ---  111 2 ---  12C 2 --- }
791B: 0130 { 112 2 ---  12D 2 ---  113 2 ---  12E 2 --- }
791C: 0130 { 114 2 ---  12F 2 ---  115 2 ---  130 2 --- }
791D: 0130 { 116 2 ---  131 2 ---  116 2 ---  132 2 --- }
791E: 0130 { 004 4 ---  3FF 7 xyp  3FF 7 xyp  004 4 --- }
791F: 0130 { 004 4 ---  3FF 7 xyp  3FF 7 xyp  004 4 --- }
7920: 0130 { 133 2 ---  14F 2 ---  134 1 ---  150 2 --- }
7921: 0130 { 135 1 ---  151 0 ---  136 1 ---  151 0 --- }
7922: 0130 { 137 1 ---  151 0 ---  138 1 ---  152 0 --- }
7923: 0130 { 139 1 ---  153 1 ---  13A 3 ---  154 3 --- }
7924: 0130 { 13B 3 ---  155 3 ---  13C 3 ---  156 3 --- }
7925: 0130 { 13D 3 ---  157 3 ---  13E 3 ---  158 3 --- }
7926: 0130 { 13F 1 ---  159 3 ---  140 1 ---  15A 0 --- }
7927: 0130 { 141 3 ---  15B 0 ---  142 1 ---  15C 0 --- }
7928: 0130 { 143 1 ---  15C 0 ---  144 1 ---  15D 1 --- }
7929: 0130 { 145 3 ---  15E 3 ---  146 3 ---  15F 3 --- }
792A: 0130 { 147 3 ---  160 3 ---  148 2 ---  161 3 --- }
792B: 0130 { 149 2 ---  162 3 ---  14A 2 ---  163 2 --- }
792C: 0130 { 14B 2 ---  164 0 ---  14C 2 ---  165 0 --- }
792D: 0130 { 14D 2 ---  166 0 ---  14E 2 ---  167 2 --- }
792E: 0130 { 004 4 ---  3FF 7 xyp  3FF 7 xyp  004 4 --- }
792F: 0130 { 004 4 ---  3FF 7 xyp  3FF 7 xyp  004 4 --- }
7930: 0130 { 168 2 ---  1C7 2 ---  169 2 ---  1C8 2 --- }
7931: 0130 { 16A 0 ---  1C9 0 ---  16B 0 ---  1CA 3 --- }
7932: 0130 { 16C 0 ---  1CB 0 ---  16D 0 ---  1CC 0 --- }
7933: 0130 { 16E 2 ---  1CD 2 ---  16F 3 ---  1CE 3 --- }
7934: 0130 { 170 3 ---  1CF 3 ---  171 3 ---  1D0 3 --- }
7935: 0130 { 172 3 ---  1D1 3 ---  173 2 ---  1D2 2 --- }
7936: 0130 { 174 2 ---  1D3 2 ---  175 0 ---  1D4 3 --- }
7937: 0130 { 176 0 ---  1D5 3 ---  177 0 ---  1D6 3 --- }
7938: 0130 { 178 0 ---  1D7 3 ---  179 0 ---  1D8 3 --- }
7939: 0130 { 17A 3 ---  1D9 3 ---  17B 3 ---  1DA 3 --- }
793A: 0130 { 17C 3 ---  1DB 3 ---  17D 3 ---  1DC 3 --- }
793B: 0130 { 17E 3 ---  1DD 3 ---  17F 2 ---  1DE 2 --- }
793C: 0130 { 1C3 0 ---  1DF 2 ---  1C4 0 ---  1E0 2 --- }
793D: 0130 { 1C5 0 ---  1E1 2 ---  1C6 0 ---  1E2 2 --- }
793E: 0130 { 004 4 ---  3FF 7 xyp  3FF 7 xyp  004 4 --- }
793F: 0130 { 004 4 ---  3FF 7 xyp  3FF 7 xyp  004 4 --- }
7940: 0130 { 100 2 ---  10F 2 ---  101 1 ---  110 1 --- }
7941: 0130 { 102 1 ---  111 2 ---  102 1 ---  112 2 --- }
7942: 0130 { 102 1 ---  113 2 ---  102 1 ---  114 2 --- }
7943: 0130 { 102 1 ---  115 2 ---  103 2 ---  116 3 --- }
7944: 0130 { 104 3 ---  117 3 ---  105 1 ---  118 3 --- }
7945: 0130 { 102 1 ---  119 3 ---  106 1 ---  11A 3 --- }
7946: 0130 { 107 3 ---  11B 3 ---  108 2 ---  11C 2 --- }
7947: 0130 { 109 2 ---  11D 2 ---  109 2 ---  11E 2 --- }
7948: 0130 { 109 2 ---  11F 2 ---  109 2 ---  120 2 --- }
7949: 0130 { 109 2 ---  121 2 ---  10A 2 ---  122 2 --- }
794A: 0130 { 10B 2 ---  123 2 ---  10C 2 ---  124 2 --- }
794B: 0130 { 10D 1 ---  125 2 ---  10E 2 ---  126 2 --- }
794C: 0130 { 004 4 ---  3FF 7 xyp  3FF 7 xyp  004 4 --- }
794D: 0130 { 004 4 ---  3FF 7 xyp  3FF 7 xyp  004 4 --- }
794E: 0130 { 004 4 ---  3FF 7 xyp  3FF 7 xyp  004 4 --- }
794F: 0130 { 004 4 ---  3FF 7 xyp  3FF 7 xyp  004 4 --- }
7950: 0130 { 127 2 ---  13F 1 ---  128 1 ---  140 1 --- }
7951: 0130 { 129 2 ---  141 0 ---  12A 2 ---  142 0 --- }
7952: 0130 { 12B 2 ---  143 0 ---  12C 2 ---  144 0 --- }
7953: 0130 { 12D 2 ---  145 0 ---  12E 3 ---  146 0 --- }
7954: 0130 { 12F 3 ---  147 3 ---  130 3 ---  148 3 --- }
7955: 0130 { 131 3 ---  149 3 ---  132 3 ---  14A 3 --- }
7956: 0130 { 133 3 ---  13F 1 ---  134 2 ---  14B 1 --- }
7957: 0130 { 135 2 ---  14C 3 ---  136 2 ---  14D 3 --- }
7958: 0130 { 137 2 ---  14E 3 ---  138 2 ---  14F 3 --- }
7959: 0130 { 139 2 ---  150 3 ---  13A 2 ---  151 1 --- }
795A: 0130 { 13B 2 ---  152 1 ---  13C 2 ---  153 1 --- }
795B: 0130 { 13D 2 ---  154 1 ---  13E 2 ---  155 1 --- }
795C: 0130 { 004 4 ---  3FF 7 xyp  3FF 7 xyp  004 4 --- }
795D: 0130 { 004 4 ---  3FF 7 xyp  3FF 7 xyp  004 4 --- }
795E: 0130 { 004 4 ---  3FF 7 xyp  3FF 7 xyp  004 4 --- }
795F: 0130 { 004 4 ---  3FF 7 xyp  3FF 7 xyp  004 4 --- }
7960: 0130 { 156 1 ---  16D 1 ---  157 1 ---  16E 1 --- }
7961: 0130 { 158 0 ---  16F 1 ---  159 0 ---  170 0 --- }
7962: 0130 { 15A 0 ---  171 1 ---  15B 0 ---  172 0 --- }
7963: 0130 { 15C 0 ---  173 1 ---  15D 0 ---  174 0 --- }
7964: 0130 { 15E 0 ---  175 0 ---  15F 0 ---  176 0 --- }
7965: 0130 { 160 0 ---  177 0 ---  161 0 ---  178 0 --- }
7966: 0130 { 156 1 ---  16D 1 ---  162 1 ---  179 1 --- }
7967: 0130 { 163 0 ---  17A 1 ---  164 0 ---  17B 0 --- }
7968: 0130 { 165 0 ---  17C 0 ---  166 0 ---  17D 0 --- }
7969: 0130 { 167 0 ---  17E 0 ---  168 1 ---  17F 1 --- }
796A: 0130 { 169 1 ---  1E3 1 ---  16A 1 ---  1E4 0 --- }
796B: 0130 { 16B 1 ---  1E5 1 ---  16C 1 ---  1E6 0 --- }
796C: 0130 { 004 4 ---  3FF 7 xyp  3FF 7 xyp  004 4 --- }
796D: 0130 { 004 4 ---  3FF 7 xyp  3FF 7 xyp  004 4 --- }
796E: 0130 { 004 4 ---  3FF 7 xyp  3FF 7 xyp  004 4 --- }
796F: 0130 { 004 4 ---  3FF 7 xyp  3FF 7 xyp  004 4 --- }
7970: 0130 { 100 2 ---  114 0 ---  101 0 ---  115 0 --- }
7971: 0130 { 102 1 ---  116 0 ---  103 0 ---  117 0 --- }
7972: 0130 { 104 0 ---  118 0 ---  105 1 ---  119 0 --- }
7973: 0130 { 106 1 ---  11A 1 ---  107 1 ---  11B 2 --- }
7974: 0130 { 107 1 ---  11C 2 ---  107 1 ---  11D 2 --- }
7975: 0130 { 107 1 ---  11E 2 ---  108 3 ---  11F 2 --- }
7976: 0130 { 109 3 ---  120 2 ---  10A 3 ---  121 2 --- }
7977: 0130 { 10A 3 ---  122 2 ---  10A 3 ---  123 2 --- }
7978: 0130 { 10B 3 ---  124 2 ---  10C 3 ---  125 2 --- }
7979: 0130 { 10D 2 ---  126 2 ---  10E 2 ---  127 2 --- }
797A: 0130 { 10D 2 ---  128 2 ---  10D 2 ---  129 2 --- }
797B: 0130 { 10F 2 ---  12A 2 ---  110 2 ---  12B 2 --- }
797C: 0130 { 111 2 ---  12C 2 ---  112 2 ---  12D 0 --- }
797D: 0130 { 112 2 ---  12E 0 ---  113 2 ---  12F 2 --- }
797E: 0130 { 004 4 ---  3FF 7 xyp  3FF 7 xyp  004 4 --- }
797F: 0130 { 004 4 ---  3FF 7 xyp  3FF 7 xyp  004 4 --- }
7980: 0130 { 130 0 ---  14C 0 ---  131 1 ---  14D 0 --- }
7981: 0130 { 132 0 ---  14E 3 ---  133 2 ---  14F 0 --- }
7982: 0130 { 134 2 ---  150 3 ---  135 0 ---  151 0 --- }
7983: 0130 { 136 1 ---  152 1 ---  137 1 ---  153 2 --- }
7984: 0130 { 138 0 ---  154 2 ---  139 2 ---  155 2 --- }
7985: 0130 { 13A 0 ---  156 2 ---  13B 1 ---  157 0 --- }
7986: 0130 { 13C 2 ---  158 3 ---  13D 2 ---  159 3 --- }
7987: 0130 { 13E 2 ---  15A 3 ---  13F 2 ---  15B 3 --- }
7988: 0130 { 140 0 ---  15C 3 ---  141 2 ---  15D 0 --- }
7989: 0130 { 142 2 ---  15E 2 ---  143 2 ---  15F 2 --- }
798A: 0130 { 144 2 ---  160 2 ---  145 2 ---  161 2 --- }
798B: 0130 { 146 2 ---  162 0 ---  147 2 ---  163 2 --- }
798C: 0130 { 148 0 ---  164 2 ---  149 0 ---  165 2 --- }
798D: 0130 { 14A 2 ---  166 2 ---  14B 0 ---  167 2 --- }
798E: 0130 { 004 4 ---  3FF 7 xyp  3FF 7 xyp  004 4 --- }
798F: 0130 { 004 4 ---  3FF 7 xyp  3FF 7 xyp  004 4 --- }
7990: 0130 { 168 0 ---  184 2 ---  169 2 ---  185 2 --- }
7991: 0130 { 16A 2 ---  186 2 ---  16B 0 ---  187 2 --- }
7992: 0130 { 16C 0 ---  188 2 ---  16D 0 ---  189 0 --- }
7993: 0130 { 16E 0 ---  18A 2 ---  16F 2 ---  18B 2 --- }
7994: 0130 { 170 2 ---  18C 2 ---  171 2 ---  18D 2 --- }
7995: 0130 { 172 2 ---  18E 2 ---  173 0 ---  18F 2 --- }
7996: 0130 { 174 2 ---  190 2 ---  175 2 ---  191 2 --- }
7997: 0130 { 176 2 ---  192 2 ---  177 2 ---  193 2 --- }
7998: 0130 { 178 2 ---  194 2 ---  179 2 ---  195 2 --- }
7999: 0130 { 17A 2 ---  196 2 ---  17B 2 ---  197 2 --- }
799A: 0130 { 17C 2 ---  198 2 ---  17D 2 ---  199 2 --- }
799B: 0130 { 17E 0 ---  19A 2 ---  17F 2 ---  19B 2 --- }
799C: 0130 { 180 2 ---  19C 2 ---  181 2 ---  19D 2 --- }
799D: 0130 { 182 2 ---  19E 2 ---  183 2 ---  19F 2 --- }
799E: 0130 { 004 4 ---  3FF 7 xyp  3FF 7 xyp  004 4 --- }
799F: 0130 { 004 4 ---  3FF 7 xyp  3FF 7 xyp  004 4 --- }
79A0: 0130 { 100 2 ---  11A 2 ---  101 1 ---  11B 3 --- }
79A1: 0130 { 102 0 ---  11C 3 ---  103 0 ---  11D 3 --- }
79A2: 0130 { 104 0 ---  11E 3 ---  105 0 ---  11F 2 --- }
79A3: 0130 { 106 0 ---  120 0 ---  107 0 ---  121 0 --- }
79A4: 0130 { 108 0 ---  122 0 ---  109 3 ---  123 3 --- }
79A5: 0130 { 10A 0 ---  124 0 ---  10B 0 ---  125 0 --- }
79A6: 0130 { 10C 3 ---  126 3 ---  10D 1 ---  127 3 --- }
79A7: 0130 { 10E 1 ---  128 3 ---  10F 1 ---  129 3 --- }
79A8: 0130 { 110 1 ---  12A 3 ---  111 1 ---  12B 3 --- }
79A9: 0130 { 112 1 ---  12C 1 ---  113 1 ---  12D 3 --- }
79AA: 0130 { 114 3 ---  12E 3 ---  115 3 ---  12F 3 --- }
79AB: 0130 { 116 1 ---  130 3 ---  117 2 ---  131 2 --- }
79AC: 0130 { 118 2 ---  132 3 ---  118 2 ---  133 3 --- }
79AD: 0130 { 118 2 ---  134 3 ---  119 2 ---  135 2 --- }
79AE: 0130 { 004 4 ---  3FF 7 xyp  3FF 7 xyp  004 4 --- }
79AF: 0130 { 004 4 ---  3FF 7 xyp  3FF 7 xyp  004 4 --- }
79B0: 0130 { 136 2 ---  152 2 ---  137 3 ---  153 2 --- }
79B1: 0130 { 138 3 ---  154 2 ---  139 3 ---  155 0 --- }
79B2: 0130 { 13A 3 ---  156 2 ---  13B 3 ---  157 2 --- }
79B3: 0130 { 13C 3 ---  158 1 ---  13D 3 ---  159 3 --- }
79B4: 0130 { 13E 3 ---  15A 3 ---  13F 3 ---  15B 3 --- }
79B5: 0130 { 140 3 ---  15C 3 ---  141 3 ---  15D 3 --- }
79B6: 0130 { 142 3 ---  15E 3 ---  143 3 ---  15F 3 --- }
79B7: 0130 { 144 3 ---  160 3 ---  145 3 ---  161 3 --- }
79B8: 0130 { 146 3 ---  162 3 ---  147 3 ---  163 3 --- }
79B9: 0130 { 148 1 ---  164 1 ---  149 1 ---  165 3 --- }
79BA: 0130 { 14A 3 ---  166 3 ---  14B 1 ---  167 3 --- }
79BB: 0130 { 14C 2 ---  168 3 ---  14D 2 ---  169 1 --- }
79BC: 0130 { 14E 3 ---  16A 2 ---  14F 3 ---  16B 2 --- }
79BD: 0130 { 150 3 ---  16C 2 ---  151 2 ---  16D 2 --- }
79BE: 0130 { 004 4 ---  3FF 7 xyp  3FF 7 xyp  004 4 --- }
79BF: 0130 { 004 4 ---  3FF 7 xyp  3FF 7 xyp  004 4 --- }
79C0: 0130 { 16E 2 ---  1AA 2 ---  16F 2 ---  1AB 2 --- }
79C1: 0130 { 170 2 ---  1AC 2 ---  171 2 ---  1AD 0 --- }
79C2: 0130 { 172 2 ---  1AE 2 ---  173 2 ---  1AF 2 --- }
79C3: 0130 { 174 2 ---  1B0 2 ---  175 0 ---  1B1 2 --- }
79C4: 0130 { 176 3 ---  1B2 3 ---  177 3 ---  1B3 3 --- }
79C5: 0130 { 178 3 ---  1B4 3 ---  179 2 ---  1B5 2 --- }
79C6: 0130 { 17A 3 ---  1B6 2 ---  17B 3 ---  1B7 2 --- }
79C7: 0130 { 17C 3 ---  1B8 3 ---  17D 3 ---  1B9 3 --- }
79C8: 0130 { 17E 3 ---  1BA 3 ---  17F 3 ---  1BB 2 --- }
79C9: 0130 { 1A0 2 ---  1BC 2 ---  1A1 2 ---  1BD 2 --- }
79CA: 0130 { 1A2 2 ---  1BE 2 ---  1A3 2 ---  1BF 3 --- }
79CB: 0130 { 1A4 2 ---  1C0 2 ---  1A5 2 ---  1C1 2 --- }
79CC: 0130 { 1A6 2 ---  1C2 2 ---  1A7 2 ---  1C3 2 --- }
79CD: 0130 { 1A8 2 ---  1C4 2 ---  1A9 2 ---  1C5 2 --- }
79CE: 0130 { 004 4 ---  3FF 7 xyp  3FF 7 xyp  004 4 --- }
79CF: 0130 { 004 4 ---  3FF 7 xyp  3FF 7 xyp  004 4 --- }
79D0: 0130 { 100 2 ---  117 0 ---  101 1 ---  118 1 --- }
79D1: 0130 { 102 1 ---  119 1 ---  102 1 ---  11A 1 --- }
79D2: 0130 { 102 1 ---  11B 1 ---  103 1 ---  11C 1 --- }
79D3: 0130 { 104 1 ---  11D 1 ---  105 1 ---  11E 3 --- }
79D4: 0130 { 106 1 ---  11F 3 ---  102 1 ---  120 2 --- }
79D5: 0130 { 107 1 ---  121 2 ---  108 1 ---  122 2 --- }
79D6: 0130 { 109 2 ---  123 2 ---  10A 2 ---  124 2 --- }
79D7: 0130 { 10A 2 ---  125 2 ---  10A 2 ---  126 2 --- }
79D8: 0130 { 10B 2 ---  127 0 ---  10C 2 ---  128 2 --- }
79D9: 0130 { 10D 3 ---  129 3 ---  10E 3 ---  12A 3 --- }
79DA: 0130 { 10F 2 ---  12B 3 ---  110 2 ---  12C 2 --- }
79DB: 0130 { 111 3 ---  12D 3 ---  112 2 ---  12E 2 --- }
79DC: 0130 { 113 2 ---  12F 0 ---  114 2 ---  130 0 --- }
79DD: 0130 { 115 2 ---  131 0 ---  116 2 ---  132 0 --- }
79DE: 0130 { 004 4 ---  3FF 7 xyp  3FF 7 xyp  004 4 --- }
79DF: 0130 { 004 4 ---  3FF 7 xyp  3FF 7 xyp  004 4 --- }
79E0: 0130 { 133 0 ---  14F 1 ---  134 1 ---  150 1 --- }
79E1: 0130 { 135 1 ---  151 1 ---  136 1 ---  152 1 --- }
79E2: 0130 { 137 1 ---  153 1 ---  138 1 ---  154 1 --- }
79E3: 0130 { 139 1 ---  155 0 ---  13A 3 ---  156 3 --- }
79E4: 0130 { 13B 3 ---  157 3 ---  13C 3 ---  158 3 --- }
79E5: 0130 { 13D 3 ---  159 3 ---  13E 1 ---  15A 1 --- }
79E6: 0130 { 13F 2 ---  15B 0 ---  140 2 ---  15C 0 --- }
79E7: 0130 { 141 2 ---  15D 0 ---  142 2 ---  15E 0 --- }
79E8: 0130 { 143 1 ---  15F 0 ---  144 1 ---  160 1 --- }
79E9: 0130 { 145 3 ---  161 3 ---  146 3 ---  162 1 --- }
79EA: 0130 { 147 3 ---  163 1 ---  148 3 ---  164 3 --- }
79EB: 0130 { 149 3 ---  165 1 ---  14A 2 ---  166 0 --- }
79EC: 0130 { 14B 0 ---  167 0 ---  14C 0 ---  168 0 --- }
79ED: 0130 { 14D 0 ---  169 0 ---  14E 0 ---  16A 0 --- }
79EE: 0130 { 004 4 ---  3FF 7 xyp  3FF 7 xyp  004 4 --- }
79EF: 0130 { 004 4 ---  3FF 7 xyp  3FF 7 xyp  004 4 --- }
79F0: 0130 { 16B 1 ---  1CD 1 ---  16C 0 ---  1CE 1 --- }
79F1: 0130 { 16D 1 ---  1CF 1 ---  16E 0 ---  1D0 1 --- }
79F2: 0130 { 16F 1 ---  1D1 1 ---  170 1 ---  1D2 1 --- }
79F3: 0130 { 171 0 ---  1D3 0 ---  172 0 ---  1D4 1 --- }
79F4: 0130 { 173 0 ---  1D5 1 ---  174 0 ---  1D6 1 --- }
79F5: 0130 { 175 0 ---  1D7 1 ---  176 1 ---  1D8 1 --- }
79F6: 0130 { 177 0 ---  1D9 0 ---  178 0 ---  1DA 0 --- }
79F7: 0130 { 179 0 ---  1DB 0 ---  17A 0 ---  1DC 0 --- }
79F8: 0130 { 17B 0 ---  1DD 0 ---  17C 1 ---  1DE 0 --- }
79F9: 0130 { 17D 0 ---  1DF 1 ---  17E 1 ---  1E0 1 --- }
79FA: 0130 { 17F 0 ---  1E1 1 ---  1C6 1 ---  1E2 1 --- }
79FB: 0130 { 1C7 1 ---  1E3 1 ---  1C8 0 ---  1D3 0 x-- }
79FC: 0130 { 1C9 0 ---  1E4 0 ---  1CA 0 ---  1E5 0 --- }
79FD: 0130 { 1CB 0 ---  1E6 0 ---  1CC 0 ---  1E7 0 --- }
79FE: 0130 { 004 4 ---  3FF 7 xyp  3FF 7 xyp  004 4 --- }
79FF: 0130 { 004 4 ---  3FF 7 xyp  3FF 7 xyp  004 4 --- }
