1300: 0040 { 0F8 6 ---  10A 6 ---  0F8 6 ---  10B 6 --- }
1301: 0040 { 0F8 5 x--  10B 5 x--  0F8 5 x--  10A 5 x-- }
1302: 0040 { 0F8 4 ---  10A 2 ---  0F8 4 ---  10B 2 --- }
1303: 0040 { 12A 6 -y-  11A 6 -y-  12B 6 -y-  11B 6 -y- }
1304: 0040 { 12B 5 xy-  11B 5 xy-  12A 5 xy-  11A 5 xy- }
1305: 0040 { 12A 2 -y-  11A 2 -y-  12B 2 -y-  11B 2 -y- }
1306: 0040 { 10C 5 ---  11C 5 ---  10D 5 ---  11D 5 --- }
1307: 0040 { 10D 5 x--  11D 5 x--  10C 5 x--  11C 5 x-- }
1308: 0040 { 10E 5 ---  11E 5 ---  10E 5 x--  11E 5 x-- }
1309: 0137 { 000 5 ---  010 5 ---  001 5 ---  011 5 --- }
130A: 0138 { 002 5 ---  012 5 ---  003 5 ---  013 5 --- }
130B: 013F { 024 5 ---  034 5 ---  025 5 ---  035 5 --- }
130C: 0130 { 000 5 ---  010 5 ---  001 5 ---  011 5 --- }
130D: 0130 { 002 5 ---  012 5 ---  003 5 ---  013 5 --- }
130E: 0130 { 004 5 ---  014 5 ---  005 5 ---  015 5 --- }
130F: 0130 { 02E 5 ---  03E 5 ---  02E 5 ---  03E 5 --- }
1310: 0040 { 11A 6 ---  12A 6 ---  11B 6 ---  12B 6 --- }
1311: 0040 { 11B 5 x--  12B 5 x--  11A 5 x--  12A 5 x-- }
1312: 0040 { 11A 2 ---  12A 2 ---  11B 2 ---  12B 2 --- }
1313: 0040 { 10A 6 -y-  0F8 6 -y-  10B 6 -y-  0F8 6 -y- }
1314: 0040 { 10B 5 xy-  0F8 5 xy-  10A 5 xy-  0F8 5 xy- }
1315: 0040 { 10A 2 -y-  0F8 4 -y-  10B 2 -y-  0F8 4 -y- }
1316: 0040 { 11C 5 -y-  10C 5 -y-  11D 5 -y-  10D 5 -y- }
1317: 0040 { 11D 5 xy-  10D 5 xy-  11C 5 xy-  10C 5 xy- }
1318: 0040 { 11E 5 -y-  10E 5 -y-  11E 5 xy-  10E 5 xy- }
1319: 0137 { 000 6 ---  010 6 ---  001 6 ---  011 6 --- }
131A: 0138 { 002 6 ---  012 6 ---  003 6 ---  013 6 --- }
131B: 013F { 024 6 ---  034 6 ---  025 6 ---  035 6 --- }
131C: 0130 { 020 5 ---  020 5 ---  021 5 ---  021 5 --- }
131D: 0130 { 022 5 ---  022 5 ---  023 5 ---  023 5 --- }
131E: 0130 { 024 5 ---  034 5 ---  025 5 ---  035 5 --- }
131F: 0130 { 02F 5 ---  03F 5 ---  02F 5 ---  03F 5 --- }
1320: 0040 { 0F8 6 ---  110 5 ---  0F8 6 ---  111 5 --- }
1321: 0040 { 0F8 5 ---  112 5 ---  0F8 5 ---  113 5 --- }
1322: 0040 { 0F8 6 ---  113 5 x--  0F8 6 ---  112 5 x-- }
1323: 0040 { 0F8 5 ---  111 5 x--  0F8 5 ---  110 5 x-- }
1324: 0040 { 0F8 2 ---  110 2 ---  0F8 2 ---  111 2 --- }
1325: 0040 { 0F8 2 ---  112 2 ---  0F8 2 ---  113 2 --- }
1326: 0040 { 0F8 2 ---  113 2 x--  0F8 2 ---  112 2 x-- }
1327: 0040 { 0F8 2 ---  111 2 x--  0F8 2 ---  110 2 x-- }
1328: 0040 { 1E7 2 ---  1EA 2 ---  1E7 2 x--  1EA 2 x-- }
1329: 0137 { 000 7 ---  010 7 ---  001 7 ---  011 7 --- }
132A: 0138 { 002 7 ---  012 7 ---  003 7 ---  013 7 --- }
132B: 013F { 024 7 ---  034 7 ---  025 7 ---  035 7 --- }
132C: 0130 { 000 6 ---  010 6 ---  001 6 ---  011 6 --- }
132D: 0130 { 002 6 ---  012 6 ---  003 6 ---  013 6 --- }
132E: 0130 { 004 6 ---  014 6 ---  005 6 ---  015 6 --- }
132F: 0130 { 02E 6 ---  03E 6 ---  02E 6 ---  03E 6 --- }
1330: 0040 { 120 5 ---  130 5 ---  121 5 ---  131 5 --- }
1331: 0040 { 122 5 ---  132 5 ---  123 5 ---  133 5 --- }
1332: 0040 { 123 5 x--  133 5 x--  122 5 x--  132 5 x-- }
1333: 0040 { 121 5 x--  131 5 x--  120 5 x--  130 5 x-- }
1334: 0040 { 120 2 ---  130 2 ---  121 2 ---  131 2 --- }
1335: 0040 { 122 2 ---  132 2 ---  123 2 ---  133 2 --- }
1336: 0040 { 123 2 x--  133 2 x--  122 2 x--  132 2 x-- }
1337: 0040 { 121 2 x--  131 2 x--  120 2 x--  130 2 x-- }
1338: 0116 { 0F8 4 ---  0F8 4 ---  0F8 4 ---  0F8 4 --- }
1339: 0137 { 000 0 ---  010 0 ---  001 0 ---  011 0 --- }
133A: 0138 { 002 0 ---  012 0 ---  003 0 ---  013 0 --- }
133B: 013F { 024 0 ---  034 0 ---  025 0 ---  035 0 --- }
133C: 0130 { 020 6 ---  020 6 ---  021 6 ---  021 6 --- }
133D: 0130 { 022 6 ---  022 6 ---  023 6 ---  023 6 --- }
133E: 0130 { 024 6 ---  034 6 ---  025 6 ---  035 6 --- }
133F: 0130 { 02F 6 ---  03F 6 ---  02F 6 ---  03F 6 --- }
1340: 0040 { 1DA 1 ---  1DC 1 ---  1DB 1 ---  1DD 1 --- }
1341: 0100 { 1D8 1 ---  1DA 1 ---  1D9 1 ---  1DB 1 --- }
1342: 0100 { 1D9 1 x--  1DA 1 ---  1D8 1 x--  1DB 1 --- }
1343: 0100 { 1D9 1 ---  0F8 5 ---  1D9 1 ---  0F8 2 --- }
1344: 01E2 { 192 2 -y-  186 2 -y-  193 2 -y-  195 2 -y- }
1345: 0040 { 1C0 1 ---  1D0 1 ---  1C0 1 x--  1D0 1 x-- }
1346: 01E4 { 192 2 -y-  194 2 -y-  193 2 -y-  186 2 xy- }
1347: 0040 { 1C0 1 ---  1D0 1 ---  195 1 ---  193 1 --- }
1348: 0044 { 192 1 -y-  194 1 -y-  193 1 -y-  195 1 -y- }
1349: 0041 { 194 1 ---  192 1 ---  1C0 1 x--  1D0 1 x-- }
134A: 0040 { 0F8 1 ---  1D1 1 x--  1D1 1 x--  195 1 --- }
134B: 0040 { 1D1 1 ---  193 1 ---  0F8 1 ---  1D1 1 --- }
134C: 0130 { 000 7 ---  010 7 ---  001 7 ---  011 7 --- }
134D: 0130 { 002 7 ---  012 7 ---  003 7 ---  013 7 --- }
134E: 0130 { 004 7 ---  014 7 ---  005 7 ---  015 7 --- }
134F: 0130 { 02E 7 ---  03E 7 ---  02E 7 ---  03E 7 --- }
1350: 0040 { 1DC 1 ---  1DC 1 ---  1DD 1 ---  1DD 1 --- }
1351: ~
1352: ~
1353: ~
1354: ~
1355: ~
1356: ~
1357: ~
1358: ~
1359: ~
135A: 0040 { 1D1 1 xy-  0F8 1 ---  193 1 ---  1D1 1 xy- }
135B: 0040 { 194 1 ---  1D1 1 -y-  1D1 1 -y-  0F8 1 --- }
135C: 0130 { 020 7 ---  020 7 ---  021 7 ---  021 7 --- }
135D: 0130 { 022 7 ---  022 7 ---  023 7 ---  023 7 --- }
135E: 0130 { 024 7 ---  034 7 ---  025 7 ---  035 7 --- }
135F: 0130 { 02F 7 ---  03F 7 ---  02F 7 ---  03F 7 --- }
1360: ~
1361: ~
1362: ~
1363: ~
1364: ~
1365: ~
1366: ~
1367: ~
1368: ~
1369: ~
136A: ~
136B: ~
136C: 0130 { 000 0 ---  010 0 ---  001 0 ---  011 0 --- }
136D: 0130 { 002 0 ---  012 0 ---  003 0 ---  013 0 --- }
136E: 0130 { 004 0 ---  014 0 ---  005 0 ---  015 0 --- }
136F: 0130 { 02E 0 ---  03E 0 ---  02E 0 ---  03E 0 --- }
1370: ~
1371: ~
1372: ~
1373: ~
1374: ~
1375: ~
1376: ~
1377: ~
1378: ~
1379: ~
137A: ~
137B: ~
137C: 0130 { 020 0 ---  020 0 ---  021 0 ---  021 0 --- }
137D: 0130 { 022 0 ---  022 0 ---  023 0 ---  023 0 --- }
137E: 0130 { 024 0 ---  034 0 ---  025 0 ---  035 0 --- }
137F: 0130 { 02F 0 ---  03F 0 ---  02F 0 ---  03F 0 --- }
1380: ~
1381: ~
1382: ~
1383: ~
1384: ~
1385: ~
1386: ~
1387: ~
1388: ~
1389: ~
138A: ~
138B: ~
138C: ~
138D: ~
138E: ~
138F: ~
1390: ~
1391: ~
1392: ~
1393: ~
1394: ~
1395: ~
1396: ~
1397: ~
1398: ~
1399: ~
139A: ~
139B: ~
139C: ~
139D: ~
139E: ~
139F: ~
13A0: ~
13A1: ~
13A2: ~
13A3: ~
13A4: ~
13A5: ~
13A6: ~
13A7: ~
13A8: ~
13A9: ~
13AA: ~
13AB: ~
13AC: ~
13AD: ~
13AE: ~
13AF: ~
13B0: ~
13B1: ~
13B2: ~
13B3: ~
13B4: ~
13B5: ~
13B6: ~
13B7: ~
13B8: ~
13B9: ~
13BA: ~
13BB: ~
13BC: ~
13BD: ~
13BE: ~
13BF: ~
13C0: ~
13C1: ~
13C2: ~
13C3: ~
13C4: ~
13C5: ~
13C6: ~
13C7: ~
13C8: ~
13C9: ~
13CA: ~
13CB: ~
13CC: ~
13CD: ~
13CE: ~
13CF: ~
13D0: ~
13D1: ~
13D2: ~
13D3: ~
13D4: ~
13D5: ~
13D6: ~
13D7: ~
13D8: ~
13D9: ~
13DA: ~
13DB: ~
13DC: ~
13DD: ~
13DE: ~
13DF: ~
13E0: ~
13E1: ~
13E2: ~
13E3: ~
13E4: ~
13E5: ~
13E6: ~
13E7: ~
13E8: ~
13E9: ~
13EA: ~
13EB: ~
13EC: ~
13ED: ~
13EE: ~
13EF: ~
13F0: ~
13F1: ~
13F2: ~
13F3: ~
13F4: ~
13F5: ~
13F6: ~
13F7: ~
13F8: ~
13F9: ~
13FA: ~
13FB: ~
13FC: ~
13FD: ~
13FE: ~
13FF: ~
