2000: 0130 { 180 6 ---  190 6 ---  181 6 ---  191 6 --- }
2001: 0130 { 182 6 ---  192 6 ---  183 6 ---  193 6 --- }
2002: 0130 { 184 6 ---  194 6 ---  185 6 ---  195 6 --- }
2003: 0025 { 0F8 4 ---  0F8 4 ---  0F8 4 ---  186 4 --- }
2004: 0025 { 0F8 4 ---  187 4 ---  0F8 4 ---  188 4 --- }
2005: 0025 { 0F8 4 ---  189 4 ---  0F8 4 ---  0F8 4 --- }
2006: 0025 { 0F8 4 x--  0F8 4 x--  0F8 4 x--  189 4 x-- }
2007: 0025 { 0F8 4 x--  188 4 x--  0F8 4 x--  187 4 x-- }
2008: 0025 { 0F8 4 x--  186 4 x--  0F8 4 x--  0F8 4 x-- }
2009: 0025 { 18A 4 ---  19A 4 ---  18B 4 ---  19B 4 --- }
200A: 0025 { 18C 4 ---  19C 4 ---  0F8 4 x--  0F8 4 x-- }
200B: 0130 { 0FA 4 ---  0FA 4 ---  0FA 4 ---  0FA 4 --- }
200C: 0100 { 18D 4 ---  19D 4 ---  18E 4 ---  19E 4 --- }
200D: 0100 { 18F 4 ---  0F8 4 x--  18F 4 ---  0F8 4 x-- }
200E: 0100 { 1AD 4 ---  19D 4 ---  1AE 4 ---  19E 4 --- }
200F: 0025 { 0F8 4 x--  1F7 4 ---  0F8 4 x--  1F8 4 --- }
2010: 0130 { 1A4 6 ---  1B4 6 ---  1A5 6 ---  1B5 6 --- }
2011: 0006 { 082 4 ---  082 4 ---  082 4 x--  082 4 x-- }
2012: 0130 { 1A4 6 ---  1B4 6 ---  1A5 6 ---  1B5 6 --- }
2013: 0025 { 0F8 4 ---  0F8 4 ---  196 4 ---  1A6 4 --- }
2014: 0020 { 197 4 ---  1A7 4 ---  198 4 ---  1A8 4 --- }
2015: 0025 { 199 4 ---  1A9 4 ---  0F8 4 ---  0F8 4 --- }
2016: 0025 { 0F8 4 x--  0F8 4 x--  199 4 x--  1A9 4 x-- }
2017: 0020 { 198 4 x--  1A8 4 x--  197 4 x--  1A7 4 x-- }
2018: 0025 { 196 4 x--  1A6 4 x--  0F8 4 x--  0F8 4 x-- }
2019: 0025 { 1AA 4 ---  1BA 4 ---  1AB 4 ---  1BB 4 --- }
201A: 0025 { 1AC 4 ---  1BC 4 ---  0F8 4 x--  0F8 4 x-- }
201B: 0025 { 0F8 4 x--  1FF 4 ---  0F8 4 x--  0F8 4 x-- }
201C: 0025 { 0F8 4 x--  0F8 4 x--  0F8 4 x--  1B8 4 --- }
201D: 0025 { 0F8 4 x--  0F8 4 x--  0F8 4 x--  1B9 4 --- }
201E: 0025 { 0F8 4 x--  1BE 4 ---  0F8 4 x--  1BF 4 --- }
201F: 0025 { 0F8 4 x--  1D0 4 ---  0F8 4 x--  1D1 4 --- }
2020: 0130 { 1A0 6 ---  1B0 6 ---  1A1 6 ---  1B1 6 --- }
2021: 0130 { 182 6 ---  192 6 ---  183 6 ---  193 6 --- }
2022: 0130 { 1A2 6 ---  1B2 6 ---  1A3 6 ---  1B3 6 --- }
2023: 0025 { 0F8 4 ---  0F8 4 ---  1B6 4 ---  1C6 4 --- }
2024: 0020 { 1B7 4 ---  1C7 4 ---  1C8 4 ---  1C8 4 --- }
2025: 0025 { 1C9 4 ---  1C9 4 ---  0F8 4 ---  0F8 4 --- }
2026: 0025 { 0F8 4 x--  0F8 4 x--  1C9 4 x--  1C9 4 x-- }
2027: 0020 { 1C8 4 x--  1C8 4 x--  1B7 4 x--  1C7 4 x-- }
2028: 0025 { 1B6 4 x--  1C6 4 x--  0F8 4 x--  0F8 4 x-- }
2029: 0025 { 0F8 4 x--  0F8 4 x--  0F8 4 x--  1AF 4 --- }
202A: 0025 { 0F8 4 x--  1F9 4 ---  0F8 4 x--  1FA 4 --- }
202B: 0025 { 0F8 4 x--  0F8 4 x--  0F8 4 x--  19F 3 --- }
202C: 0100 { 1CA 4 ---  19D 4 ---  1CB 4 ---  19E 4 --- }
202D: 0100 { 1CC 4 ---  0F8 4 x--  1CD 4 ---  0F8 4 x-- }
202E: 0100 { 1CE 4 ---  19D 4 ---  1CF 4 ---  19E 4 --- }
202F: 0025 { 1E0 4 ---  1F0 3 ---  1E1 4 ---  1F1 3 --- }
2030: 0025 { 0F8 4 ---  1C2 4 ---  0F8 4 ---  1C3 4 --- }
2031: 0025 { 0F8 4 ---  1C4 4 ---  0F8 4 ---  1C5 4 --- }
2032: 0025 { 0F8 4 x--  0F8 4 x--  0F8 4 x--  1BD 4 --- }
2033: 0100 { 1D2 4 ---  1F2 4 -y-  1D3 4 x--  1F3 4 xy- }
2034: 0100 { 1D3 4 ---  1F3 4 -y-  1D4 4 ---  1F4 4 -y- }
2035: 0100 { 1D5 4 ---  1F5 4 -y-  1D6 4 ---  1F6 4 -y- }
2036: 0100 { 1D7 4 ---  1E7 4 ---  1D8 4 ---  1E9 4 x-- }
2037: 0100 { 1D8 4 ---  1E9 4 ---  1DA 4 ---  1EA 4 --- }
2038: 0025 { 1D6 4 ---  1F6 4 -y-  0F8 4 x--  0F8 4 x-- }
2039: 0025 { 0F8 4 x--  1D9 4 ---  0F8 4 x--  1DF 4 --- }
203A: 0025 { 0F8 4 x--  1EC 4 ---  0F8 4 x--  0F8 4 x-- }
203B: 0100 { 1DB 4 ---  1EB 4 ---  1DC 4 ---  0F9 4 --- }
203C: 0100 { 1DC 4 ---  0F9 4 ---  1DD 4 ---  1ED 4 --- }
203D: 0025 { 1DE 4 ---  1EE 4 ---  0F8 4 x--  0F8 4 x-- }
203E: 0025 { 207 2 ---  217 2 ---  208 2 ---  218 2 --- }
203F: 0025 { 209 4 ---  219 4 ---  0F8 4 x--  0F8 4 x-- }
2040: 0100 { 1C0 4 ---  0F8 4 ---  1C1 4 ---  0F8 4 --- }
2041: 0100 { 1C1 4 ---  0F8 4 ---  1C1 4 ---  0F8 4 --- }
2042: 0100 { 1C1 4 x--  0F8 4 ---  1C0 4 x--  0F8 4 --- }
2043: 0025 { 1E2 4 ---  1F2 4 ---  1E3 4 x--  1F3 4 x-- }
2044: 0025 { 1E3 4 ---  1F3 4 ---  1E4 4 ---  1F4 4 --- }
2045: 0025 { 1E5 4 ---  1F5 4 ---  1E6 4 ---  1F6 4 --- }
2046: 0025 { 1E8 4 ---  1E8 4 -y-  0FA 4 ---  0FA 4 --- }
2047: 0025 { 0FA 4 ---  0FA 4 ---  278 4 ---  279 4 --- }
2048: 0025 { 1E6 4 ---  1F6 4 ---  0F8 4 x--  0F8 4 x-- }
2049: 0025 { 1EF 4 ---  0F8 4 x--  1FB 4 ---  200 4 --- }
204A: 0025 { 1FC 4 ---  201 4 ---  0F8 4 x--  0F8 4 x-- }
204B: 0025 { 1EB 4 ---  1DB 4 ---  0F9 4 ---  1DC 4 --- }
204C: 0025 { 0F9 4 ---  1DC 4 ---  1FD 4 ---  1DD 4 --- }
204D: 0025 { 1FE 4 ---  1DE 4 ---  0F8 4 x--  0F8 4 x-- }
204E: 0025 { 227 4 ---  1BA 4 ---  228 4 ---  229 4 --- }
204F: 0025 { 1AC 4 ---  1BC 4 ---  0F8 4 x--  0F8 4 x-- }
2050: 0100 { 20A 4 ---  21A 4 ---  20B 4 ---  21B 4 --- }
2051: 0100 { 20C 4 ---  21B 4 ---  20D 4 ---  21C 4 --- }
2052: 0025 { 1DE 4 ---  1EE 4 ---  0F8 4 x--  0F8 4 x-- }
2053: 0025 { 0F8 4 ---  20F 3 x--  0F8 4 ---  20E 3 x-- }
2054: 0025 { 18C 4 x--  19C 4 x--  18B 4 x--  19B 4 x-- }
2055: 0025 { 18A 4 x--  19A 4 x--  0F8 4 x--  0F8 4 x-- }
2056: 0025 { 0F8 4 x--  202 3 ---  0F8 4 x--  203 3 --- }
2057: 0025 { 0F8 4 x--  204 3 ---  0F8 4 x--  205 3 --- }
2058: 0025 { 0F8 4 x--  206 3 ---  0F8 4 x--  0F8 4 x-- }
2059: 0025 { 0F8 4 x--  0F8 4 x--  210 3 ---  220 3 --- }
205A: 0025 { 211 3 ---  221 3 ---  0F8 4 x--  0F8 4 x-- }
205B: 0025 { 1EB 4 ---  1EB 4 ---  0F9 4 ---  0F9 4 --- }
205C: 0025 { 0F9 4 ---  0F9 4 ---  1ED 4 ---  1FD 4 --- }
205D: 0025 { 1EE 4 ---  1EE 4 ---  0F8 4 x--  0F8 4 x-- }
205E: 0025 { 0F8 4 ---  283 4 ---  209 4 x--  219 4 x-- }
205F: 0025 { 208 2 x--  218 2 x--  207 2 x--  217 2 x-- }
2060: 0025 { 22A 4 ---  213 4 ---  22B 4 ---  214 4 --- }
2061: 0025 { 22B 4 ---  214 4 ---  22C 4 ---  21D 4 --- }
2062: 0025 { 1EE 4 ---  1FE 4 ---  0F8 4 x--  0F8 4 x-- }
2063: 0025 { 21F 3 x--  22F 3 x--  21E 3 x--  22E 3 x-- }
2064: 0025 { 1AC 4 x--  1BC 4 x--  1AB 4 x--  1BB 4 x-- }
2065: 0025 { 1AA 4 x--  1BA 4 x--  0F8 4 x--  0F8 4 x-- }
2066: 0025 { 212 3 ---  222 3 ---  0FA 3 ---  223 3 --- }
2067: 0025 { 0FA 3 ---  224 3 ---  215 3 ---  225 3 --- }
2068: 0025 { 216 3 ---  216 3 ---  0F8 4 x--  0F8 4 x-- }
2069: 0020 { 0D3 4 x--  0E3 4 x--  0D2 4 x--  0E2 4 x-- }
206A: 0020 { 0D2 4 ---  0E2 4 ---  0D3 4 ---  0E3 4 --- }
206B: 0025 { 1EB 4 ---  1EB 4 ---  0F9 4 ---  0F9 4 --- }
206C: 0025 { 0F9 4 ---  0F9 4 ---  1FD 4 ---  1FD 4 --- }
206D: 0025 { 1EE 4 ---  1FE 4 ---  0F8 4 x--  0F8 4 x-- }
206E: 0025 { 0F8 4 ---  0F8 4 ---  1AC 4 x--  1BC 4 x-- }
206F: 0025 { 228 4 x--  229 4 x--  227 4 x--  1BA 4 x-- }
2070: 0025 { 293 3 ---  2A3 3 ---  294 3 ---  2A4 3 --- }
2071: 0025 { 294 3 x--  2A4 3 x--  293 3 x--  2A3 3 x-- }
2072: 0025 { 290 3 ---  0F8 3 ---  291 3 ---  2A1 3 --- }
2073: 0025 { 292 3 ---  2A2 3 ---  0F8 3 ---  2A1 3 xy- }
2074: 0025 { 0F8 3 x--  2A1 3 -y-  292 3 x--  2A2 3 x-- }
2075: 0025 { 291 3 x--  2A1 3 x--  290 3 x--  0F8 3 x-- }
2076: 0137 { 1D0 4 ---  1E0 4 ---  1D1 4 ---  1E1 4 --- }
2077: 0138 { 1D2 4 ---  1E2 4 ---  1D3 4 ---  1E3 4 --- }
2078: 0130 { 0B5 4 ---  0C5 4 ---  0D6 4 ---  0E6 4 --- }
2079: 0020 { 0F3 4 x--  0F3 4 xy-  0F2 4 x--  0F2 4 xy- }
207A: 0020 { 0F2 4 ---  0F2 4 -y-  0F3 4 ---  0F3 4 -y- }
207B: 0025 { 0D3 4 x--  0E3 4 x--  0D2 4 x--  0E2 4 x-- }
207C: 0025 { 0D2 4 ---  0E2 4 ---  0D3 4 ---  0E3 4 --- }
207D: 0025 { 202 3 ---  212 3 ---  203 3 ---  0FA 3 --- }
207E: 0025 { 204 3 ---  0FA 3 ---  205 3 ---  215 3 --- }
207F: 0025 { 206 3 ---  216 3 ---  0F8 4 x--  0F8 4 x-- }
2080: 0025 { 2B3 3 ---  2C3 3 ---  2B4 3 ---  2C4 3 --- }
2081: 0025 { 2B4 3 x--  2C4 3 x--  2B3 3 x--  2C3 3 x-- }
2082: 0025 { 2A1 3 xy-  2A2 3 ---  0F8 3 ---  2A1 3 xy- }
2083: 0025 { 2A1 3 ---  0F8 3 ---  2A2 3 ---  2A1 3 --- }
2084: 0025 { 2A2 3 x--  2A1 3 x--  2A1 3 x--  0F8 3 x-- }
2085: 0025 { 0F8 3 x--  2A1 3 -y-  2A1 3 -y-  2A2 3 x-- }
2086: 0137 { 1F0 4 ---  1D0 4 ---  1F1 4 ---  1D1 4 --- }
2087: 0138 { 1F2 4 ---  1D2 4 ---  1F3 4 ---  1D3 4 --- }
2088: 0025 { 2A0 3 ---  2B0 3 ---  2A0 3 x--  2B0 3 x-- }
2089: 0020 { 0E3 4 xy-  0D3 4 xy-  0E2 4 xy-  0D2 4 xy- }
208A: 0020 { 0E2 4 -y-  0D2 4 -y-  0E3 4 -y-  0D3 4 -y- }
208B: 0025 { 0F3 4 x--  0F3 4 xy-  0F2 4 x--  0F2 4 xy- }
208C: 0025 { 0F2 4 ---  0F2 4 -y-  0F3 4 ---  0F3 4 -y- }
208D: 0025 { 222 3 ---  18D 4 ---  223 3 ---  18E 4 --- }
208E: 0025 { 224 3 ---  18F 4 ---  225 3 ---  1AD 4 --- }
208F: 0025 { 216 3 ---  1AE 4 ---  0F8 4 x--  0F8 4 x-- }
2090: 0025 { 2D3 3 ---  2E3 3 ---  2D4 3 ---  2E4 3 --- }
2091: 0025 { 2D4 3 x--  2E4 3 x--  2D3 3 x--  2E3 3 x-- }
2092: 0025 { 0FA 3 ---  0FA 3 ---  0FA 3 ---  0FA 3 --- }
2093: 0130 { 060 6 ---  062 6 ---  061 6 ---  063 6 --- }
2094: 0130 { 184 3 ---  194 3 ---  185 3 ---  195 3 --- }
2095: 0130 { 186 3 ---  196 3 ---  187 3 ---  197 3 --- }
2096: 0130 { 1A7 4 ---  1B7 4 ---  1A7 4 ---  1B7 4 --- }
2097: 013F { 1CD 4 ---  1DD 4 ---  1CB 4 ---  1DB 4 --- }
2098: 0025 { 2B0 3 ---  2B0 3 ---  2B0 3 x--  2B0 3 x-- }
2099: 015C { 0D1 2 x--  0D1 2 x--  0D0 2 x--  0D0 2 x-- }
209A: 015B { 0D0 2 ---  0D0 2 ---  0D1 2 ---  0D1 2 --- }
209B: 0025 { 0E3 4 xy-  0D3 4 xy-  0E2 4 xy-  0D2 4 xy- }
209C: 0025 { 0E2 4 -y-  0D2 4 -y-  0E3 4 -y-  0D3 4 -y- }
209D: 0130 { 0E4 4 ---  0F5 4 x--  0E5 4 ---  0F4 4 --- }
209E: 0130 { 0E4 4 ---  0F4 4 ---  0E5 4 ---  0F4 4 --- }
209F: 0130 { 0E4 4 ---  0F4 4 ---  0E5 4 ---  0F5 4 --- }
20A0: 0130 { 180 3 ---  190 6 ---  181 3 ---  191 6 --- }
20A1: 0130 { 180 3 ---  191 6 x--  181 3 ---  191 6 --- }
20A2: 0130 { 180 3 ---  191 6 x--  181 3 ---  190 6 x-- }
20A3: 0130 { 182 6 ---  192 6 ---  183 6 ---  193 6 --- }
20A4: 0106 { 180 3 ---  1AE 6 ---  181 3 ---  1AF 6 --- }
20A5: 0106 { 180 3 ---  1AF 6 x--  181 3 ---  1AF 6 --- }
20A6: 0106 { 180 3 ---  1AF 6 x--  181 3 ---  1AE 6 x-- }
20A7: 0025 { 0F8 4 ---  283 4 ---  0F8 4 ---  0F8 4 --- }
20A8: 0025 { 0F8 4 ---  0F8 4 ---  0F8 4 ---  283 4 x-- }
20A9: 0130 { 1A4 4 ---  1B4 4 ---  1A5 4 ---  188 4 --- }
20AA: 0130 { 1A5 4 ---  188 4 x--  1A6 4 ---  1B6 4 --- }
20AB: 0130 { 1A4 4 --p  1B4 4 --p  1B5 4 x-p  189 4 --p }
20AC: 0130 { 1B5 4 --p  189 4 x-p  1A6 4 --p  1B6 4 --p }
20AD: 0105 { 1BE 3 ---  1CE 3 ---  1BF 3 ---  1EF 3 --- }
20AE: 0105 { 1BF 3 ---  1EF 3 ---  1BF 3 ---  1EF 3 --- }
20AF: 0105 { 1BF 3 ---  1EF 3 ---  1CF 3 ---  1CE 3 --- }
20B0: 0130 { 1A0 6 ---  1B0 6 ---  1A1 6 ---  1B1 6 --- }
20B1: 0130 { 1A1 6 x--  1B1 6 x--  1A1 6 ---  1B1 6 --- }
20B2: 0130 { 1A1 6 x--  1B1 6 x--  1A0 6 x--  1B0 6 x-- }
20B3: 0025 { 1B2 6 ---  1C2 6 ---  1B3 6 ---  1C3 6 --- }
20B4: 0025 { 1A2 6 ---  1A2 6 ---  1A3 6 ---  1A3 6 --- }
20B5: 0025 { 1A3 6 ---  1A3 6 ---  1A3 6 ---  1A3 6 --- }
20B6: 0025 { 1A3 6 x--  1A3 6 x--  1A2 6 x--  1A2 6 x-- }
20B7: 0025 { 282 4 ---  281 4 ---  18A 4 ---  19A 4 --- }
20B8: 0025 { 18A 4 ---  19A 4 ---  282 4 x--  281 4 x-- }
20B9: 0130 { 1B4 4 ---  1C4 4 ---  198 4 ---  1C5 4 --- }
20BA: 0130 { 198 4 x--  1C5 4 ---  1B6 4 ---  1C6 4 --- }
20BB: 0130 { 1B4 4 --p  1C4 4 --p  199 4 --p  1C5 4 --p }
20BC: 0130 { 199 4 x-p  1C5 4 --p  1B6 4 --p  1C6 4 --p }
20BD: 0025 { 1CE 3 ---  1CE 3 ---  1FF 3 ---  1FF 3 --- }
20BE: 0025 { 1FF 3 ---  1FF 3 ---  1FF 3 ---  1FF 3 --- }
20BF: 0025 { 1FF 3 ---  1FF 3 ---  1CE 3 ---  1CE 3 --- }
20C0: 0025 { 1C0 6 ---  0F8 4 ---  1C1 6 ---  0F8 4 --- }
20C1: 0025 { 1C1 6 x--  0F8 4 ---  1C1 6 ---  0F8 4 --- }
20C2: 0025 { 1C1 6 x--  0F8 4 ---  1C0 6 x--  0F8 4 --- }
20C3: 0130 { 18B 6 ---  19B 6 ---  18C 6 ---  19C 6 --- }
20C4: 0130 { 1C7 3 ---  1D7 6 ---  1C8 3 ---  1D8 6 --- }
20C5: 0130 { 1C9 3 ---  1D9 6 ---  1CA 3 ---  1DA 6 --- }
20C6: 003F { 295 4 ---  2A5 4 ---  296 4 ---  2A6 4 --- }
20C7: 0025 { 280 4 ---  0F8 4 ---  0F8 4 ---  0F8 4 --- }
20C8: 0025 { 0F8 4 ---  0F8 4 ---  280 4 x--  0F8 4 --- }
20C9: 0130 { 1A4 4 ---  1C4 4 ---  1A6 4 ---  1C6 4 --- }
20CA: 0130 { 1D0 4 ---  1E0 4 ---  1D1 4 ---  1E1 4 --- }
20CB: 0130 { 1D2 4 ---  1E2 4 ---  1D3 4 ---  1E3 4 --- }
20CC: 0025 { 1EB 3 ---  1FB 3 ---  1EC 3 ---  1FC 3 --- }
20CD: 0025 { 1CE 3 ---  1DE 3 ---  1FF 3 ---  1BF 3 --- }
20CE: 0025 { 1FF 3 ---  1BF 3 ---  1FF 3 ---  1BF 3 --- }
20CF: 0025 { 1FF 3 ---  1BF 3 ---  1CE 3 ---  1DF 3 --- }
20D0: 003F { 1A8 4 ---  1B8 4 ---  1A9 4 ---  1B9 4 --- }
20D1: 003F { 1A9 4 ---  1B9 4 ---  1A9 4 ---  1B9 4 --- }
20D2: 003F { 1A9 4 ---  1B9 4 ---  1AA 4 ---  1BA 4 --- }
20D3: 0130 { 19B 6 -y-  19B 6 ---  19C 6 -y-  19C 6 --- }
20D4: 0130 { 1E7 6 ---  1E7 6 -y-  1E8 6 ---  1E8 6 -y- }
20D5: 0130 { 1E9 6 ---  1E9 6 -y-  1EA 6 ---  1EA 6 -y- }
20D6: 003F { 2A5 4 ---  2A5 4 ---  2A6 4 ---  2A6 4 --- }
20D7: 0130 { 1AB 4 ---  1BB 4 ---  1AC 4 ---  1BC 4 --- }
20D8: 0130 { 1AD 4 ---  1BD 4 ---  1AD 4 ---  1BD 4 --- }
20D9: 0130 { 1AD 4 ---  1BD 4 ---  1AB 4 ---  1BB 4 --- }
20DA: 0130 { 1F0 4 ---  1F0 4 ---  1F1 4 ---  1F1 4 --- }
20DB: 0130 { 1F2 4 ---  1F2 4 ---  1F3 4 ---  1F3 4 --- }
20DC: 0105 { 1BE 3 ---  1CE 3 ---  1BF 3 ---  1ED 3 --- }
20DD: 0105 { 1BF 3 ---  1EE 3 ---  1CF 3 ---  1CE 3 --- }
20DE: 0130 { 1D4 4 ---  1E5 4 x--  1D5 4 ---  1F4 4 --- }
20DF: 0130 { 1D5 4 x--  1F5 4 ---  1D4 4 x--  1E5 4 --- }
20E0: 0105 { 2B1 3 ---  2C0 3 ---  2B2 3 ---  2C2 3 --- }
20E1: 0105 { 2B2 3 x--  2C2 3 ---  2B2 3 ---  2C2 3 --- }
20E2: 0105 { 2B2 3 x--  2C2 3 ---  2B1 3 x--  2C1 3 --- }
20E3: 0130 { 19B 6 -y-  18B 6 -y-  19C 6 -y-  18C 6 -y- }
20E4: 0130 { 1E7 6 -y-  1C7 3 ---  1E8 6 -y-  1C8 3 --- }
20E5: 0130 { 1E9 6 -y-  1C9 3 ---  1EA 6 -y-  1CA 3 --- }
20E6: 003F { 2A5 4 ---  2B5 4 ---  2A6 4 ---  2B6 4 --- }
20E7: 0130 { 1CB 4 ---  1DB 4 ---  1CC 4 ---  1DC 4 --- }
20E8: 0130 { 1CD 4 ---  1DD 4 ---  1CD 4 ---  1DD 4 --- }
20E9: 0130 { 1CD 4 ---  1DD 4 ---  1CB 4 ---  1DB 4 --- }
20EA: 0130 { 1F0 4 ---  1D0 4 ---  1F1 4 ---  1D1 4 --- }
20EB: 0130 { 1F2 4 ---  1D2 4 ---  1F3 4 ---  1D3 4 --- }
20EC: 0025 { 1CE 3 ---  1DE 3 ---  1FB 3 ---  1BF 3 --- }
20ED: 0025 { 1FC 3 ---  1BF 3 ---  1CE 3 ---  1DF 3 --- }
20EE: 0130 { 1D5 4 x--  1D4 4 -y-  1F6 4 ---  1E5 4 --- }
20EF: 0130 { 1F7 4 ---  1E5 4 x--  1D5 4 ---  1D4 4 xy- }
20F0: 0025 { 0FA 3 ---  2B1 3 ---  0FA 3 ---  2B2 3 --- }
20F1: 0025 { 0FA 3 ---  2B2 3 x--  0FA 3 ---  2B2 3 --- }
20F2: 0025 { 0FA 3 ---  2B2 3 x--  0FA 3 ---  2B1 3 x-- }
20F3: 0025 { 2C5 3 -y-  2C5 3 ---  2C6 3 xy-  2C6 3 x-- }
20F4: 0025 { 2C6 3 xy-  2C6 3 x--  2C6 3 xy-  2C6 3 x-- }
20F5: 0130 { 1FD 4 ---  1FD 4 ---  1FE 4 ---  1FE 4 --- }
20F6: 0130 { 1F9 4 ---  1FD 4 ---  1FA 4 ---  1FE 4 --- }
20F7: 0130 { 18D 4 ---  19D 4 ---  18E 4 ---  19E 4 --- }
20F8: 0130 { 18F 4 ---  19F 4 ---  18F 4 ---  19F 4 --- }
20F9: 0130 { 18F 4 ---  19F 4 ---  18D 4 ---  19D 4 --- }
20FA: 01EB { 180 3 ---  191 6 x--  181 3 ---  190 6 x-- }
20FB: 0098 { 1EB 2 ---  1ED 2 ---  1EC 2 ---  1DD 2 --- }
20FC: 0099 { 1EC 2 x--  1DD 2 x--  1EB 2 x--  1ED 2 x-- }
20FD: 009A { 1DD 2 x--  1DD 2 x--  1DD 2 ---  1EF 2 --- }
20FE: 009B { 1DD 2 x--  1EF 2 x--  1DD 2 ---  1DD 2 --- }
20FF: 009C { 1DD 2 x--  1EE 2 ---  1DD 2 ---  1EE 2 x-- }
