7B00: 0130 { 000 7 ---  000 7 ---  001 7 ---  00E 7 --- }
7B01: 0130 { 000 7 ---  000 7 ---  003 7 ---  00F 7 --- }
7B02: 0130 { 000 7 ---  000 7 ---  005 7 ---  011 7 --- }
7B03: 0130 { 000 7 ---  000 7 ---  007 7 ---  000 7 --- }
7B04: 0130 { 000 7 ---  000 7 ---  009 7 ---  014 7 --- }
7B05: 0130 { 000 7 ---  000 7 ---  00B 7 ---  016 7 --- }
7B06: 0130 { 000 7 ---  000 7 ---  00C 7 ---  000 7 --- }
7B07: 0130 { 000 7 ---  000 7 ---  00D 7 ---  019 7 --- }
7B08: 0130 { 000 7 ---  000 7 ---  000 7 ---  000 7 --- }
7B09: 0130 { 000 7 ---  000 7 ---  01B 7 ---  02A 7 --- }
7B0A: 0130 { 000 7 ---  000 7 ---  01D 7 ---  02C 7 --- }
7B0B: 0130 { 000 7 ---  000 7 ---  01F 7 ---  02E 7 --- }
7B0C: 0130 { 000 7 ---  000 7 ---  021 7 ---  02D 7 x-- }
7B0D: 0130 { 000 7 ---  000 7 ---  023 7 ---  02F 7 --- }
7B0E: 0130 { 000 7 ---  000 7 ---  018 7 -y-  017 7 --- }
7B0F: 0130 { 000 7 ---  000 7 ---  026 7 ---  000 7 --- }
7B10: 0130 { 000 7 ---  000 7 ---  002 7 ---  000 7 --- }
7B11: 0130 { 000 7 ---  000 7 ---  004 7 ---  010 7 --- }
7B12: 0130 { 000 7 ---  000 7 ---  006 7 ---  012 7 --- }
7B13: 0130 { 000 7 ---  000 7 ---  008 7 ---  013 7 --- }
7B14: 0130 { 000 7 ---  000 7 ---  00A 7 ---  015 7 --- }
7B15: 0130 { 000 7 ---  000 7 ---  000 7 ---  017 7 --- }
7B16: 0130 { 000 7 ---  000 7 ---  000 7 ---  018 7 --- }
7B17: 0130 { 000 7 ---  000 7 ---  000 7 ---  000 7 --- }
7B18: 0130 { 000 7 ---  000 7 ---  01A 7 ---  029 7 --- }
7B19: 0130 { 000 7 ---  000 7 ---  01C 7 ---  02B 7 --- }
7B1A: 0130 { 000 7 ---  000 7 ---  01E 7 ---  02D 7 --- }
7B1B: 0130 { 000 7 ---  000 7 ---  020 7 ---  029 7 --- }
7B1C: 0130 { 000 7 ---  000 7 ---  022 7 ---  029 7 --- }
7B1D: 0130 { 000 7 ---  000 7 ---  024 7 ---  030 7 --- }
7B1E: 0130 { 000 7 ---  000 7 ---  025 7 ---  031 7 --- }
7B1F: 0130 { 000 7 ---  000 7 ---  000 7 ---  000 7 --- }
7B20: 0130 { 000 7 ---  000 7 ---  028 7 ---  033 7 --- }
7B21: 0130 { 000 7 ---  000 7 ---  035 7 ---  043 7 --- }
7B22: 0130 { 000 7 ---  000 7 ---  037 7 ---  045 7 --- }
7B23: 0130 { 000 7 ---  000 7 ---  039 7 ---  047 7 --- }
7B24: 0130 { 000 7 ---  000 7 ---  03A 7 ---  029 7 --- }
7B25: 0130 { 000 7 ---  000 7 ---  03C 7 ---  02A 7 --- }
7B26: 0130 { 000 7 ---  000 7 ---  03E 7 ---  043 7 --- }
7B27: 0130 { 000 7 ---  000 7 ---  040 7 ---  043 7 --- }
7B28: 0130 { 000 7 ---  000 7 ---  01A 7 ---  029 7 --- }
7B29: 0130 { 000 7 ---  000 7 ---  01A 7 ---  057 7 --- }
7B2A: 0130 { 000 7 ---  000 7 ---  04C 7 ---  059 7 --- }
7B2B: 0130 { 000 7 ---  000 7 ---  04D 7 ---  029 7 --- }
7B2C: 0130 { 000 7 ---  000 7 ---  04F 7 ---  05C 7 --- }
7B2D: 0130 { 000 7 ---  000 7 ---  051 7 ---  05A 7 --- }
7B2E: 0130 { 000 7 ---  000 7 ---  053 7 ---  05D 7 --- }
7B2F: 0130 { 000 7 ---  000 7 ---  055 7 ---  05F 7 --- }
7B30: 0130 { 000 7 ---  000 7 ---  027 7 ---  032 7 --- }
7B31: 0130 { 000 7 ---  000 7 ---  034 7 ---  042 7 --- }
7B32: 0130 { 000 7 ---  000 7 ---  036 7 ---  044 7 --- }
7B33: 0130 { 000 7 ---  000 7 ---  038 7 ---  046 7 --- }
7B34: 0130 { 000 7 ---  000 7 ---  039 7 ---  048 7 --- }
7B35: 0130 { 000 7 ---  000 7 ---  03B 7 ---  043 7 --- }
7B36: 0130 { 000 7 ---  000 7 ---  03D 7 ---  02E 7 --- }
7B37: 0130 { 000 7 ---  000 7 ---  03F 7 ---  047 7 --- }
7B38: 0130 { 000 7 ---  000 7 ---  041 7 ---  049 7 --- }
7B39: 0130 { 000 7 ---  000 7 ---  04A 7 ---  048 7 --- }
7B3A: 0130 { 000 7 ---  000 7 ---  04B 7 ---  058 7 --- }
7B3B: 0130 { 000 7 ---  000 7 ---  03C 7 ---  05A 7 --- }
7B3C: 0130 { 000 7 ---  000 7 ---  04E 7 ---  05B 7 --- }
7B3D: 0130 { 000 7 ---  000 7 ---  050 7 ---  043 7 --- }
7B3E: 0130 { 000 7 ---  000 7 ---  052 7 ---  02B 7 --- }
7B3F: 0130 { 000 7 ---  000 7 ---  054 7 ---  05E 7 --- }
7B40: 0130 { 000 7 ---  000 7 ---  000 7 ---  060 7 --- }
7B41: 0130 { 000 7 ---  000 7 ---  062 7 ---  06F 7 --- }
7B42: 0130 { 000 7 ---  000 7 ---  064 7 ---  064 7 -y- }
7B43: 0130 { 000 7 ---  000 7 ---  029 7 -y-  070 7 --- }
7B44: 0130 { 000 7 ---  000 7 ---  067 7 ---  072 7 --- }
7B45: 0130 { 000 7 ---  000 7 ---  069 7 ---  02A 7 --- }
7B46: 0130 { 000 7 ---  000 7 ---  06B 7 ---  058 7 --- }
7B47: 0130 { 000 7 ---  000 7 ---  06D 7 ---  074 7 --- }
7B48: 0130 { 000 7 ---  000 7 ---  029 7 -y-  029 7 --- }
7B49: 0130 { 000 7 ---  000 7 ---  06F 7 -y-  07F 7 --- }
7B4A: 0130 { 000 7 ---  000 7 ---  076 7 ---  02C 7 --- }
7B4B: 0130 { 000 7 ---  000 7 ---  043 7 -y-  06F 7 --- }
7B4C: 0130 { 000 7 ---  000 7 ---  078 7 ---  1F2 7 --- }
7B4D: 0130 { 000 7 ---  000 7 ---  043 7 -y-  1F3 7 --- }
7B4E: 0130 { 000 7 ---  000 7 ---  07B 7 ---  1F5 7 --- }
7B4F: 0130 { 000 7 ---  000 7 ---  07B 7 x--  1F5 7 x-- }
7B50: 0130 { 000 7 ---  000 7 ---  056 7 ---  000 7 --- }
7B51: 0130 { 000 7 ---  000 7 ---  061 7 ---  000 7 --- }
7B52: 0130 { 000 7 ---  000 7 ---  063 7 ---  06E 7 -y- }
7B53: 0130 { 000 7 ---  000 7 ---  065 7 ---  06F 7 --- }
7B54: 0130 { 000 7 ---  000 7 ---  066 7 ---  071 7 --- }
7B55: 0130 { 000 7 ---  000 7 ---  068 7 ---  043 7 --- }
7B56: 0130 { 000 7 ---  000 7 ---  06A 7 ---  073 7 --- }
7B57: 0130 { 000 7 ---  000 7 ---  06C 7 ---  02A 7 --- }
7B58: 0130 { 000 7 ---  000 7 ---  06E 7 ---  043 7 --- }
7B59: 0130 { 000 7 ---  000 7 ---  06E 7 ---  07E 7 --- }
7B5A: 0130 { 000 7 ---  000 7 ---  075 7 ---  048 7 --- }
7B5B: 0130 { 000 7 ---  000 7 ---  077 7 ---  1F0 7 --- }
7B5C: 0130 { 000 7 ---  000 7 ---  043 7 -y-  1F1 7 --- }
7B5D: 0130 { 000 7 ---  000 7 ---  079 7 ---  079 7 -y- }
7B5E: 0130 { 000 7 ---  000 7 ---  07A 7 ---  1F4 7 --- }
7B5F: 0130 { 000 7 ---  000 7 ---  07C 7 ---  05A 7 --- }
7B60: 0025 { 280 3 ---  290 3 ---  281 3 ---  291 3 --- }
7B61: 0025 { 282 3 ---  292 3 ---  283 3 ---  293 3 --- }
7B62: 0025 { 284 3 ---  294 3 ---  285 3 ---  295 3 --- }
7B63: 0025 { 286 3 ---  296 3 ---  287 3 ---  297 3 --- }
7B64: 0130 { 237 0 ---  245 0 ---  262 0 ---  26F 0 --- }
7B65: 0130 { 26E 0 ---  243 0 ---  200 0 ---  200 0 --- }
7B66: 0130 { 243 0 -y-  1F3 0 ---  229 0 -y-  229 0 --- }
7B67: 0130 { 243 0 -y-  26F 0 ---  200 0 ---  200 0 --- }
7B68: 0130 { 266 0 ---  271 0 ---  229 0 -y-  270 0 --- }
7B69: 0130 { 229 0 -y-  270 0 ---  26C 0 ---  22A 0 --- }
7B6A: 0130 { 200 0 ---  200 0 ---  269 0 ---  22A 0 --- }
7B6B: 0130 { 277 0 ---  1F0 0 ---  228 0 ---  233 0 --- }
7B6C: ~
7B6D: ~
7B6E: ~
7B6F: ~
7B70: 0025 { 2A0 3 ---  2B0 3 ---  2A1 3 ---  2B1 3 --- }
7B71: 0025 { 2A2 3 ---  2B2 3 ---  2A3 3 ---  2B3 3 --- }
7B72: 0025 { 2A4 3 ---  2B4 3 ---  2A5 3 ---  2B5 3 --- }
7B73: 0025 { 2A6 3 ---  2B6 3 ---  2A7 3 ---  2B7 3 --- }
7B74: 0130 { 237 0 ---  245 0 ---  262 0 ---  26F 0 --- }
7B75: 0130 { 26E 0 ---  243 0 ---  200 0 ---  200 0 --- }
7B76: 0130 { 243 0 -y-  1F3 0 ---  229 0 -y-  229 0 --- }
7B77: 0130 { 243 0 -y-  26F 0 ---  200 0 ---  200 0 --- }
7B78: 0130 { 266 0 ---  271 0 ---  229 0 -y-  270 0 --- }
7B79: 0130 { 229 0 -y-  270 0 ---  26C 0 ---  22A 0 --- }
7B7A: 0130 { 200 0 ---  200 0 ---  243 0 -y-  26F 0 --- }
7B7B: 0130 { 276 0 ---  22C 0 ---  228 0 ---  233 0 --- }
7B7C: ~
7B7D: ~
7B7E: ~
7B7F: ~
7B80: 0025 { 2C0 3 ---  2D0 3 ---  2C1 3 ---  2D1 3 --- }
7B81: 0025 { 2C2 3 ---  2D2 3 ---  2C3 3 ---  2D3 3 --- }
7B82: 0025 { 2C4 3 ---  2D4 3 ---  2C5 3 ---  2D5 3 --- }
7B83: 0025 { 2C6 3 ---  2D6 3 ---  2C7 3 ---  2D7 3 --- }
7B84: 0130 { 24F 0 ---  25C 0 ---  229 0 -y-  270 0 --- }
7B85: 0130 { 200 0 ---  200 0 ---  262 0 ---  26F 0 --- }
7B86: 0130 { 275 0 ---  248 0 ---  229 0 -y-  270 0 --- }
7B87: 0130 { 200 0 ---  200 0 ---  262 0 ---  26F 0 --- }
7B88: 0130 { 26C 0 ---  22A 0 ---  269 0 ---  22A 0 --- }
7B89: 0130 { 243 0 -y-  1F1 0 ---  229 0 -y-  270 0 --- }
7B8A: 0130 { 200 0 ---  200 0 ---  200 0 ---  218 0 --- }
7B8B: 0130 { 200 0 ---  218 0 ---  200 0 ---  218 0 --- }
7B8C: ~
7B8D: ~
7B8E: ~
7B8F: ~
7B90: 0025 { 2E0 3 ---  2F0 3 ---  2E1 3 ---  2F1 3 --- }
7B91: 0025 { 2E2 3 ---  2F2 3 ---  2E3 3 ---  2F3 3 --- }
7B92: 0025 { 2E4 3 ---  2F4 3 ---  2E5 3 ---  2F5 3 --- }
7B93: 0025 { 2E6 3 ---  2F6 3 ---  2E7 3 ---  2F7 3 --- }
7B94: 0025 { 0F8 4 ---  0F8 4 ---  0F8 4 ---  0F8 4 --- }
7B95: 0130 { 0F8 0 ---  0F8 0 ---  0F8 0 ---  0F8 0 --- }
7B96: 0130 { 0F8 0 ---  0F8 0 ---  0F8 0 ---  1B8 1 --- }
7B97: 0130 { 0F8 0 ---  1B9 1 ---  0F8 0 ---  1B1 1 -y- }
7B98: 0130 { 0F8 0 ---  0F8 0 ---  0F8 0 ---  0F8 0 --- }
7B99: 0130 { 0F8 0 ---  0F8 0 ---  180 1 ---  0F8 0 --- }
7B9A: 0130 { 181 2 ---  189 2 ---  182 2 ---  18A 2 --- }
7B9B: 0130 { 183 2 ---  18B 2 ---  184 2 ---  18C 2 --- }
7B9C: 0130 { 185 2 ---  18D 2 ---  186 2 ---  18E 2 --- }
7B9D: 0130 { 187 2 ---  18F 2 ---  188 2 ---  190 2 --- }
7B9E: 0130 { 0F8 0 ---  0F8 0 ---  0F8 0 ---  0F8 0 --- }
7B9F: ~
7BA0: ~
7BA1: ~
7BA2: ~
7BA3: ~
7BA4: ~
7BA5: 0130 { 0F8 0 ---  0F8 0 ---  0F8 0 ---  0F8 0 --- }
7BA6: 0130 { 0F8 0 ---  0F8 0 ---  1BA 1 ---  1BD 1 --- }
7BA7: 0130 { 1BB 1 ---  1BE 1 ---  1BC 1 ---  1BF 1 --- }
7BA8: 0130 { 0F8 0 ---  0F8 0 ---  0F8 0 ---  0F8 0 --- }
7BA9: 0130 { 0F8 0 ---  0F8 0 ---  0F8 0 ---  0F8 0 --- }
7BAA: 0130 { 191 2 ---  199 2 ---  192 2 ---  19A 2 --- }
7BAB: 0130 { 193 2 ---  19B 2 ---  194 1 ---  19C 2 --- }
7BAC: 0130 { 195 1 ---  19D 2 ---  196 1 ---  19E 2 --- }
7BAD: 0130 { 197 2 ---  19F 2 ---  198 1 ---  1A0 2 --- }
7BAE: 0130 { 0F8 0 ---  0F8 0 ---  0F8 0 ---  0F8 0 --- }
7BAF: ~
7BB0: ~
7BB1: ~
7BB2: ~
7BB3: ~
7BB4: ~
7BB5: 0130 { 0F8 0 ---  0F8 0 ---  0F8 0 ---  0F8 0 --- }
7BB6: 0130 { 1C0 1 ---  1C5 1 ---  1C1 1 ---  1C6 1 --- }
7BB7: 0130 { 1C2 1 ---  1C7 1 ---  1C3 1 ---  1C8 1 --- }
7BB8: 0130 { 1C4 1 ---  1C9 1 ---  0F8 0 ---  0F8 0 --- }
7BB9: 0130 { 0F8 0 ---  0F8 0 ---  0F8 0 ---  1A9 3 --- }
7BBA: 0130 { 1A1 2 ---  1AA 3 ---  1A2 2 ---  1AB 3 --- }
7BBB: 0130 { 1A3 2 ---  1AC 3 ---  1A4 2 ---  1AD 3 --- }
7BBC: 0130 { 1A5 2 ---  1AE 3 ---  1A6 2 ---  1AF 2 --- }
7BBD: 0130 { 1A7 2 ---  1B0 2 ---  1A8 2 ---  1B1 1 --- }
7BBE: 0130 { 0F8 0 ---  0F8 0 ---  0F8 0 ---  0F8 0 --- }
7BBF: ~
7BC0: 0130 { 0F8 0 ---  1D0 1 ---  0F8 0 ---  1D1 1 --- }
7BC1: 0130 { 1CA 1 ---  1D2 1 ---  1CB 1 ---  1D3 1 --- }
7BC2: 0130 { 1CC 1 ---  1D4 1 ---  1CD 1 ---  1D5 1 --- }
7BC3: 0130 { 1CE 1 ---  1D6 1 ---  0F8 0 ---  0F8 0 --- }
7BC4: 0130 { 0F8 0 ---  0F8 0 ---  0F8 0 ---  1D7 7 --- }
7BC5: 0130 { 0F8 0 ---  1D8 7 ---  0F8 0 ---  1D9 1 --- }
7BC6: 0130 { 1CF 1 ---  1DA 1 ---  0F8 0 ---  1B1 1 -y- }
7BC7: 0130 { 0F8 0 ---  0F8 0 ---  0F8 0 ---  1CF 1 --- }
7BC8: 0130 { 0F8 0 ---  0F8 0 ---  0F8 0 ---  0F8 0 --- }
7BC9: 0130 { 0F8 0 ---  0F8 0 ---  0F8 0 ---  0F8 0 --- }
7BCA: 0130 { 0F8 0 ---  1DB 5 ---  0F8 0 ---  1DB 5 x-- }
7BCB: 0130 { 0F8 0 ---  0F8 0 ---  0F8 0 ---  0F8 0 --- }
7BCC: 0130 { 0F8 0 ---  0F8 0 ---  0F8 0 ---  0F8 0 --- }
7BCD: 0130 { 0F8 0 ---  0F8 0 ---  0F8 0 ---  0F8 0 --- }
7BCE: 0130 { 0F8 0 ---  0F8 0 ---  0F8 0 ---  0F8 0 --- }
7BCF: 0130 { 0F8 0 ---  0F8 0 ---  0F8 0 ---  0F8 0 --- }
7BD0: 0130 { 1DC 1 ---  1EF 1 ---  1DD 1 ---  1F0 1 --- }
7BD1: 0130 { 1DE 1 ---  1F1 1 ---  1DF 1 ---  0F8 0 --- }
7BD2: 0130 { 0F8 0 ---  0F8 0 ---  0F8 0 ---  0F8 0 --- }
7BD3: 0130 { 0F8 0 ---  0F8 0 ---  1E0 1 ---  1F2 3 --- }
7BD4: 0130 { 1E1 3 ---  1F3 1 ---  1E2 6 ---  1F4 7 --- }
7BD5: 0130 { 1E3 5 ---  1F5 6 ---  1E4 2 ---  1F6 4 --- }
7BD6: 0130 { 1E5 6 ---  1F7 1 ---  1E6 7 ---  1F8 2 --- }
7BD7: 0130 { 1E7 1 ---  1F9 1 ---  1E8 3 ---  1FA 6 --- }
7BD8: 0130 { 1E9 3 ---  1FB 3 ---  1EA 4 ---  1FC 4 --- }
7BD9: 0130 { 1EB 4 ---  1FD 4 ---  1EC 4 ---  1FE 4 --- }
7BDA: 0130 { 1ED 5 ---  1FF 6 ---  1ED 5 x--  1FF 6 x-- }
7BDB: 0130 { 0F8 0 ---  0F8 0 ---  1B1 1 xy-  200 6 --- }
7BDC: 0130 { 1EE 6 ---  201 2 ---  0F8 0 ---  202 2 --- }
7BDD: 0130 { 0F8 0 ---  0F8 0 ---  0F8 0 ---  203 1 --- }
7BDE: 0130 { 0F8 0 ---  204 1 ---  0F8 0 ---  205 7 --- }
7BDF: 0130 { 0F8 0 ---  0F8 0 ---  0F8 0 ---  206 7 --- }
7BE0: 0130 { 207 1 ---  227 1 ---  208 1 ---  228 7 --- }
7BE1: 0130 { 209 1 ---  229 1 ---  20A 1 ---  22A 1 --- }
7BE2: 0130 { 20B 1 ---  22B 1 ---  20C 3 ---  22C 1 --- }
7BE3: 0130 { 20D 1 ---  22D 3 ---  20E 4 ---  22E 3 --- }
7BE4: 0130 { 20F 3 ---  22F 3 ---  210 7 ---  230 3 --- }
7BE5: 0130 { 211 6 ---  231 6 ---  212 4 ---  232 6 --- }
7BE6: 0130 { 213 3 ---  233 3 ---  214 1 ---  234 3 --- }
7BE7: 0130 { 215 6 ---  235 7 ---  216 1 ---  236 7 --- }
7BE8: 0130 { 217 7 ---  237 7 ---  218 6 ---  238 6 --- }
7BE9: 0130 { 219 6 ---  239 6 ---  21A 6 ---  23A 6 --- }
7BEA: 0130 { 21B 5 ---  23B 6 ---  21C 5 ---  23C 5 --- }
7BEB: 0130 { 21D 2 ---  23D 6 ---  21E 2 ---  23E 2 --- }
7BEC: 0130 { 21F 3 ---  23F 2 ---  220 4 ---  240 3 --- }
7BED: 0130 { 221 5 ---  241 6 ---  222 1 ---  242 1 --- }
7BEE: 0130 { 223 1 ---  243 6 ---  224 7 ---  244 6 --- }
7BEF: 0130 { 225 2 ---  245 7 ---  226 7 ---  246 1 --- }
7BF0: 0130 { 247 7 ---  267 7 ---  248 7 ---  268 7 --- }
7BF1: 0130 { 249 1 ---  269 1 ---  24A 1 ---  26A 1 --- }
7BF2: 0130 { 24B 1 ---  26B 1 ---  24C 1 ---  26C 2 --- }
7BF3: 0130 { 24D 1 ---  26D 1 ---  24E 3 ---  26E 3 --- }
7BF4: 0130 { 24F 3 ---  26F 3 ---  250 6 ---  270 6 --- }
7BF5: 0130 { 251 6 ---  271 4 ---  252 6 ---  272 4 --- }
7BF6: 0130 { 253 3 ---  273 4 ---  254 3 ---  274 3 --- }
7BF7: 0130 { 255 3 ---  275 3 ---  256 7 ---  276 1 --- }
7BF8: 0130 { 257 6 ---  277 7 ---  258 6 ---  278 6 --- }
7BF9: 0130 { 259 6 ---  279 6 ---  25A 6 ---  27A 6 --- }
7BFA: 0130 { 25B 5 ---  27B 5 ---  25C 5 ---  27C 5 --- }
7BFB: 0130 { 25D 2 ---  27D 2 ---  25E 2 ---  27E 2 --- }
7BFC: 0130 { 25F 3 ---  27F 1 ---  260 1 ---  280 3 --- }
7BFD: 0130 { 261 5 ---  281 5 ---  262 1 ---  282 1 --- }
7BFE: 0130 { 263 1 ---  283 6 ---  264 6 ---  284 6 --- }
7BFF: 0130 { 265 2 ---  285 1 ---  266 1 ---  286 1 --- }
