0A00: 012F { 05F 6 xy-  05D 6 xy-  05E 6 xy-  05C 6 xy- }
0A01: 0130 { 02A 4 ---  03A 4 ---  02B 4 ---  03B 4 --- }
0A02: ~
0A03: ~
0A04: ~
0A05: ~
0A06: ~
0A07: ~
0A08: ~
0A09: ~
0A0A: ~
0A0B: ~
0A0C: ~
0A0D: 0025 { 0F8 2 ---  0F8 2 ---  219 3 ---  229 3 --- }
0A0E: 0025 { 21A 3 ---  204 3 ---  21B 3 ---  205 3 --- }
0A0F: 0025 { 21C 3 ---  22C 3 ---  0F8 2 ---  0F8 2 --- }
0A10: ~
0A11: ~
0A12: ~
0A13: 0025 { 194 2 ---  192 2 ---  200 3 ---  210 3 --- }
0A14: 0025 { 201 3 ---  211 3 ---  202 3 ---  212 3 --- }
0A15: 0025 { 203 3 ---  213 3 ---  204 3 ---  214 3 --- }
0A16: 0025 { 205 3 ---  215 3 ---  206 3 ---  216 3 --- }
0A17: 0025 { 207 3 ---  217 3 ---  194 2 ---  192 2 --- }
0A18: 0025 { 194 2 ---  192 2 ---  230 3 ---  240 3 --- }
0A19: 0025 { 0F8 2 ---  0F8 2 ---  1A0 2 ---  1EA 2 --- }
0A1A: 0025 { 1B0 2 ---  1EB 2 ---  0F8 2 ---  0F8 2 --- }
0A1B: 0025 { 235 3 ---  245 3 ---  236 3 ---  246 3 --- }
0A1C: 0025 { 237 3 ---  247 3 ---  194 2 ---  192 2 --- }
0A1D: 0025 { 0F8 2 ---  0F8 2 ---  239 3 ---  249 3 --- }
0A1E: 0025 { 214 3 ---  24A 3 ---  215 3 ---  24B 3 --- }
0A1F: 0025 { 23C 3 ---  24C 3 ---  0F8 2 ---  0F8 2 --- }
0A20: 0130 { 004 2 x--  034 2 x--  08C 2 x--  09C 2 x-- }
0A21: 0130 { 08D 2 x--  09D 2 x--  08C 2 x--  09C 2 x-- }
0A22: 0025 { 08D 2 x--  09D 2 x--  004 2 ---  034 2 --- }
0A23: 0025 { 194 2 ---  192 2 ---  220 3 ---  194 2 --- }
0A24: 0025 { 221 3 ---  195 2 ---  222 3 ---  194 2 --- }
0A25: 0025 { 223 3 ---  195 2 ---  224 3 ---  194 2 --- }
0A26: 0025 { 225 3 ---  195 2 ---  226 3 ---  194 2 --- }
0A27: 0025 { 227 3 ---  195 2 ---  194 2 ---  192 2 --- }
0A28: 0025 { 194 2 ---  192 2 ---  250 3 ---  194 2 --- }
0A29: 0025 { 0F8 2 ---  1E4 2 ---  1E8 2 ---  1E6 2 --- }
0A2A: 0025 { 1E9 2 ---  1E7 2 ---  0F8 2 ---  1E4 2 x-- }
0A2B: 0025 { 255 3 ---  195 2 ---  256 3 ---  194 2 --- }
0A2C: 0025 { 257 3 ---  195 2 ---  194 2 ---  192 2 --- }
0A2D: ~
0A2E: 0025 { 259 3 ---  2CD 3 ---  259 3 x--  2CD 3 x-- }
0A2F: 0025 { 2CD 3 ---  2CD 3 ---  2CD 3 x--  2CD 3 x-- }
0A30: 0130 { 1F4 2 ---  1F7 2 ---  1F6 2 ---  1F8 2 --- }
0A31: 0130 { 09E 2 ---  08E 2 ---  09F 2 ---  08F 2 --- }
0A32: 0130 { 09E 2 ---  18B 2 ---  09F 2 ---  1CB 2 --p }
0A33: 0130 { 18B 2 -y-  08E 2 ---  1CB 2 -yp  08F 2 --- }
0A34: 0025 { 0F8 2 ---  1DB 2 --p  1CC 2 --p  1DC 2 --p }
0A35: 0025 { 0F8 2 --p  1DD 2 --p  18A 2 ---  18A 2 --- }
0A36: 0130 { 1F5 2 x--  1FA 2 ---  1F5 2 ---  1FA 2 x-- }
0A37: 0130 { 08C 2 ---  09C 2 ---  08D 2 ---  09D 2 --- }
0A38: 0130 { 08C 2 ---  09C 2 ---  004 2 ---  034 2 --- }
0A39: 0025 { 185 2 ---  196 2 ---  187 2 ---  197 2 --- }
0A3A: 0025 { 187 2 x--  197 2 x--  185 2 x--  196 2 x-- }
0A3B: 0025 { 231 3 ---  241 3 ---  232 3 ---  242 3 --- }
0A3C: 0025 { 233 3 ---  243 3 ---  234 3 ---  244 3 --- }
0A3D: 0130 { 1CB 2 xyp  08F 2 x--  18B 2 xy-  08E 2 x-- }
0A3E: 0130 { 09F 2 x--  1CB 2 x-p  09E 2 x--  18B 2 x-- }
0A3F: 0130 { 09F 2 x--  08F 2 x--  09E 2 x--  08E 2 x-- }
0A40: 0130 { 1F7 2 ---  1F7 2 -y-  1F8 2 ---  1F8 2 -y- }
0A41: 0135 { 020 5 --p  020 5 --p  021 5 --p  021 5 --p }
0A42: 0136 { 022 5 --p  022 5 --p  023 5 --p  023 5 --p }
0A43: 0130 { 004 5 ---  014 5 ---  005 5 ---  015 5 --- }
0A44: 0130 { 18C 2 --p  19C 2 --p  18D 2 --p  19D 2 --p }
0A45: 0130 { 18E 2 --p  19E 2 --p  18F 2 --p  19F 2 --p }
0A46: 0025 { 1C0 2 ---  194 2 ---  195 2 ---  193 2 --- }
0A47: 0025 { 0F8 2 --p  1D8 2 --p  18A 2 ---  1D9 2 --p }
0A48: 0025 { 004 2 x--  034 2 x--  08D 2 ---  09D 2 --- }
0A49: 0025 { 1A1 2 ---  1B1 2 ---  1A2 2 ---  1B2 2 --- }
0A4A: 0025 { 1A2 2 x--  1B2 2 x--  1A1 2 x--  1B1 2 x-- }
0A4B: 0025 { 251 3 ---  195 2 ---  252 3 ---  194 2 --- }
0A4C: 0025 { 253 3 ---  195 2 ---  254 3 ---  194 2 --- }
0A4D: 0025 { 0F8 2 ---  0F8 2 ---  28C 4 ---  29C 4 --- }
0A4E: 0025 { 28D 4 ---  29D 4 ---  28E 4 ---  29E 4 --- }
0A4F: 0025 { 28F 4 ---  29F 4 ---  0F8 2 ---  0F8 2 --- }
0A50: 0130 { 1F7 2 ---  1F9 2 ---  1F8 2 ---  1FB 2 --- }
0A51: 0133 { 000 5 --p  010 5 --p  001 5 --p  011 5 --p }
0A52: 0134 { 002 5 --p  012 5 --p  003 5 --p  013 5 --p }
0A53: 0130 { 024 5 ---  034 5 ---  025 5 ---  035 5 --- }
0A54: 0025 { 1AC 2 ---  0F8 2 ---  1AD 2 ---  1BD 2 --- }
0A55: 0130 { 1AE 2 ---  1BE 2 ---  1AF 2 ---  1BF 2 --- }
0A56: 0025 { 0F8 2 --p  0F8 2 --p  1CD 2 --p  1DA 2 --p }
0A57: 0025 { 1CE 2 --p  1DE 2 --p  1CF 2 --p  1DF 2 --p }
0A58: 0025 { 1D7 2 -yp  1D7 2 --p  0F8 2 --p  0F8 2 --p }
0A59: 0025 { 1E0 2 ---  1F0 2 ---  1E1 2 ---  1F1 2 --- }
0A5A: 0025 { 1E2 2 ---  1F2 2 ---  1E3 2 ---  1F3 2 --- }
0A5B: 0025 { 19A 2 ---  192 2 ---  19A 2 ---  193 2 --- }
0A5C: 0025 { 194 2 ---  19B 2 ---  195 2 ---  19B 2 --- }
0A5D: 0025 { 0F8 2 ---  0F8 2 ---  2AC 4 ---  2BC 4 --- }
0A5E: 0025 { 2AD 4 ---  2BD 4 ---  2AE 4 ---  2BE 4 --- }
0A5F: 0025 { 2AF 4 ---  2BF 4 ---  0F8 2 ---  0F8 2 --- }
0A60: 0106 { 0F8 2 ---  0F8 2 ---  0F8 2 ---  0F8 2 --- }
0A61: 0025 { 192 2 -y-  1D1 2 -y-  192 2 -y-  1D1 2 xy- }
0A62: 0025 { 1C0 2 ---  1D0 2 ---  1C0 2 x--  1D0 2 x-- }
0A63: 0025 { 1C0 2 ---  194 2 ---  1C0 2 x--  194 2 --- }
0A64: 0025 { 1C0 2 ---  1D0 2 ---  194 2 ---  1D0 2 x-- }
0A65: 0130 { 1A3 2 ---  1B3 2 ---  1A4 2 ---  1B4 2 --- }
0A66: 0130 { 188 2 ---  198 2 ---  189 2 ---  199 2 --- }
0A67: 0130 { 1EE 2 ---  1B7 2 ---  1EF 2 ---  1B8 2 --- }
0A68: 0025 { 0F8 2 ---  1ED 2 ---  0F8 2 ---  0F8 2 --- }
0A69: 0025 { 0F8 2 x--  0F8 2 x--  0F8 2 x--  1ED 2 x-- }
0A6A: 0025 { 0F8 2 x--  1EC 2 ---  0F8 2 x--  0F8 2 x-- }
0A6B: 0025 { 0F8 2 ---  0F8 2 ---  0F8 2 ---  1EC 2 x-- }
0A6C: 0025 { 0F8 2 ---  0F8 2 ---  1D1 2 x--  1D1 2 xy- }
0A6D: 0025 { 0F8 2 ---  0F8 2 ---  2CE 3 ---  2DE 3 --- }
0A6E: 0025 { 2CF 3 ---  2DF 3 ---  2EE 3 ---  2FE 3 --- }
0A6F: 0025 { 2EF 3 ---  2FF 3 ---  0F8 2 ---  0F8 2 --- }
0A70: 0025 { 194 2 ---  192 2 ---  194 2 ---  1D0 2 x-- }
0A71: 0025 { 1D1 2 -y-  0F8 2 ---  0F8 2 ---  0F8 2 --- }
0A72: 0100 { 182 2 ---  192 2 ---  183 2 ---  193 2 --- }
0A73: 0100 { 182 2 ---  192 2 ---  183 2 ---  193 2 --- }
0A74: 0130 { 1C5 2 ---  1D5 2 ---  1C6 2 ---  1D6 2 --- }
0A75: 0025 { 0F8 2 ---  1C1 2 x--  18A 2 ---  18A 2 --- }
0A76: 0097 { 19A 3 ---  0F8 2 ---  19A 3 x--  0F8 2 --- }
0A77: 0025 { 1C0 2 ---  1D0 2 ---  194 2 x--  192 2 x-- }
0A78: 0025 { 1D1 2 xy-  0F8 2 ---  1D1 2 -y-  0F8 2 --- }
0A79: 0025 { 193 2 ---  192 2 ---  1D1 2 -y-  1D1 2 --- }
0A7A: 0025 { 194 2 ---  192 2 ---  1C0 2 x--  194 2 --- }
0A7B: 0025 { 0F8 2 ---  1D1 2 ---  0F8 2 ---  0F8 2 --- }
0A7C: 0025 { 0F8 2 ---  0F8 2 ---  0F8 2 ---  1D1 2 x-- }
0A7D: 0025 { 1D1 2 xy-  1D1 2 x--  193 2 x--  192 2 x-- }
0A7E: 0025 { 2CD 3 ---  2CD 3 ---  2CD 3 x--  2CD 3 x-- }
0A7F: 0020 { 0FB 4 ---  0FB 4 ---  0FB 4 ---  0FB 4 --- }
0A80: 0130 { 1F4 2 ---  1F7 2 ---  1F5 2 ---  1FC 2 --- }
0A81: 0130 { 1F5 2 x--  1FC 2 ---  1F5 2 ---  1FD 2 --- }
0A82: 0130 { 1F5 2 x--  1FD 2 ---  1F6 2 ---  1F8 2 --- }
0A83: 0130 { 1A9 2 ---  1AA 2 xy-  1AA 2 ---  1A9 2 xy- }
0A84: 0130 { 00D 6 ---  00D 6 x--  00D 6 ---  00D 6 x-- }
0A85: 0130 { 1AA 2 x--  1A9 2 -y-  1A9 2 x--  1AA 2 -y- }
0A86: 0025 { 0F8 2 ---  0F8 2 ---  18A 2 ---  18A 2 --- }
0A87: 0025 { 0F8 2 ---  0F8 2 ---  0F8 2 ---  1C2 2 x-- }
0A88: 0025 { 0F8 2 ---  1C1 2 x--  0F8 2 ---  0F8 2 --- }
0A89: 0025 { 0F8 2 ---  1D1 2 x--  0F8 2 ---  1D1 2 --- }
0A8A: 0025 { 0F8 2 ---  0F8 2 ---  299 3 ---  2A9 3 --- }
0A8B: 0025 { 29A 3 ---  284 3 ---  29B 3 ---  285 3 --- }
0A8C: 0025 { 29C 3 ---  2AC 3 ---  0F8 2 ---  0F8 2 --- }
0A8D: 0025 { 0F8 2 ---  0F8 2 ---  299 3 ---  2A9 3 --- }
0A8E: 0025 { 29A 3 ---  2AA 3 ---  29B 3 ---  2AB 3 --- }
0A8F: 0025 { 29C 3 ---  2AC 3 ---  0F8 2 ---  0F8 2 --- }
0A90: 0130 { 1F7 2 ---  1F7 2 -y-  1FE 2 x--  1FF 2 -y- }
0A91: 0130 { 1FE 2 -y-  1FF 2 ---  1FF 2 -y-  1FE 2 x-- }
0A92: 0130 { 1FE 2 ---  1FF 2 ---  1F8 2 ---  1F8 2 -y- }
0A93: 0025 { 0F8 2 ---  29F 3 ---  0F8 2 ---  2DF 3 --- }
0A94: 0025 { 0F8 2 ---  2DF 3 x--  0F8 2 ---  29F 3 x-- }
0A95: 0025 { 1D1 2 ---  192 2 ---  0F8 2 ---  1D1 2 --- }
0A96: 0130 { 1A5 2 ---  1B5 2 ---  1A6 2 ---  1B6 2 --- }
0A97: 0025 { 0F8 2 ---  0F8 2 ---  1D2 2 x--  0F8 2 --- }
0A98: 0130 { 1C4 2 x--  1D4 2 x--  1C3 2 x--  1D3 2 x-- }
0A99: 0025 { 0F8 2 x--  1D1 2 x--  1D1 2 x--  192 2 x-- }
0A9A: 0025 { 0F8 2 ---  0F8 2 ---  2B9 3 ---  2C9 3 --- }
0A9B: 0025 { 294 3 ---  2CA 3 ---  295 3 ---  2CB 3 --- }
0A9C: 0025 { 2BC 3 ---  2CC 3 ---  0F8 2 ---  0F8 2 --- }
0A9D: 0025 { 0F8 2 ---  0F8 2 ---  2B9 3 ---  2C9 3 --- }
0A9E: 0025 { 2BA 3 ---  2CA 3 ---  2BB 3 ---  2CB 3 --- }
0A9F: 0025 { 2BC 3 ---  2CC 3 ---  0F8 2 ---  0F8 2 --- }
0AA0: 0130 { 1F7 2 ---  1F9 2 ---  1FE 2 ---  1FA 2 --- }
0AA1: 0130 { 1FF 2 x--  1FA 2 ---  1FE 2 ---  1FA 2 x-- }
0AA2: 0130 { 1FE 2 xy-  1FA 2 ---  1F8 2 ---  1FB 2 --- }
0AA3: 0025 { 2AF 3 ---  2BF 3 ---  2EF 3 ---  2FF 3 --- }
0AA4: 0025 { 2EF 3 x--  2FF 3 x--  2AF 3 x--  2BF 3 x-- }
0AA5: 0025 { 192 2 -y-  1D1 2 -y-  1D1 2 -y-  0F8 2 -y- }
0AA6: 0130 { 1A7 2 ---  1B7 2 ---  1A8 2 ---  1B8 2 --- }
0AA7: 0130 { 1A5 2 ---  1B9 2 ---  1A6 2 ---  1BA 2 --- }
0AA8: 0025 { 194 2 ---  192 2 ---  195 2 ---  193 2 --- }
0AA9: 0025 { 1D1 2 xy-  0F8 2 xy-  192 2 xy-  1D1 2 xy- }
0AAA: 0025 { 0F8 2 ---  0F8 2 ---  0F8 2 ---  0F8 2 --- }
0AAB: 0025 { 2D9 3 ---  2DA 3 ---  2D9 3 x--  2DA 3 x-- }
0AAC: 0025 { 0F8 2 ---  0F8 2 ---  0F8 2 ---  0F8 2 --- }
0AAD: 0025 { 0F8 2 ---  0F8 2 ---  0F8 2 ---  0F8 2 --- }
0AAE: 0025 { 2D9 3 ---  2DA 3 ---  2D9 3 x--  2DA 3 x-- }
0AAF: 0025 { 0F8 2 ---  0F8 2 ---  0F8 2 ---  0F8 2 --- }
0AB0: 0025 { 0F8 2 ---  290 2 ---  281 2 ---  291 2 --- }
0AB1: 0025 { 282 2 ---  292 2 ---  283 2 ---  293 2 --- }
0AB2: 0025 { 284 2 ---  294 2 ---  285 2 ---  295 2 --- }
0AB3: 0025 { 2CF 3 ---  296 2 ---  2BE 3 ---  297 2 --- }
0AB4: 0025 { 288 3 ---  298 2 ---  289 3 ---  299 2 --- }
0AB5: 0025 { 28A 2 ---  29A 2 ---  28B 2 ---  29B 2 --- }
0AB6: 0025 { 28C 2 ---  29C 2 ---  28D 2 ---  29D 2 --- }
0AB7: 0025 { 28E 2 ---  29E 2 ---  0F8 2 ---  290 2 x-- }
0AB8: 0025 { 1C0 2 x--  1D0 2 x--  1C7 2 ---  1C7 2 -y- }
0AB9: 0025 { 1C8 2 ---  1C8 2 -y-  1C0 2 ---  1D0 2 --- }
0ABA: 0025 { 0F8 2 ---  0F8 2 ---  0F8 2 ---  0F8 2 --- }
0ABB: 0025 { 2DA 3 ---  2DA 3 ---  2DA 3 x--  2DA 3 x-- }
0ABC: 0025 { 0F8 2 ---  0F8 2 ---  0F8 2 ---  0F8 2 --- }
0ABD: 0025 { 0F8 2 ---  0F8 2 ---  0F8 2 ---  0F8 2 --- }
0ABE: 0025 { 2DA 3 ---  2DA 3 ---  2DA 3 x--  2DA 3 x-- }
0ABF: 0025 { 0F8 2 ---  0F8 2 ---  0F8 2 ---  0F8 2 --- }
0AC0: 0025 { 2A0 2 ---  2B0 2 ---  2A1 2 ---  2B1 2 --- }
0AC1: 0025 { 2A2 2 ---  2B2 2 ---  2A3 2 ---  2B3 2 --- }
0AC2: 0025 { 2A4 2 ---  2B1 2 ---  2A5 2 ---  2B1 2 --- }
0AC3: 0025 { 2A6 2 ---  2B1 2 ---  2A7 2 ---  2B2 2 --- }
0AC4: 0025 { 2A8 2 ---  2B3 2 ---  2A9 2 ---  2B1 2 --- }
0AC5: 0025 { 2AA 2 ---  2B1 2 ---  2AB 2 ---  2B1 2 --- }
0AC6: 0025 { 2AC 2 ---  2B2 2 ---  2AD 2 ---  2B3 2 --- }
0AC7: 0025 { 2AE 2 ---  2B1 2 ---  2A0 2 x--  2B0 2 x-- }
0AC8: 0025 { 194 2 ---  192 2 ---  1C0 2 x--  1D0 2 x-- }
0AC9: 0025 { 1C7 2 ---  1C7 2 -y-  1C8 2 ---  1C8 2 -y- }
0ACA: 0025 { 0FB 4 ---  0FB 4 ---  0FB 4 ---  0FB 4 --- }
0ACB: 0124 { 1C3 6 ---  1D3 6 ---  1C4 6 ---  1D4 6 --- }
0ACC: 0025 { 0F8 2 ---  0F8 2 ---  0F8 2 ---  0F8 2 --- }
0ACD: 0025 { 2C0 3 ---  2D0 3 ---  2C1 3 ---  2D1 3 --- }
0ACE: 0025 { 280 2 ---  290 2 ---  281 2 ---  291 2 --- }
0ACF: 0025 { 288 2 x--  298 2 x--  287 2 x--  297 2 x-- }
0AD0: 0025 { 2C0 2 ---  2C0 2 ---  2CB 2 ---  2D1 2 --- }
0AD1: 0025 { 2C2 2 ---  2D2 2 ---  2C3 2 ---  2D3 2 --- }
0AD2: 0025 { 2C1 2 ---  2D4 2 ---  2CA 2 -y-  2D5 2 --- }
0AD3: 0025 { 2C1 2 ---  2D6 2 ---  2C7 2 ---  2D7 2 --- }
0AD4: 0025 { 2C2 2 ---  2D8 2 ---  2C1 2 ---  2D9 2 --- }
0AD5: 0025 { 2C9 2 ---  2DA 2 ---  2C1 2 ---  2DB 2 --- }
0AD6: 0025 { 2CC 2 ---  2DC 2 ---  2CD 2 ---  2DD 2 --- }
0AD7: 0025 { 2CB 2 xy-  2DE 2 ---  2C0 2 x--  2C0 2 x-- }
0AD8: 0025 { 0F8 7 ---  08C 7 ---  0F8 7 ---  0F8 7 --- }
0AD9: 0025 { 180 3 --p  190 3 --p  181 3 --p  191 3 --p }
0ADA: 0025 { 0F8 2 ---  0F8 2 ---  180 3 --p  190 3 --p }
0ADB: 0025 { 181 3 --p  191 3 --p  0F8 2 ---  0F8 2 --- }
0ADC: 0106 { 296 2 ---  0F8 2 ---  2A6 2 ---  0F8 2 --- }
0ADD: 0025 { 2E0 5 ---  2E0 5 ---  2E1 5 ---  2E1 5 --- }
0ADE: 0025 { 2A0 5 ---  2B0 5 ---  2A1 5 ---  2B1 5 --- }
0ADF: 0025 { 287 2 ---  297 2 ---  288 2 ---  298 2 --- }
0AE0: 0025 { 2E0 2 ---  2C0 2 ---  2E1 2 ---  2F1 2 --- }
0AE1: 0025 { 2E2 2 ---  2F2 2 ---  2E3 2 ---  2F3 2 --- }
0AE2: 0025 { 2E4 2 ---  2F4 2 ---  2E5 2 ---  2C1 2 --- }
0AE3: 0025 { 2E6 2 ---  2CB 2 ---  2E7 2 ---  2CA 2 x-- }
0AE4: 0025 { 2E8 2 ---  2F8 2 ---  2E9 2 ---  2F9 2 --- }
0AE5: 0025 { 2EA 2 ---  2FA 2 ---  2EB 2 ---  2FB 2 --- }
0AE6: 0025 { 2EC 2 ---  2FC 2 ---  2ED 2 ---  2FD 2 --- }
0AE7: 0025 { 2EE 2 ---  2FE 2 ---  2E0 2 x--  2C0 2 x-- }
0AE8: 0025 { 2F7 3 ---  0F8 2 ---  2D0 3 ---  2F6 3 --- }
0AE9: 0025 { 2F0 3 ---  0F8 2 ---  2C5 3 ---  0F8 2 --- }
0AEA: 0025 { 2C5 3 x--  0F8 2 x--  2F0 3 x--  0F8 2 x-- }
0AEB: 0025 { 2D0 3 x--  2F6 3 x--  2F7 3 x--  0F8 2 x-- }
0AEC: 0025 { 2C6 3 ---  0F8 2 x--  2C6 3 ---  0F8 2 x-- }
0AED: 0130 { 28E 5 ---  29E 2 ---  28F 5 ---  29F 2 --- }
0AEE: 0130 { 28F 5 ---  2B6 2 ---  28F 5 ---  29F 2 --- }
0AEF: 0130 { 28F 5 ---  2B6 2 ---  2CF 5 ---  2DF 2 --- }
0AF0: 0025 { 2C0 2 ---  280 2 ---  2B4 2 ---  28F 2 --- }
0AF1: 0025 { 2B5 2 ---  28F 2 ---  2B6 2 ---  28F 2 --- }
0AF2: 0025 { 2B7 2 ---  28F 2 ---  2B8 2 ---  28F 2 --- }
0AF3: 0025 { 2B9 2 ---  28F 2 ---  2BA 2 ---  28F 2 --- }
0AF4: 0025 { 2F9 2 ---  28F 2 ---  2BB 2 ---  28F 2 --- }
0AF5: 0025 { 2F9 2 ---  28F 2 ---  2BC 2 ---  28F 2 --- }
0AF6: 0025 { 2F9 2 ---  28F 2 ---  2BD 2 ---  28F 2 --- }
0AF7: 0025 { 2FD 2 ---  28F 2 ---  2C0 2 x--  280 2 x-- }
0AF8: 0025 { 0F8 2 ---  0F8 2 ---  2F5 3 ---  2F5 3 --- }
0AF9: 0025 { 0F8 2 ---  0F8 2 ---  0F8 2 ---  0F8 2 --- }
0AFA: 0025 { 0F8 2 x--  0F8 2 x--  0F8 2 x--  0F8 2 x-- }
0AFB: 0025 { 2F5 3 x--  2F5 3 x--  0F8 2 x--  0F8 2 x-- }
0AFC: 016B { 1C3 6 ---  1D3 6 ---  1C4 6 ---  1D4 6 --- }
0AFD: 0130 { 2AE 2 ---  2BE 2 ---  2AF 2 ---  2BF 2 --- }
0AFE: 0130 { 2BF 2 ---  2AF 2 ---  2AF 2 ---  2BF 2 --- }
0AFF: 0130 { 2BF 2 ---  2AF 2 ---  2EF 2 ---  2FF 2 --- }
