5000: 0005 { 0F8 4 --p  0F8 4 --p  0F8 4 --p  0F8 4 --p }
5001: 0025 { 22B 0 ---  0F8 4 --p  20C 0 ---  0F8 4 --p }
5002: 0025 { 22D 0 ---  0F8 4 --p  22B 0 ---  0F8 4 --p }
5003: 0025 { 23A 0 ---  0F8 4 --p  0F8 4 --p  0F8 4 --p }
5004: 0130 { 182 7 ---  184 7 ---  20C 0 ---  185 7 --- }
5005: 0130 { 239 0 ---  184 7 ---  219 0 ---  185 7 --- }
5006: 0130 { 22D 0 ---  184 7 ---  187 7 ---  1FD 7 --- }
5007: 0025 { 004 4 ---  004 4 ---  004 4 ---  004 4 --- }
5008: ~
5009: ~
500A: ~
500B: ~
500C: ~
500D: ~
500E: 013D { 02E 1 ---  03E 1 ---  02E 1 ---  03E 1 --- }
500F: 013B { 004 1 ---  014 1 ---  005 1 ---  015 1 --- }
5010: ~
5011: ~
5012: ~
5013: ~
5014: ~
5015: ~
5016: ~
5017: ~
5018: ~
5019: ~
501A: ~
501B: ~
501C: ~
501D: ~
501E: 013E { 02F 1 ---  03F 1 ---  02F 1 ---  03F 1 --- }
501F: 013F { 024 1 ---  034 1 ---  025 1 ---  035 1 --- }
5020: ~
5021: ~
5022: 0154 { 004 4 ---  004 4 ---  004 4 ---  004 4 --- }
5023: 0154 { 004 4 ---  004 4 ---  004 4 ---  004 4 --- }
5024: 0154 { 004 4 ---  004 4 ---  004 4 ---  004 4 --- }
5025: 0154 { 004 4 ---  004 4 ---  004 4 ---  004 4 --- }
5026: 0154 { 004 4 ---  004 4 ---  004 4 ---  004 4 --- }
5027: 0154 { 004 4 ---  004 4 ---  004 4 ---  004 4 --- }
5028: 0154 { 004 4 ---  004 4 ---  004 4 ---  004 4 --- }
5029: 0154 { 004 4 ---  004 4 ---  004 4 ---  004 4 --- }
502A: 0154 { 004 4 ---  004 4 ---  004 4 ---  004 4 --- }
502B: 0154 { 004 4 ---  004 4 ---  004 4 ---  004 4 --- }
502C: 0154 { 004 4 ---  004 4 ---  004 4 ---  004 4 --- }
502D: ~
502E: ~
502F: ~
5030: 0025 { 124 5 ---  260 5 ---  124 5 ---  261 5 --- }
5031: 0025 { 124 5 ---  1B5 5 ---  157 5 ---  1B6 5 --- }
5032: 0025 { 124 5 x--  1BB 5 ---  1AC 5 ---  1BC 5 --- }
5033: 0025 { 157 5 ---  1B9 5 ---  157 5 ---  1BA 5 --- }
5034: 0025 { 124 5 x--  261 5 x--  16C 5 ---  260 5 x-- }
5035: 0025 { 124 5 ---  124 5 ---  124 5 ---  124 5 --- }
5036: 0025 { 16B 5 ---  17B 5 ---  16C 5 ---  17C 5 --- }
5037: 0025 { 14F 5 ---  124 5 ---  280 5 ---  290 5 --- }
5038: 0025 { 281 5 ---  291 5 ---  282 5 ---  292 5 --- }
5039: 0025 { 283 5 ---  293 5 ---  124 5 ---  124 5 --- }
503A: ~
503B: ~
503C: ~
503D: ~
503E: ~
503F: ~
5040: 0025 { 270 5 ---  124 5 ---  271 5 ---  124 5 --- }
5041: 0025 { 246 5 ---  256 5 ---  247 5 ---  257 5 --- }
5042: 0025 { 208 5 ---  218 5 ---  208 5 x--  218 5 x-- }
5043: 0025 { 247 5 x--  257 5 x--  246 5 x--  256 5 x-- }
5044: 0025 { 271 5 x--  124 5 x--  270 5 x--  124 5 x-- }
5045: ~
5046: ~
5047: 0025 { 124 5 ---  284 5 ---  2A0 5 ---  2B0 5 --- }
5048: 0025 { 2A1 5 ---  2B1 5 ---  2A2 5 ---  2B2 5 --- }
5049: 0025 { 2A3 5 ---  2B3 5 ---  124 5 ---  124 5 --- }
504A: ~
504B: ~
504C: ~
504D: ~
504E: ~
504F: ~
5050: 0025 { 201 5 ---  211 5 ---  202 5 ---  212 5 --- }
5051: 0025 { 203 5 ---  213 5 ---  204 5 ---  214 5 --- }
5052: 0025 { 205 5 ---  215 5 ---  206 5 ---  216 5 --- }
5053: 0025 { 207 5 ---  217 5 ---  123 5 ---  123 5 --- }
5054: 0025 { 123 5 ---  123 5 ---  200 5 ---  210 5 --- }
5055: 0025 { 123 5 ---  123 5 ---  220 5 ---  230 5 --- }
5056: 0025 { 123 5 ---  123 5 ---  240 5 ---  250 5 --- }
5057: 0025 { 294 5 ---  124 5 ---  295 5 ---  124 5 --- }
5058: ~
5059: 0025 { 1FF 5 ---  123 5 ---  1F4 5 ---  1FE 5 --- }
505A: 0025 { 10B 5 ---  1FF 5 ---  10D 5 ---  1FF 5 --- }
505B: 0025 { 10F 5 ---  117 5 xy-  123 5 ---  123 5 --- }
505C: 0130 { 0F8 0 ---  0F8 0 ---  2E6 6 --p  2CE 6 --p }
505D: ~
505E: ~
505F: ~
5060: 0025 { 221 5 ---  231 5 ---  222 5 ---  232 5 --- }
5061: 0025 { 223 5 ---  233 5 ---  224 5 ---  234 5 --- }
5062: 0025 { 225 5 ---  235 5 ---  226 5 ---  236 5 --- }
5063: 0025 { 227 5 ---  237 5 ---  106 5 ---  1F4 5 --- }
5064: 0025 { 107 5 ---  1F5 5 ---  108 5 ---  1F6 5 --- }
5065: 0025 { 109 5 ---  1F7 5 ---  10A 5 ---  1F8 5 --- }
5066: 0025 { 10B 5 ---  1F9 5 ---  10C 5 ---  1FA 5 --- }
5067: 0025 { 10D 5 ---  1FB 5 ---  10E 5 ---  1FC 5 --- }
5068: 0025 { 104 5 ---  1FD 5 ---  105 5 ---  1FE 5 --- }
5069: 0025 { 106 5 ---  1FF 5 ---  107 5 ---  1FF 5 --- }
506A: 0025 { 10F 5 ---  117 5 xy-  1FF 5 ---  1FF 5 --- }
506B: 0025 { 116 5 xy-  1F4 5 ---  123 5 ---  123 5 --- }
506C: ~
506D: ~
506E: ~
506F: ~
5070: 0025 { 241 5 ---  251 5 ---  242 5 ---  252 5 --- }
5071: 0025 { 243 5 ---  253 5 ---  266 5 ---  276 5 --- }
5072: 0025 { 267 5 ---  277 5 ---  122 5 ---  132 5 --- }
5073: 0025 { 123 5 ---  133 5 ---  124 5 ---  134 5 --- }
5074: 0025 { 125 5 ---  135 5 ---  126 5 ---  136 5 --- }
5075: 0025 { 127 5 ---  137 5 ---  128 5 ---  138 5 --- }
5076: 0025 { 129 5 ---  139 5 ---  12A 5 ---  13A 5 --- }
5077: 0025 { 12B 5 ---  13B 5 ---  12C 5 ---  13C 5 --- }
5078: 0025 { 12D 5 ---  13D 5 ---  12E 5 ---  13E 5 --- }
5079: 0025 { 12F 5 ---  13F 5 ---  1FF 5 ---  1FF 5 --- }
507A: 0025 { 116 5 xy-  115 5 xy-  123 5 ---  123 5 --- }
507B: ~
507C: ~
507D: 0025 { 124 5 ---  284 5 ---  2A0 5 ---  2B0 5 --- }
507E: ~
507F: ~
5080: 0130 { 1F4 5 ---  1F4 5 ---  114 5 ---  115 5 --- }
5081: 0025 { 1FF 5 ---  1FF 5 ---  140 5 ---  150 5 --- }
5082: 0025 { 141 5 ---  151 5 ---  142 5 ---  152 5 --- }
5083: 0025 { 143 5 ---  153 5 ---  144 5 ---  154 5 --- }
5084: 0025 { 145 5 ---  155 5 ---  146 5 ---  156 5 --- }
5085: 0025 { 147 5 ---  157 5 ---  148 5 ---  158 5 --- }
5086: 0025 { 149 5 ---  159 5 ---  14A 5 ---  15A 5 --- }
5087: 0025 { 14B 5 ---  15B 5 ---  14C 5 ---  15C 5 --- }
5088: 0025 { 14D 5 ---  15D 5 ---  14E 5 ---  15E 5 --- }
5089: 0025 { 14F 5 ---  15F 5 ---  1FF 5 ---  1FF 5 --- }
508A: 0025 { 114 5 xy-  113 5 xy-  123 5 ---  123 5 --- }
508B: ~
508C: ~
508D: 0025 { 294 5 ---  124 5 ---  124 5 ---  124 5 --- }
508E: ~
508F: ~
5090: 0130 { 1F4 5 ---  1F4 5 ---  116 5 ---  117 5 --- }
5091: 0025 { 1FF 5 ---  1FF 5 ---  160 5 ---  170 5 --- }
5092: 0025 { 161 5 ---  171 5 ---  162 5 ---  172 5 --- }
5093: 0025 { 163 5 ---  173 5 ---  164 5 ---  174 5 --- }
5094: 0025 { 165 5 ---  175 5 ---  082 3 ---  092 3 --- }
5095: 0025 { 083 3 ---  093 3 ---  084 3 ---  094 3 --- }
5096: 0025 { 085 3 ---  095 3 ---  16A 5 ---  17A 5 --- }
5097: 0025 { 16B 5 ---  17B 5 ---  16C 5 ---  17C 5 --- }
5098: 0025 { 16D 5 ---  17D 5 ---  16E 5 ---  17E 5 --- }
5099: 0025 { 16F 5 ---  17F 5 ---  1FF 5 ---  1FF 5 --- }
509A: 0025 { 112 5 xy-  111 5 xy-  123 5 ---  123 5 --- }
509B: ~
509C: ~
509D: ~
509E: ~
509F: ~
50A0: 0130 { 1F4 5 ---  1F4 5 ---  118 5 ---  111 5 --- }
50A1: 0025 { 1FF 5 ---  1FF 5 ---  180 5 ---  190 5 --- }
50A2: 0025 { 181 5 ---  191 5 ---  182 5 ---  192 5 --- }
50A3: 0025 { 183 5 ---  193 5 ---  184 5 ---  194 5 --- }
50A4: 0025 { 185 5 ---  195 5 ---  0A2 3 ---  0B2 3 --- }
50A5: 0025 { 0A3 3 ---  0B3 3 ---  093 3 xy-  083 3 xy- }
50A6: 0025 { 092 3 xy-  082 3 xy-  18A 5 ---  19A 5 --- }
50A7: 0025 { 18B 5 ---  19B 5 ---  18C 5 ---  19C 5 --- }
50A8: 0025 { 18D 5 ---  19D 5 ---  18E 5 ---  19E 5 --- }
50A9: 0025 { 18F 5 ---  19F 5 ---  1FF 5 ---  1FF 5 --- }
50AA: 0025 { 118 5 xy-  117 5 xy-  123 5 ---  123 5 --- }
50AB: ~
50AC: ~
50AD: ~
50AE: ~
50AF: ~
50B0: 0130 { 1F4 5 ---  1F4 5 ---  112 5 ---  113 5 --- }
50B1: 0025 { 1FF 5 ---  1FF 5 ---  1A0 5 ---  1B0 5 --- }
50B2: 0025 { 1A1 5 ---  1B1 5 ---  1A2 5 ---  1B2 5 --- }
50B3: 0025 { 1A3 5 ---  1B3 5 ---  1A4 5 ---  1B4 5 --- }
50B4: 0025 { 1A5 5 ---  1B5 5 ---  157 5 ---  1B6 5 --- }
50B5: 0025 { 157 5 ---  1B7 5 ---  157 5 ---  1B8 5 --- }
50B6: 0025 { 157 5 ---  1B9 5 ---  1AA 5 ---  1BA 5 --- }
50B7: 0025 { 1AB 5 ---  1BB 5 ---  1AC 5 ---  1BC 5 --- }
50B8: 0025 { 1AD 5 ---  1BD 5 ---  1AE 5 ---  1BE 5 --- }
50B9: 0025 { 1AF 5 ---  1BF 5 ---  1FF 5 ---  1FF 5 --- }
50BA: 0025 { 116 5 xy-  115 5 xy-  123 5 ---  123 5 --- }
50BB: ~
50BC: ~
50BD: ~
50BE: ~
50BF: ~
50C0: 0130 { 1F4 5 ---  1F4 5 ---  114 5 ---  115 5 --- }
50C1: 0025 { 1FF 5 ---  1FF 5 ---  1C0 5 ---  1D0 5 --- }
50C2: 0025 { 1C1 5 ---  1D1 5 ---  1C2 5 ---  1D2 5 --- }
50C3: 0025 { 1C3 5 ---  1D3 5 ---  1C4 5 ---  1D4 5 --- }
50C4: 0025 { 1C5 5 ---  1D5 5 ---  1C6 5 ---  1D6 5 --- }
50C5: 0025 { 1C7 5 ---  1D7 5 ---  1C8 5 ---  1D8 5 --- }
50C6: 0025 { 1C9 5 ---  1D9 5 ---  1CA 5 ---  1DA 5 --- }
50C7: 0025 { 1CB 5 ---  1DB 5 ---  1CC 5 ---  1DC 5 --- }
50C8: 0025 { 1CD 5 ---  1DD 5 ---  20A 5 ---  21A 5 --- }
50C9: 0025 { 20B 5 ---  21B 5 ---  20C 5 ---  21C 5 --- }
50CA: 0025 { 20D 5 ---  21D 5 ---  20E 5 ---  21E 5 --- }
50CB: 0025 { 20F 5 ---  21F 5 ---  1F4 5 ---  1F4 5 --- }
50CC: ~
50CD: ~
50CE: ~
50CF: ~
50D0: 0025 { 1FF 5 ---  1FF 5 ---  116 5 ---  117 5 --- }
50D1: 0025 { 1FF 5 ---  1FF 5 ---  1E0 5 ---  1F0 5 --- }
50D2: 0025 { 1E1 5 ---  1F1 5 ---  1E2 5 ---  1F2 5 --- }
50D3: 0025 { 1E3 5 ---  1F3 5 ---  1E4 5 ---  1F4 5 --- }
50D4: 0025 { 1E5 5 ---  1F5 5 ---  1E6 5 ---  1F6 5 --- }
50D5: 0025 { 1E7 5 ---  1F7 5 ---  1E8 5 ---  1F8 5 --- }
50D6: 0025 { 1E9 5 ---  1F9 5 ---  1EA 5 ---  1FA 5 --- }
50D7: 0025 { 1EB 5 ---  1FB 5 ---  228 5 ---  238 5 --- }
50D8: 0025 { 229 5 ---  239 5 ---  22A 5 ---  23A 5 --- }
50D9: 0025 { 22B 5 ---  23B 5 ---  22C 5 ---  23C 5 --- }
50DA: 0025 { 22D 5 ---  23D 5 ---  22E 5 ---  23E 5 --- }
50DB: 0025 { 22F 5 ---  23F 5 ---  1F4 5 ---  1F4 5 --- }
50DC: ~
50DD: ~
50DE: ~
50DF: ~
50E0: 0025 { 1FF 5 ---  1FF 5 ---  10F 5 xy-  11A 5 --- }
50E1: 0025 { 107 5 xy-  11A 5 ---  106 5 xy-  11A 5 --- }
50E2: 0025 { 105 5 xy-  11A 5 ---  104 5 xy-  11A 5 --- }
50E3: 0025 { 10E 5 xy-  11A 5 ---  10D 5 xy-  11A 5 --- }
50E4: 0025 { 10C 5 xy-  11A 5 ---  10B 5 xy-  11A 5 --- }
50E5: 0025 { 10A 5 xy-  11A 5 ---  109 5 xy-  11A 5 --- }
50E6: 0025 { 108 5 xy-  11A 5 ---  107 5 xy-  11A 5 --- }
50E7: 0025 { 106 5 xy-  11A 5 ---  106 5 xy-  11A 5 --- }
50E8: 0025 { 249 5 ---  259 5 ---  24A 5 ---  25A 5 --- }
50E9: 0025 { 24B 5 ---  25B 5 ---  24C 5 ---  25C 5 --- }
50EA: 0025 { 24D 5 ---  25D 5 ---  24E 5 ---  1FF 5 --- }
50EB: 0025 { 24F 5 ---  1FF 5 ---  1F4 5 ---  1F4 5 --- }
50EC: ~
50ED: ~
50EE: ~
50EF: ~
50F0: 0025 { 107 5 xy-  11A 5 ---  106 5 xy-  11A 5 --- }
50F1: ~
50F2: 0025 { 123 5 ---  123 5 ---  1FF 5 ---  1F4 5 --- }
50F3: 0025 { 123 5 ---  123 5 ---  114 5 ---  117 5 --- }
50F4: 0025 { 123 5 ---  123 5 ---  10F 5 xy-  11A 5 --- }
50F5: ~
50F6: ~
50F7: ~
50F8: ~
50F9: ~
50FA: ~
50FB: ~
50FC: ~
50FD: ~
50FE: ~
50FF: ~
