5900: 0025 { 041 4 ---  051 4 ---  042 4 ---  052 4 --- }
5901: 0025 { 061 4 ---  071 4 ---  062 4 ---  072 4 --- }
5902: 0025 { 00C 4 ---  01C 4 ---  00D 4 ---  01D 4 --- }
5903: 0025 { 00D 4 x--  01D 4 x--  00C 4 x--  01C 4 x-- }
5904: 0025 { 0F8 0 ---  0F8 0 ---  0F8 0 ---  000 4 --- }
5905: 0025 { 00E 4 ---  001 4 ---  00E 4 x--  001 4 x-- }
5906: 0025 { 0F8 0 x--  000 4 x--  0F8 0 x--  0F8 0 x-- }
5907: 0025 { 0F8 0 x--  0F8 0 x--  0F8 0 x--  115 4 --- }
5908: 0025 { 106 4 ---  116 4 ---  107 4 ---  117 4 --- }
5909: 0025 { 107 4 x--  117 4 x--  106 4 x--  116 4 x-- }
590A: 0025 { 0F8 0 ---  115 4 x--  0F8 0 ---  0F8 0 --- }
590B: 0025 { 019 4 x--  029 4 x--  01B 4 x--  02B 4 x-- }
590C: 0025 { 049 4 x--  059 4 x--  003 4 x--  06E 4 x-- }
590D: 0025 { 0F8 0 x--  039 4 x--  0F8 0 x--  0F8 0 x-- }
590E: 0025 { 0F8 0 x--  03B 4 x--  0F8 0 x--  0F8 0 x-- }
590F: 0025 { 040 4 x--  050 4 x--  0F8 0 x--  0F8 0 x-- }
5910: 0025 { 0F8 0 ---  0F8 0 ---  040 4 ---  050 4 --- }
5911: 0025 { 0F8 0 ---  0F8 0 ---  0F8 0 ---  03B 4 --- }
5912: 0025 { 02C 4 ---  03C 4 ---  02D 4 ---  03D 4 --- }
5913: 0025 { 02D 4 x--  03D 4 x--  02C 4 x--  03C 4 x-- }
5914: 0025 { 0F8 0 ---  002 4 ---  010 4 ---  020 4 --- }
5915: 0025 { 011 4 ---  021 4 ---  011 4 x--  021 4 x-- }
5916: 0025 { 010 4 x--  020 4 x--  0F8 0 x--  002 4 x-- }
5917: 0025 { 0F8 0 x--  0F8 0 x--  125 4 ---  135 4 --- }
5918: 0025 { 126 4 ---  136 4 ---  127 4 ---  137 4 --- }
5919: 0025 { 127 4 x--  137 4 x--  126 4 x--  136 4 x-- }
591A: 0025 { 125 4 x--  135 4 x--  0F8 0 ---  0F8 0 --- }
591B: 0025 { 0F8 0 ---  0CF 4 ---  0F8 0 ---  0E8 4 --- }
591C: 0025 { 0CB 4 ---  0CD 4 ---  0CC 4 ---  0CE 4 --- }
591D: ~
591E: 0025 { 04B 4 x--  05B 4 x--  04A 4 x--  05A 4 x-- }
591F: 0025 { 060 4 x--  070 4 x--  0F8 0 x--  0F8 0 x-- }
5920: 0025 { 0F8 0 ---  0F8 0 ---  060 4 ---  070 4 --- }
5921: 0025 { 04A 4 ---  05A 4 ---  04B 4 ---  05B 4 --- }
5922: 0025 { 04C 4 ---  05C 4 ---  04D 4 ---  05D 4 --- }
5923: 0025 { 04D 4 x--  05D 4 x--  04C 4 x--  05C 4 x-- }
5924: 0025 { 012 4 ---  00B 4 ---  030 4 ---  009 4 --- }
5925: 0025 { 031 4 ---  00A 4 ---  031 4 x--  00A 4 x-- }
5926: 0025 { 030 4 x--  009 4 x--  012 4 x--  00B 4 x-- }
5927: 0025 { 0F8 0 x--  0F8 0 x--  145 4 ---  155 4 --- }
5928: 0025 { 146 4 ---  156 4 ---  147 4 ---  157 4 --- }
5929: 0025 { 147 4 x--  157 4 x--  146 4 x--  156 4 x-- }
592A: 0025 { 145 4 x--  155 4 x--  0F8 0 ---  0F8 0 --- }
592B: 0025 { 0CC 4 x--  0CE 4 x--  0CB 4 x--  0CD 4 x-- }
592C: 0025 { 0F8 0 x--  0E8 4 x--  0F8 0 x--  0CF 4 x-- }
592D: ~
592E: 0025 { 06B 4 x--  07B 4 x--  06A 4 x--  07A 4 x-- }
592F: 0025 { 069 4 x--  079 4 x--  0F8 0 x--  0F8 0 x-- }
5930: 0025 { 0F8 0 ---  0F8 0 ---  069 4 ---  079 4 --- }
5931: 0025 { 06A 4 ---  07A 4 ---  06B 4 ---  07B 4 --- }
5932: 0025 { 06C 4 ---  07C 4 ---  06D 4 ---  07D 4 --- }
5933: 0025 { 06D 4 x--  07D 4 x--  06C 4 x--  07C 4 x-- }
5934: 0025 { 01B 4 ---  02B 4 ---  019 4 ---  029 4 --- }
5935: 0025 { 01A 4 ---  02A 4 ---  01A 4 x--  02A 4 x-- }
5936: 0025 { 0F8 0 x--  172 4 ---  0F8 0 x--  173 4 --- }
5937: 0025 { 0F8 0 x--  174 4 ---  165 4 ---  175 4 --- }
5938: 0025 { 166 4 ---  176 4 ---  167 4 ---  177 4 --- }
5939: 0025 { 167 4 x--  177 4 x--  166 4 x--  176 4 x-- }
593A: 0025 { 165 4 x--  175 4 x--  0F8 0 ---  174 4 x-- }
593B: 0025 { 0F8 0 ---  173 4 x--  0F8 0 ---  172 4 x-- }
593C: ~
593D: 0025 { 022 4 x--  032 4 x--  0F8 0 x--  0F8 0 x-- }
593E: 0025 { 006 4 x--  016 4 x--  005 4 x--  015 4 x-- }
593F: 0025 { 004 4 x--  014 4 x--  0F8 0 x--  013 4 x-- }
5940: 0025 { 0F8 0 ---  013 4 ---  004 4 ---  014 4 --- }
5941: 0025 { 005 4 ---  015 4 ---  006 4 ---  016 4 --- }
5942: 0025 { 007 4 ---  017 4 ---  008 4 ---  018 4 --- }
5943: 0025 { 008 4 x--  018 4 x--  007 4 x--  017 4 x-- }
5944: 0025 { 0F8 0 ---  0F8 0 ---  0F8 0 x--  039 4 --- }
5945: 0025 { 0F8 0 x--  118 4 ---  109 4 ---  119 4 --- }
5946: 0025 { 10A 4 ---  11A 4 ---  10B 4 ---  11B 4 --- }
5947: 0025 { 10C 4 ---  11C 4 ---  10D 4 ---  11D 4 --- }
5948: 0025 { 10E 4 ---  11E 4 ---  10F 4 ---  11F 4 --- }
5949: 0025 { 10F 4 x--  11F 4 x--  10E 4 x--  11E 4 x-- }
594A: 0025 { 10D 4 x--  11D 4 x--  10C 4 x--  11C 4 x-- }
594B: 0025 { 10B 4 x--  11B 4 x--  10A 4 x--  11A 4 x-- }
594C: 0025 { 109 4 x--  119 4 x--  0F8 0 ---  118 4 x-- }
594D: 0025 { 042 4 x--  052 4 x--  041 4 x--  051 4 x-- }
594E: 0025 { 026 4 x--  036 4 x--  025 4 x--  035 4 x-- }
594F: 0025 { 024 4 x--  034 4 x--  023 4 x--  033 4 x-- }
5950: 0025 { 023 4 ---  033 4 ---  024 4 ---  034 4 --- }
5951: 0025 { 025 4 ---  035 4 ---  026 4 ---  036 4 --- }
5952: 0025 { 027 4 ---  037 4 ---  028 4 ---  038 4 --- }
5953: 0025 { 028 4 x--  038 4 x--  027 4 x--  037 4 x-- }
5954: 0025 { 003 4 ---  06E 4 ---  049 4 ---  059 4 --- }
5955: 0025 { 128 4 ---  138 4 ---  129 4 ---  139 4 --- }
5956: 0025 { 12A 4 ---  13A 4 ---  12B 4 ---  13B 4 --- }
5957: 0025 { 12C 4 ---  13C 4 ---  12D 4 ---  13D 4 --- }
5958: 0025 { 12E 4 ---  13E 4 ---  12F 4 ---  13F 4 --- }
5959: 0025 { 12F 4 x--  13F 4 x--  12E 4 x--  13E 4 x-- }
595A: 0025 { 12D 4 x--  13D 4 x--  12C 4 x--  13C 4 x-- }
595B: 0025 { 12B 4 x--  13B 4 x--  12A 4 x--  13A 4 x-- }
595C: 0025 { 129 4 x--  139 4 x--  128 4 x--  138 4 x-- }
595D: 0025 { 062 4 x--  072 4 x--  061 4 x--  071 4 x-- }
595E: 0025 { 046 4 x--  056 4 x--  045 4 x--  055 4 x-- }
595F: 0025 { 044 4 x--  054 4 x--  043 4 x--  053 4 x-- }
5960: 0025 { 043 4 ---  053 4 ---  044 4 ---  054 4 --- }
5961: 0025 { 045 4 ---  055 4 ---  046 4 ---  056 4 --- }
5962: 0025 { 047 4 ---  057 4 ---  048 4 ---  058 4 --- }
5963: 0025 { 048 4 x--  058 4 x--  047 4 x--  057 4 x-- }
5964: 0025 { 0F8 0 x--  0F8 0 x--  172 4 ---  104 4 --- }
5965: 0025 { 148 4 ---  158 4 ---  149 4 ---  159 4 --- }
5966: 0025 { 14A 4 ---  15A 4 ---  14B 4 ---  15B 4 --- }
5967: 0025 { 14C 4 ---  15C 4 ---  14D 4 ---  15D 4 --- }
5968: 0025 { 14E 4 ---  15E 4 ---  14F 4 ---  15F 4 --- }
5969: 0025 { 14F 4 x--  15F 4 x--  14E 4 x--  15E 4 x-- }
596A: 0025 { 14D 4 x--  15D 4 x--  14C 4 x--  15C 4 x-- }
596B: 0025 { 14B 4 x--  15B 4 x--  14A 4 x--  15A 4 x-- }
596C: 0025 { 149 4 x--  159 4 x--  148 4 x--  158 4 x-- }
596D: 0025 { 172 4 x--  104 4 x--  0F8 0 ---  0F8 0 --- }
596E: 0025 { 066 4 x--  076 4 x--  065 4 x--  075 4 x-- }
596F: 0025 { 064 4 x--  074 4 x--  063 4 x--  073 4 x-- }
5970: 0025 { 063 4 ---  073 4 ---  064 4 ---  074 4 --- }
5971: 0025 { 065 4 ---  075 4 ---  066 4 ---  076 4 --- }
5972: 0025 { 067 4 ---  077 4 ---  068 4 ---  078 4 --- }
5973: 0025 { 068 4 x--  078 4 x--  067 4 x--  077 4 x-- }
5974: 0025 { 0F8 0 x--  0F8 0 x--  114 4 ---  124 4 --- }
5975: 0025 { 168 4 ---  178 4 ---  169 4 ---  179 4 --- }
5976: 0025 { 16A 4 ---  17A 4 ---  16B 4 ---  17B 4 --- }
5977: 0025 { 16C 4 ---  17C 4 ---  16D 4 ---  17D 4 --- }
5978: 0025 { 16E 4 ---  17E 4 ---  16F 4 ---  17F 4 --- }
5979: 0025 { 16F 4 x--  17F 4 x--  16E 4 x--  17E 4 x-- }
597A: 0025 { 16D 4 x--  17D 4 x--  16C 4 x--  17C 4 x-- }
597B: 0025 { 16B 4 x--  17B 4 x--  16A 4 x--  17A 4 x-- }
597C: 0025 { 169 4 x--  179 4 x--  168 4 x--  178 4 x-- }
597D: 0025 { 114 4 x--  124 4 x--  0F8 0 ---  0F8 0 --- }
597E: ~
597F: ~
5980: 0025 { 089 4 x--  099 4 x--  088 4 x--  098 4 x-- }
5981: 0025 { 08A 4 x--  09A 4 x--  0F8 0 ---  0F8 0 --- }
5982: 0025 { 0F8 0 ---  07E 4 ---  0F8 0 ---  07F 4 --- }
5983: 0025 { 0F8 0 ---  07F 4 x--  0F8 0 ---  07E 4 x-- }
5984: 0025 { 133 4 ---  143 4 ---  134 4 ---  144 4 --- }
5985: 0025 { 200 4 ---  210 4 ---  201 4 ---  211 4 --- }
5986: 0025 { 202 4 ---  212 4 ---  203 4 ---  213 4 --- }
5987: 0025 { 204 4 ---  214 4 ---  205 4 ---  215 4 --- }
5988: 0025 { 206 4 ---  216 4 ---  207 4 ---  217 4 --- }
5989: 0025 { 207 4 x--  217 4 x--  206 4 x--  216 4 x-- }
598A: 0025 { 205 4 x--  215 4 x--  204 4 x--  214 4 x-- }
598B: 0025 { 203 4 x--  213 4 x--  202 4 x--  212 4 x-- }
598C: 0025 { 201 4 x--  211 4 x--  200 4 x--  210 4 x-- }
598D: 0025 { 134 4 x--  144 4 x--  133 4 x--  143 4 x-- }
598E: ~
598F: ~
5990: 0025 { 0A1 4 x--  0B1 4 x--  0A0 4 x--  0B0 4 x-- }
5991: 0025 { 0AA 4 x--  0BA 4 x--  0F8 0 ---  0F8 0 --- }
5992: 0025 { 0F8 0 ---  00F 4 ---  0F8 0 ---  00F 4 x-- }
5993: 0025 { 0F8 0 x--  0B8 4 ---  0F8 0 x--  0B9 4 --- }
5994: 0025 { 153 4 ---  100 4 ---  154 4 ---  101 4 --- }
5995: 0025 { 220 4 ---  230 4 ---  221 4 ---  231 4 --- }
5996: 0025 { 222 4 ---  232 4 ---  223 4 ---  233 4 --- }
5997: 0025 { 224 4 ---  234 4 ---  225 4 ---  235 4 --- }
5998: 0025 { 226 4 ---  236 4 ---  227 4 ---  237 4 --- }
5999: 0025 { 227 4 x--  237 4 x--  226 4 x--  236 4 x-- }
599A: 0025 { 225 4 x--  235 4 x--  224 4 x--  234 4 x-- }
599B: 0025 { 223 4 x--  233 4 x--  222 4 x--  232 4 x-- }
599C: 0025 { 221 4 x--  231 4 x--  220 4 x--  230 4 x-- }
599D: 0025 { 154 4 x--  101 4 x--  153 4 x--  100 4 x-- }
599E: 0025 { 0F8 0 ---  0B9 4 x--  0F8 0 ---  0B8 4 x-- }
599F: ~
59A0: 0025 { 0C1 4 x--  0D1 4 x--  0C0 4 x--  0D0 4 x-- }
59A1: 0025 { 0CA 4 x--  0A8 4 x--  0F8 0 ---  0F8 0 --- }
59A2: 0025 { 0F8 0 x--  0F8 0 x--  0AB 4 ---  0BB 4 --- }
59A3: 0025 { 0AC 4 ---  0BC 4 ---  0AD 4 ---  0BD 4 --- }
59A4: 0025 { 110 4 ---  120 4 ---  111 4 ---  121 4 --- }
59A5: 0025 { 240 4 ---  250 4 ---  241 4 ---  251 4 --- }
59A6: 0025 { 242 4 ---  252 4 ---  243 4 ---  253 4 --- }
59A7: 0025 { 244 4 ---  254 4 ---  245 4 ---  255 4 --- }
59A8: 0025 { 246 4 ---  256 4 ---  247 4 ---  257 4 --- }
59A9: 0025 { 247 4 x--  257 4 x--  246 4 x--  256 4 x-- }
59AA: 0025 { 245 4 x--  255 4 x--  244 4 x--  254 4 x-- }
59AB: 0025 { 243 4 x--  253 4 x--  242 4 x--  252 4 x-- }
59AC: 0025 { 241 4 x--  251 4 x--  240 4 x--  250 4 x-- }
59AD: 0025 { 111 4 x--  121 4 x--  110 4 x--  120 4 x-- }
59AE: 0025 { 0AD 4 x--  0BD 4 x--  0AC 4 x--  0BC 4 x-- }
59AF: 0025 { 0AB 4 x--  0BB 4 x--  0F8 0 ---  0F8 0 --- }
59B0: 0025 { 0E1 4 x--  0F1 4 x--  0E0 4 x--  0F0 4 x-- }
59B1: 0025 { 0A9 4 x--  0F8 0 ---  0F8 0 ---  0F8 0 --- }
59B2: 0025 { 0F8 0 x--  0F8 0 x--  08B 4 ---  09B 4 --- }
59B3: 0025 { 08C 4 ---  09C 4 ---  08D 4 ---  09D 4 --- }
59B4: 0025 { 08E 4 ---  09E 4 ---  08F 4 ---  09F 4 --- }
59B5: 0025 { 260 4 ---  270 4 ---  261 4 ---  271 4 --- }
59B6: 0025 { 262 4 ---  272 4 ---  263 4 ---  273 4 --- }
59B7: 0025 { 264 4 ---  274 4 ---  265 4 ---  275 4 --- }
59B8: 0025 { 266 4 ---  276 4 ---  267 4 ---  277 4 --- }
59B9: 0025 { 267 4 x--  277 4 x--  266 4 x--  276 4 x-- }
59BA: 0025 { 265 4 x--  275 4 x--  264 4 x--  274 4 x-- }
59BB: 0025 { 263 4 x--  273 4 x--  262 4 x--  272 4 x-- }
59BC: 0025 { 261 4 x--  271 4 x--  260 4 x--  270 4 x-- }
59BD: 0025 { 08F 4 x--  09F 4 x--  08E 4 x--  09E 4 x-- }
59BE: 0025 { 08D 4 x--  09D 4 x--  08C 4 x--  09C 4 x-- }
59BF: 0025 { 08B 4 x--  09B 4 x--  0F8 0 ---  0F8 0 --- }
59C0: 0025 { 0F8 0 x--  0F8 0 x--  08A 4 ---  09A 4 --- }
59C1: 0025 { 088 4 ---  098 4 ---  089 4 ---  099 4 --- }
59C2: 0025 { 082 4 ---  092 4 ---  083 4 ---  093 4 --- }
59C3: 0025 { 084 4 ---  094 4 ---  085 4 ---  095 4 --- }
59C4: 0025 { 086 4 ---  096 4 ---  087 4 ---  097 4 --- }
59C5: 0025 { 208 4 ---  218 4 ---  209 4 ---  219 4 --- }
59C6: 0025 { 20A 4 ---  21A 4 ---  20B 4 ---  21B 4 --- }
59C7: 0025 { 20C 4 ---  21C 4 ---  20D 4 ---  21D 4 --- }
59C8: 0025 { 20E 4 ---  21E 4 ---  20F 4 ---  21F 4 --- }
59C9: 0025 { 20F 4 x--  21F 4 x--  20E 4 x--  21E 4 x-- }
59CA: 0025 { 20D 4 x--  21D 4 x--  20C 4 x--  21C 4 x-- }
59CB: 0025 { 20B 4 x--  21B 4 x--  20A 4 x--  21A 4 x-- }
59CC: 0025 { 209 4 x--  219 4 x--  208 4 x--  218 4 x-- }
59CD: 0025 { 087 4 x--  097 4 x--  086 4 x--  096 4 x-- }
59CE: 0025 { 085 4 x--  095 4 x--  084 4 x--  094 4 x-- }
59CF: 0025 { 083 4 x--  093 4 x--  082 4 x--  092 4 x-- }
59D0: 0025 { 0F8 0 x--  0F8 0 x--  0AA 4 ---  0BA 4 --- }
59D1: 0025 { 0A0 4 ---  0B0 4 ---  0A1 4 ---  0B1 4 --- }
59D2: 0025 { 0A2 4 ---  0B2 4 ---  0A3 4 ---  0B3 4 --- }
59D3: 0025 { 0A4 4 ---  0B4 4 ---  0A5 4 ---  0B5 4 --- }
59D4: 0025 { 0A6 4 ---  0B6 4 ---  0A7 4 ---  0B7 4 --- }
59D5: 0025 { 228 4 ---  238 4 ---  229 4 ---  239 4 --- }
59D6: 0025 { 22A 4 ---  23A 4 ---  22B 4 ---  23B 4 --- }
59D7: 0025 { 22C 4 ---  23C 4 ---  22D 4 ---  23D 4 --- }
59D8: 0025 { 22E 4 ---  23E 4 ---  22F 4 ---  23F 4 --- }
59D9: 0025 { 22F 4 x--  23F 4 x--  22E 4 x--  23E 4 x-- }
59DA: 0025 { 22D 4 x--  23D 4 x--  22C 4 x--  23C 4 x-- }
59DB: 0025 { 22B 4 x--  23B 4 x--  22A 4 x--  23A 4 x-- }
59DC: 0025 { 229 4 x--  239 4 x--  228 4 x--  238 4 x-- }
59DD: 0025 { 0A7 4 x--  0B7 4 x--  0A6 4 x--  0B6 4 x-- }
59DE: 0025 { 0A5 4 x--  0B5 4 x--  0A4 4 x--  0B4 4 x-- }
59DF: 0025 { 0A3 4 x--  0B3 4 x--  0A2 4 x--  0B2 4 x-- }
59E0: 0025 { 0F8 0 x--  0F8 0 x--  0CA 4 ---  0A8 4 --- }
59E1: 0025 { 0C0 4 ---  0D0 4 ---  0C1 4 ---  0D1 4 --- }
59E2: 0025 { 0C2 4 ---  0D2 4 ---  0C3 4 ---  0D3 4 --- }
59E3: 0025 { 0C4 4 ---  0D4 4 ---  0C5 4 ---  0D5 4 --- }
59E4: 0025 { 0C6 4 ---  0D6 4 ---  0C7 4 ---  0D7 4 --- }
59E5: 0025 { 248 4 ---  258 4 ---  249 4 ---  259 4 --- }
59E6: 0025 { 24A 4 ---  25A 4 ---  24B 4 ---  25B 4 --- }
59E7: 0025 { 24C 4 ---  25C 4 ---  24D 4 ---  25D 4 --- }
59E8: 0025 { 24E 4 ---  25E 4 ---  24F 4 ---  25F 4 --- }
59E9: 0025 { 24F 4 x--  25F 4 x--  24E 4 x--  25E 4 x-- }
59EA: 0025 { 24D 4 x--  25D 4 x--  24C 4 x--  25C 4 x-- }
59EB: 0025 { 24B 4 x--  25B 4 x--  24A 4 x--  25A 4 x-- }
59EC: 0025 { 249 4 x--  259 4 x--  248 4 x--  258 4 x-- }
59ED: 0025 { 0C7 4 x--  0D7 4 x--  0C6 4 x--  0D6 4 x-- }
59EE: 0025 { 0C5 4 x--  0D5 4 x--  0C4 4 x--  0D4 4 x-- }
59EF: 0025 { 0C3 4 x--  0D3 4 x--  0C2 4 x--  0D2 4 x-- }
59F0: 0025 { 0F8 0 x--  0F8 0 x--  0A9 4 ---  0F8 0 x-- }
59F1: 0025 { 0E0 4 ---  0F0 4 ---  0E1 4 ---  0F1 4 --- }
59F2: 0025 { 0E2 4 ---  0F2 4 ---  0E3 4 ---  0F3 4 --- }
59F3: 0025 { 0E4 4 ---  0F4 4 ---  0E5 4 ---  0F5 4 --- }
59F4: 0025 { 0E6 4 ---  0F6 4 ---  0E7 4 ---  0F7 4 --- }
59F5: 0025 { 268 4 ---  278 4 ---  269 4 ---  279 4 --- }
59F6: 0025 { 26A 4 ---  27A 4 ---  26B 4 ---  27B 4 --- }
59F7: 0025 { 26C 4 ---  27C 4 ---  26D 4 ---  27D 4 --- }
59F8: 0025 { 26E 4 ---  27E 4 ---  26F 4 ---  27F 4 --- }
59F9: 0025 { 26F 4 x--  27F 4 x--  26E 4 x--  27E 4 x-- }
59FA: 0025 { 26D 4 x--  27D 4 x--  26C 4 x--  27C 4 x-- }
59FB: 0025 { 26B 4 x--  27B 4 x--  26A 4 x--  27A 4 x-- }
59FC: 0025 { 269 4 x--  279 4 x--  268 4 x--  278 4 x-- }
59FD: 0025 { 0E7 4 x--  0F7 4 x--  0E6 4 x--  0F6 4 x-- }
59FE: 0025 { 0E5 4 x--  0F5 4 x--  0E4 4 x--  0F4 4 x-- }
59FF: 0025 { 0E3 4 x--  0F3 4 x--  0E2 4 x--  0F2 4 x-- }
