6600: 0025 { 108 4 ---  10A 4 ---  109 4 ---  10B 4 --- }
6601: 0025 { 109 4 ---  10C 4 ---  109 4 ---  10C 4 --- }
6602: 0025 { 109 4 ---  10D 4 ---  109 4 ---  10E 5 --- }
6603: 0025 { 109 4 ---  10F 5 ---  109 4 ---  110 5 --- }
6604: 0025 { 109 4 ---  110 5 ---  109 4 ---  111 5 --- }
6605: 0025 { 109 4 ---  112 5 ---  109 4 ---  10C 4 --- }
6606: 0025 { 109 4 ---  10C 4 ---  109 4 ---  10C 4 --- }
6607: 0025 { 109 4 ---  10B 4 x--  108 4 x--  10A 4 x-- }
6608: 0025 { 159 4 ---  15B 4 ---  15A 4 ---  15C 4 --- }
6609: 0025 { 15A 4 ---  0FE 4 ---  15A 4 ---  15D 4 --- }
660A: 0025 { 15A 4 ---  15E 4 ---  15A 4 ---  0FE 4 --- }
660B: 0025 { 15A 4 ---  15F 4 ---  15A 4 ---  0CC 4 x-- }
660C: 0025 { 15A 4 ---  160 4 ---  15A 4 ---  161 4 --- }
660D: 0025 { 15A 4 ---  0FE 4 ---  15A 4 ---  160 4 --- }
660E: 0025 { 15A 4 ---  162 4 ---  15A 4 ---  163 4 --- }
660F: 0025 { 15A 4 ---  164 4 ---  159 4 x--  15B 4 x-- }
6610: 0025 { 113 4 ---  11E 5 ---  114 4 ---  11F 5 --- }
6611: 0025 { 115 4 ---  120 7 ---  116 4 ---  121 7 --- }
6612: 0025 { 117 5 ---  122 5 ---  118 5 ---  10E 5 -y- }
6613: 0025 { 0FA 4 ---  110 5 -y-  0FA 4 ---  123 5 --- }
6614: 0025 { 119 4 ---  124 5 ---  11A 4 ---  110 5 -y- }
6615: 0025 { 11B 5 ---  112 5 -y-  11C 4 ---  125 5 --- }
6616: 0025 { 115 4 ---  126 7 ---  116 4 ---  127 4 --- }
6617: 0025 { 11D 4 ---  128 7 ---  113 4 x--  11E 5 x-- }
6618: 0025 { 15B 4 ---  15B 4 ---  165 4 ---  16E 4 --- }
6619: 0025 { 166 4 ---  16F 4 ---  167 4 ---  170 4 --- }
661A: 0025 { 0FE 4 ---  171 4 ---  0FE 4 ---  0FE 4 --- }
661B: 0025 { 168 4 ---  172 4 ---  169 4 ---  173 4 --- }
661C: 0025 { 16A 4 ---  174 4 ---  0CC 4 xy-  175 4 --- }
661D: 0025 { 0FE 4 ---  0FE 4 ---  163 4 -y-  176 4 --- }
661E: 0025 { 16B 4 ---  177 4 ---  16C 4 ---  178 4 --- }
661F: 0025 { 16D 4 ---  179 4 ---  15B 4 x--  15B 4 x-- }
6620: 0025 { 11E 5 ---  11E 5 ---  129 5 ---  135 7 --- }
6621: 0025 { 12A 7 ---  136 5 ---  12B 5 ---  136 5 --- }
6622: 0025 { 12C 5 ---  137 5 ---  12D 5 ---  138 5 --- }
6623: 0025 { 12E 4 ---  139 5 ---  0F9 4 ---  13A 5 --- }
6624: 0025 { 12F 4 ---  13A 5 ---  102 5 x--  13B 5 --- }
6625: 0025 { 130 5 ---  125 5 ---  131 5 ---  13C 5 --- }
6626: 0025 { 132 5 ---  136 5 ---  133 5 ---  136 5 --- }
6627: 0025 { 134 5 ---  13D 5 ---  11E 5 x--  11E 5 x-- }
6628: 0025 { 15B 4 ---  15B 4 ---  17A 4 ---  17A 4 --- }
6629: 0025 { 17B 4 ---  185 4 ---  17C 4 ---  186 4 --- }
662A: 0025 { 17D 4 ---  17D 4 ---  0FE 4 ---  0FE 4 --- }
662B: 0025 { 17E 4 ---  17E 4 ---  17F 4 ---  187 4 --- }
662C: 0025 { 180 4 ---  188 4 ---  181 4 ---  181 4 --- }
662D: 0025 { 0FE 4 ---  0FE 4 ---  0C8 4 ---  0C8 4 --- }
662E: 0025 { 182 4 ---  189 4 ---  183 4 ---  18A 4 --- }
662F: 0025 { 184 4 ---  18B 4 ---  15B 4 x--  15B 4 x-- }
6630: 0025 { 11E 5 ---  147 5 ---  13E 7 ---  148 7 --- }
6631: 0025 { 13F 5 ---  149 5 ---  13F 5 ---  149 5 --- }
6632: 0025 { 140 5 ---  14A 5 ---  141 5 ---  14B 7 --- }
6633: 0025 { 142 7 ---  14C 4 ---  143 5 ---  14D 4 --- }
6634: 0025 { 144 5 ---  14D 4 ---  145 5 ---  14E 5 --- }
6635: 0025 { 125 5 ---  14F 5 ---  125 5 ---  14F 5 --- }
6636: 0025 { 13F 5 ---  149 5 ---  13F 5 ---  149 5 --- }
6637: 0025 { 146 5 ---  150 5 ---  11E 5 x--  147 5 x-- }
6638: 0025 { 15B 4 ---  192 4 ---  18C 4 ---  193 4 --- }
6639: 0025 { 18D 4 ---  193 4 ---  18D 4 ---  193 4 --- }
663A: 0025 { 18E 4 ---  193 4 ---  0FE 4 ---  193 4 --- }
663B: 0025 { 18F 4 ---  193 4 ---  18D 4 ---  193 4 --- }
663C: 0025 { 18D 4 ---  193 4 ---  190 4 ---  193 4 --- }
663D: 0025 { 0FE 4 ---  193 4 ---  176 4 -y-  193 4 --- }
663E: 0025 { 18D 4 ---  193 4 ---  18D 4 ---  193 4 --- }
663F: 0025 { 191 4 ---  193 4 ---  15B 4 x--  192 4 x-- }
6640: 0025 { 19C 4 ---  1A2 4 ---  19D 4 ---  1A3 7 --- }
6641: 0025 { 19D 4 ---  1A4 7 ---  19E 7 ---  1A5 7 --- }
6642: 0025 { 19D 4 ---  1A6 7 ---  19D 4 ---  1A6 7 --- }
6643: 0025 { 19D 4 ---  1A6 7 ---  19D 4 ---  1A7 7 --- }
6644: 0025 { 19F 7 ---  1A8 7 ---  19D 4 ---  1A9 7 --- }
6645: 0025 { 19D 4 ---  1A6 7 ---  19D 4 ---  1A6 7 --- }
6646: 0025 { 19D 4 ---  1A6 7 ---  1A0 7 ---  1AA 7 --- }
6647: 0025 { 19D 4 ---  1AB 7 ---  1A1 4 ---  1AC 7 --- }
6648: 0025 { 10B 4 ---  112 4 ---  10C 5 ---  113 7 --- }
6649: 0025 { 10C 5 ---  114 7 ---  10C 5 ---  115 7 --- }
664A: 0025 { 10C 5 ---  113 7 ---  10D 5 ---  116 5 --- }
664B: 0025 { 10E 4 ---  117 4 ---  10E 4 ---  118 4 --- }
664C: 0025 { 10E 4 ---  119 4 ---  10E 4 ---  11A 4 --- }
664D: 0025 { 10F 4 ---  11B 4 ---  110 4 ---  11C 4 --- }
664E: 0025 { 110 4 ---  11D 4 ---  110 4 ---  11E 4 --- }
664F: 0025 { 110 4 ---  11F 4 ---  111 4 ---  120 4 --- }
6650: 0025 { 1A2 4 ---  1A2 4 ---  1AD 7 ---  1B8 7 --- }
6651: 0025 { 1AE 7 ---  2D0 7 ---  1AF 7 ---  2D0 7 --- }
6652: 0025 { 1B0 7 ---  2D0 7 ---  2D0 7 ---  1B9 5 --- }
6653: 0025 { 2D0 7 ---  1BA 5 ---  1B1 7 ---  1BA 5 --- }
6654: 0025 { 1B2 7 ---  1BB 5 ---  1B3 7 ---  1BC 5 --- }
6655: 0025 { 2D0 7 ---  1BD 5 ---  2D0 7 ---  1BA 5 --- }
6656: 0025 { 1B4 7 ---  1BA 5 ---  1B5 7 ---  1BB 5 --- }
6657: 0025 { 1B6 7 ---  1BE 5 ---  1B7 7 ---  1BF 7 --- }
6658: 0025 { 121 4 ---  12C 4 ---  122 5 ---  12D 4 --- }
6659: 0025 { 122 5 ---  12E 4 ---  122 5 ---  12F 4 --- }
665A: 0025 { 122 5 ---  130 4 ---  123 5 ---  104 4 --- }
665B: 0025 { 124 4 ---  131 4 ---  125 4 ---  132 5 --- }
665C: 0025 { 125 4 ---  133 5 ---  126 4 ---  134 4 --- }
665D: 0025 { 127 4 ---  104 4 ---  128 4 ---  104 4 --- }
665E: 0025 { 129 4 ---  135 4 ---  12A 4 ---  104 4 --- }
665F: 0025 { 12B 4 ---  104 4 ---  120 4 ---  136 4 --- }
6660: 0025 { 1A2 4 ---  1CB 7 ---  1B8 7 ---  1CC 7 --- }
6661: 0025 { 2D0 7 ---  1CD 7 ---  2D0 7 ---  1CE 7 --- }
6662: 0025 { 2D0 7 ---  1CF 7 ---  1C0 5 ---  1C0 5 --- }
6663: 0025 { 1C1 5 ---  1D0 5 ---  1C2 5 ---  1D1 5 --- }
6664: 0025 { 1C3 5 ---  1D2 5 ---  1C4 5 ---  1D3 5 --- }
6665: 0025 { 1C5 5 ---  1D4 5 ---  1C6 5 ---  1D5 5 --- }
6666: 0025 { 1C7 5 ---  1D6 5 ---  1C8 5 ---  1D7 5 --- }
6667: 0025 { 1C9 5 ---  1C9 5 ---  1CA 7 ---  1CA 7 --- }
6668: 0025 { 137 4 ---  140 4 ---  104 4 ---  141 4 --- }
6669: 0025 { 104 4 ---  142 4 ---  138 4 ---  143 4 --- }
666A: 0025 { 139 4 ---  142 4 ---  104 4 ---  144 4 --- }
666B: 0025 { 13A 4 ---  145 4 ---  13B 5 ---  146 7 --- }
666C: 0025 { 13C 5 ---  147 7 ---  13D 4 ---  148 4 --- }
666D: 0025 { 104 4 ---  144 4 x--  139 4 x--  142 4 --- }
666E: 0025 { 138 4 x--  143 4 x--  104 4 ---  142 4 --- }
666F: 0025 { 13E 4 ---  149 4 ---  13F 4 ---  14A 4 --- }
6670: 0025 { 1D8 4 ---  1E3 4 ---  1D9 7 ---  1E4 7 --- }
6671: 0025 { 1DA 7 ---  1E5 7 ---  1DB 7 ---  1E6 7 --- }
6672: 0025 { 1DC 7 ---  1E7 7 ---  1C0 5 ---  1E8 5 --- }
6673: 0025 { 1DD 5 ---  1E9 5 ---  1DE 5 ---  1EA 5 --- }
6674: 0025 { 290 5 ---  1E9 5 ---  1DF 5 ---  1E9 5 --- }
6675: 0025 { 1E0 5 ---  1EB 5 ---  1E1 5 ---  1E9 5 --- }
6676: 0025 { 1E2 5 ---  1EA 5 ---  1C6 5 ---  1E9 5 --- }
6677: 0025 { 1C9 5 ---  1EC 5 ---  1CA 7 ---  1ED 7 --- }
6678: 0025 { 14B 4 ---  159 4 ---  14C 4 ---  15A 4 --- }
6679: 0025 { 14D 4 ---  15B 4 ---  14E 4 ---  15C 4 --- }
667A: 0025 { 14F 4 ---  15D 4 ---  150 4 ---  15E 4 --- }
667B: 0025 { 151 4 ---  15F 4 ---  146 7 ---  160 7 --- }
667C: 0025 { 147 7 ---  161 7 ---  152 4 ---  162 4 --- }
667D: 0025 { 153 4 ---  163 4 ---  154 4 ---  164 4 --- }
667E: 0025 { 155 4 ---  165 4 ---  156 4 ---  166 4 --- }
667F: 0025 { 157 4 ---  167 4 ---  158 4 ---  168 4 --- }
6680: 0025 { 171 7 ---  178 7 ---  172 7 ---  179 7 --- }
6681: 0025 { 172 7 ---  17A 7 ---  172 7 ---  17B 7 --- }
6682: 0025 { 172 7 ---  17C 7 ---  172 7 ---  17C 7 --- }
6683: 0025 { 173 7 ---  17D 7 ---  174 4 ---  17E 4 --- }
6684: 0025 { 175 4 ---  17F 5 ---  176 4 ---  180 5 --- }
6685: 0025 { 176 4 ---  181 5 ---  176 4 ---  182 5 --- }
6686: 0025 { 176 4 ---  183 5 ---  176 4 ---  181 5 x-- }
6687: 0025 { 176 4 ---  180 5 x--  177 4 ---  184 4 --- }
6688: 0025 { 1C0 7 ---  1C9 7 ---  1C1 7 ---  1CA 7 --- }
6689: 0025 { 1C2 7 ---  1CB 7 ---  1C3 7 ---  1CC 7 --- }
668A: 0025 { 1C4 7 ---  1CD 7 ---  1C5 7 ---  1BC 7 x-- }
668B: 0025 { 1C3 7 ---  1CE 7 ---  1C6 7 ---  1CF 7 --- }
668C: 0025 { 1C7 7 ---  1D0 7 ---  1C5 7 x--  1D1 7 --- }
668D: 0025 { 1C4 7 x--  1D2 4 ---  1C3 7 ---  1D3 7 --- }
668E: 0025 { 1C8 7 ---  1D4 7 ---  1C2 7 ---  1CB 7 --- }
668F: 0025 { 1C3 7 ---  1CC 7 ---  1C0 7 x--  1D5 7 --- }
6690: 0025 { 178 7 ---  178 7 ---  185 5 ---  18F 7 --- }
6691: 0025 { 185 5 ---  18F 7 ---  186 7 ---  190 7 --- }
6692: 0025 { 187 7 ---  191 7 ---  188 7 ---  192 7 --- }
6693: 0025 { 189 7 ---  189 7 ---  17E 4 ---  17E 4 --- }
6694: 0025 { 17F 5 ---  17F 5 ---  181 5 x--  193 5 --- }
6695: 0025 { 18A 5 ---  194 5 ---  18B 5 ---  195 5 --- }
6696: 0025 { 18C 5 ---  195 5 ---  18D 5 ---  196 5 --- }
6697: 0025 { 18E 5 ---  146 5 ---  184 4 ---  184 4 --- }
6698: 0025 { 1D5 7 x--  1D5 7 x--  1D6 7 ---  1DC 7 --- }
6699: 0025 { 1D7 4 ---  1DD 7 ---  1D8 7 ---  1DE 7 --- }
669A: 0025 { 1D9 4 ---  1DF 7 ---  1BC 7 x--  1E0 7 --- }
669B: 0025 { 1D3 7 -y-  1E1 7 ---  1DA 7 ---  1E2 7 --- }
669C: 0025 { 1DB 4 ---  0A6 7 ---  1BC 7 ---  1E3 7 --- }
669D: 0025 { 1CD 7 xy-  1DF 7 x--  0A6 7 ---  0A6 7 --- }
669E: 0025 { 1D6 7 ---  1E4 7 ---  1D7 4 ---  1E5 7 --- }
669F: 0025 { 1D8 7 ---  1E6 7 ---  1D5 7 ---  1D5 7 --- }
66A0: 0025 { 178 7 ---  19F 7 ---  197 7 ---  1A0 7 --- }
66A1: 0025 { 197 7 ---  1A0 7 ---  198 7 ---  1A0 7 --- }
66A2: 0025 { 199 7 ---  1A1 7 ---  19A 7 ---  1A2 7 --- }
66A3: 0025 { 17D 7 ---  1A3 7 ---  17E 4 ---  17E 4 --- }
66A4: 0025 { 17F 5 ---  1A4 5 ---  193 5 x--  181 5 --- }
66A5: 0025 { 19B 5 ---  146 5 ---  19C 5 ---  194 5 --- }
66A6: 0025 { 19D 5 ---  180 5 ---  19E 5 ---  181 5 --- }
66A7: 0025 { 146 5 ---  146 5 ---  184 4 ---  184 4 --- }
66A8: 0025 { 1D5 7 x--  1D5 7 x--  0A6 7 ---  1CE 7 -y- }
66A9: 0025 { 1E7 7 ---  1F3 7 ---  1E8 7 ---  1F4 7 --- }
66AA: 0025 { 0A6 7 ---  1F5 7 ---  1E9 7 ---  1F6 7 --- }
66AB: 0025 { 1EA 7 ---  1F7 7 ---  1EB 7 ---  1F8 7 --- }
66AC: 0025 { 1EC 7 ---  1F9 7 ---  1ED 7 ---  1FA 7 --- }
66AD: 0025 { 1EE 7 ---  1F4 7 x--  1EF 7 ---  1FB 7 --- }
66AE: 0025 { 1F0 7 ---  1FC 7 ---  1F1 7 ---  1F4 7 --- }
66AF: 0025 { 1F2 7 ---  1FD 7 ---  1D5 7 ---  1D5 7 --- }
66B0: 0025 { 1A5 4 ---  1AF 4 ---  1A6 4 ---  1B0 4 --- }
66B1: 0025 { 1A6 4 ---  1B0 4 ---  1A7 4 ---  1B1 4 --- }
66B2: 0025 { 1A8 4 ---  1B2 4 ---  1A9 7 ---  1B3 7 --- }
66B3: 0025 { 1AA 7 ---  1B4 7 ---  1AB 4 ---  1B5 4 --- }
66B4: 0025 { 1AC 4 ---  1B6 4 ---  1AD 4 ---  1B6 4 --- }
66B5: 0025 { 1AD 4 ---  1B6 4 ---  1AD 4 ---  1B6 4 --- }
66B6: 0025 { 1AD 4 ---  1B6 4 ---  1AD 4 ---  1B6 4 --- }
66B7: 0025 { 1AD 4 ---  1B6 4 ---  1AE 4 ---  1B7 4 --- }
66B8: 0025 { 1D5 7 x--  206 7 ---  0A6 7 ---  207 7 --- }
66B9: 0025 { 1FE 7 ---  208 7 ---  1FF 7 ---  209 7 --- }
66BA: 0025 { 0A6 7 ---  207 7 ---  1EC 7 ---  20A 7 --- }
66BB: 0025 { 200 7 ---  20B 7 ---  201 7 ---  20C 7 --- }
66BC: 0025 { 0A6 7 ---  207 7 ---  202 7 ---  20D 7 --- }
66BD: 0025 { 1FF 7 x--  209 7 x--  203 7 ---  20E 7 --- }
66BE: 0025 { 204 7 ---  20F 7 ---  1FF 7 ---  209 7 --- }
66BF: 0025 { 205 7 ---  210 7 ---  1D5 7 ---  206 7 x-- }
66C0: 0025 { 10A 7 ---  10F 7 ---  10B 7 ---  110 7 --- }
66C1: 0025 { 10C 4 ---  111 7 ---  10C 4 ---  112 7 --- }
66C2: 0025 { 10B 7 x--  113 7 ---  10D 7 ---  2F1 7 --- }
66C3: 0025 { 10E 7 ---  114 7 ---  10C 4 ---  115 7 --- }
66C4: 0025 { 10C 4 ---  116 7 ---  10B 7 x--  117 7 --- }
66C5: 0025 { 10D 7 ---  118 7 ---  10E 7 ---  119 7 --- }
66C6: 0025 { 10C 4 ---  11A 7 ---  10C 4 ---  11A 7 x-- }
66C7: 0025 { 10B 7 x--  117 7 ---  10A 7 x--  11B 7 --- }
66C8: 0025 { 162 4 ---  164 4 ---  163 4 ---  165 4 --- }
66C9: 0025 { 163 4 ---  0A6 4 ---  163 4 ---  0A6 4 --- }
66CA: 0025 { 163 4 ---  166 4 ---  163 4 ---  166 4 x-- }
66CB: 0025 { 163 4 ---  0A6 4 ---  163 4 ---  167 4 --- }
66CC: 0025 { 163 4 ---  168 4 ---  163 4 ---  168 4 --- }
66CD: 0025 { 163 4 ---  168 4 ---  163 4 ---  168 4 --- }
66CE: 0025 { 163 4 ---  169 4 ---  163 4 ---  168 4 --- }
66CF: 0025 { 163 4 ---  16A 4 ---  162 4 x--  164 4 x-- }
66D0: 0025 { 11C 7 ---  128 7 ---  11D 7 ---  0FF 7 --- }
66D1: 0025 { 11E 7 ---  129 7 ---  11F 7 ---  0FF 7 --- }
66D2: 0025 { 120 4 ---  12A 4 ---  121 7 ---  12B 4 --- }
66D3: 0025 { 2F1 7 ---  2F1 7 ---  2F1 7 ---  12C 7 --- }
66D4: 0025 { 122 7 ---  12D 4 ---  123 4 ---  12E 7 --- }
66D5: 0025 { 124 7 ---  12F 7 ---  124 7 ---  2F1 7 --- }
66D6: 0025 { 125 7 ---  130 7 ---  126 4 ---  131 7 --- }
66D7: 0025 { 125 7 ---  132 7 ---  127 7 ---  10F 7 x-- }
66D8: 0025 { 16B 4 ---  176 4 ---  16C 4 ---  177 4 --- }
66D9: 0025 { 16D 4 ---  0FC 4 ---  16D 4 ---  0FC 4 --- }
66DA: 0025 { 16E 4 ---  178 4 ---  16E 4 x--  178 4 x-- }
66DB: 0025 { 16D 4 ---  0FC 4 ---  16F 4 ---  179 4 --- }
66DC: 0025 { 170 7 ---  17A 4 ---  171 7 ---  17B 4 --- }
66DD: 0025 { 172 4 ---  17C 4 ---  173 4 ---  17D 4 --- }
66DE: 0025 { 174 7 ---  17E 4 ---  170 7 ---  17A 4 --- }
66DF: 0025 { 175 7 ---  17F 4 ---  16B 4 x--  176 4 x-- }
66E0: 0025 { 133 7 ---  10F 7 ---  134 7 ---  140 7 --- }
66E1: 0025 { 135 7 ---  08E 4 ---  136 7 ---  141 7 --- }
66E2: 0025 { 137 7 ---  142 7 ---  138 7 ---  143 7 --- }
66E3: 0025 { 139 7 ---  2F1 7 ---  13A 7 ---  144 7 --- }
66E4: 0025 { 13B 7 ---  145 4 ---  13B 7 ---  145 4 --- }
66E5: 0025 { 13C 7 ---  146 7 ---  13D 7 ---  147 7 --- }
66E6: 0025 { 13E 7 ---  148 4 ---  13B 7 x--  145 4 x-- }
66E7: 0025 { 13B 7 x--  149 4 ---  13F 7 ---  10F 7 x-- }
66E8: 0025 { 176 4 ---  176 4 ---  180 4 ---  18C 4 --- }
66E9: 0025 { 181 4 ---  18D 4 ---  182 4 ---  18E 4 --- }
66EA: 0025 { 15F 4 ---  18F 4 ---  183 4 ---  190 4 --- }
66EB: 0025 { 184 4 ---  191 4 ---  179 4 ---  192 4 --- }
66EC: 0025 { 185 7 ---  0FC 4 ---  186 7 ---  0FC 4 --- }
66ED: 0025 { 187 7 ---  177 4 x--  188 7 ---  0FC 4 --- }
66EE: 0025 { 189 7 ---  15E 5 x--  18A 7 ---  193 5 --- }
66EF: 0025 { 18B 7 ---  194 7 ---  176 4 x--  176 4 x-- }
66F0: 0025 { 10F 7 ---  14F 7 ---  14A 7 ---  150 7 --- }
66F1: 0025 { 14B 7 ---  151 7 ---  14C 7 ---  152 7 --- }
66F2: 0025 { 14D 7 ---  153 7 ---  14E 7 ---  154 7 --- }
66F3: 0025 { 2F1 7 ---  154 7 ---  144 7 ---  155 7 --- }
66F4: 0025 { 145 4 ---  156 4 ---  145 4 ---  156 4 --- }
66F5: 0025 { 146 7 ---  157 7 ---  147 7 ---  158 7 --- }
66F6: 0025 { 148 4 ---  159 7 ---  145 4 x--  156 4 x-- }
66F7: 0025 { 149 4 ---  15A 4 ---  10F 7 x--  14F 7 x-- }
66F8: 0025 { 176 4 ---  1A1 4 ---  195 4 ---  1A2 4 --- }
66F9: 0025 { 196 4 ---  1A3 4 ---  197 4 ---  1A4 4 --- }
66FA: 0025 { 198 4 ---  1A5 4 ---  199 4 ---  1A6 4 --- }
66FB: 0025 { 19A 4 ---  1A3 4 ---  19B 4 ---  1A7 4 --- }
66FC: 0025 { 0FC 4 ---  1A8 4 ---  0FC 4 ---  1A8 4 --- }
66FD: 0025 { 19C 4 ---  1A9 4 ---  19D 5 ---  1AA 7 --- }
66FE: 0025 { 19E 7 ---  1AB 7 ---  19F 5 ---  1AC 7 --- }
66FF: 0025 { 1A0 7 ---  1AD 7 ---  176 4 x--  1A1 4 x-- }
