5700: 0025 { 24C 2 xyp  24C 2 --p  24C 2 xyp  1D1 2 x-- }
5701: 0025 { 24C 2 xyp  1C3 2 --p  24C 2 xyp  1D0 2 --p }
5702: 0025 { 24C 2 xyp  1C3 2 --p  24C 2 xyp  1D0 2 --p }
5703: 0025 { 24C 2 xyp  1D1 2 ---  24C 2 xyp  24C 2 --p }
5704: 0025 { 24C 2 xyp  1C3 2 --p  24C 2 xyp  1D0 2 --p }
5705: 0025 { 24C 2 xyp  1C3 2 --p  24C 2 xyp  1D0 2 --p }
5706: 0025 { 24C 2 xyp  24C 2 --p  24C 2 xyp  1D1 2 x-p }
5707: 0025 { 24C 2 xyp  1C3 2 --p  24C 2 xyp  1D0 2 --p }
5708: 0025 { 24C 2 xyp  1C3 2 --p  24C 2 xyp  1D0 2 --p }
5709: 0025 { 24C 2 xyp  1C3 2 --p  24C 2 xyp  1D0 2 --p }
570A: 0025 { 24C 2 xyp  1C3 2 --p  24C 2 xyp  1D0 2 --p }
570B: 0025 { 24C 2 xyp  1D1 2 --p  24C 2 xyp  24C 2 --p }
570C: 0130 { 22C 2 --p  23C 2 --p  22D 2 --p  23D 2 --p }
570D: 0130 { 20C 2 --p  21C 2 --p  20D 2 --p  21D 2 --p }
570E: ~
570F: 0025 { 24C 2 xyp  24C 2 xyp  24C 2 xyp  24C 2 xyp }
5710: 0025 { 24C 2 --p  24C 2 --p  1F0 2 --p  1F1 2 --p }
5711: 0130 { 22C 2 --p  23C 2 --p  22D 2 --p  23D 2 --p }
5712: 0130 { 22A 2 --p  23A 2 --p  22B 2 --p  23B 2 --p }
5713: 0025 { 1C4 2 --p  1D4 2 --p  24C 2 --p  24C 2 --p }
5714: 0130 { 228 2 --p  238 2 --p  229 2 --p  239 2 --p }
5715: 0130 { 20A 2 --p  21A 2 --p  20B 2 --p  21B 2 --p }
5716: 0025 { 24C 2 --p  24C 2 --p  1F0 2 --p  1F1 2 --p }
5717: 0145 { 208 2 --p  218 2 --p  209 2 --p  219 2 --p }
5718: 0130 { 20A 2 --p  21A 2 --p  20B 2 --p  21B 2 --p }
5719: 0130 { 228 2 --p  238 2 --p  229 2 --p  239 2 --p }
571A: 0130 { 22A 2 --p  23A 2 --p  22B 2 --p  23B 2 --p }
571B: 0025 { 1C4 2 --p  1D4 2 --p  24C 2 --p  24C 2 --p }
571C: 0130 { 02E 2 --p  03E 2 --p  02F 2 --p  03F 2 --p }
571D: 0130 { 00E 2 --p  01E 2 --p  00F 2 --p  01F 2 --p }
571E: ~
571F: 0025 { 24C 2 xyp  1D1 2 --p  24C 2 xyp  24C 2 --p }
5720: 0025 { 24C 2 --p  24C 2 --p  1F2 2 --p  1F3 2 --p }
5721: 0130 { 02E 2 --p  03E 2 --p  02F 2 --p  03F 2 --p }
5722: 0130 { 226 2 --p  03C 2 --p  227 2 --p  237 2 --p }
5723: 0025 { 1E4 2 --p  1F4 2 --p  24C 2 --p  24C 2 --p }
5724: 0130 { 220 2 --p  230 2 --p  221 2 --p  231 2 --p }
5725: 0130 { 222 2 --p  232 2 --p  223 2 --p  233 2 --p }
5726: 0025 { 24C 2 --p  24C 2 --p  1F2 2 --p  1F3 2 --p }
5727: 014B { 224 2 --p  234 2 --p  225 2 --p  235 2 --p }
5728: 0130 { 222 2 --p  232 2 --p  223 2 --p  233 2 --p }
5729: 0130 { 220 2 --p  230 2 --p  221 2 --p  231 2 --p }
572A: 0130 { 226 2 --p  236 2 --p  227 2 --p  237 2 --p }
572B: 0025 { 1E4 2 --p  1F4 2 --p  24C 2 --p  24C 2 --p }
572C: ~
572D: ~
572E: ~
572F: 0025 { 24C 2 xyp  24C 2 --p  24C 2 xyp  1D1 2 x-p }
5730: 0025 { 24C 2 x-p  24C 2 -yp  1D1 2 xy-  24C 2 -yp }
5731: 0025 { 184 2 --p  24C 2 xyp  185 2 --p  24C 2 xyp }
5732: 0025 { 186 2 --p  24C 2 xyp  187 2 --p  24C 2 xyp }
5733: 0025 { 24C 2 --p  24C 2 xyp  24C 2 --p  24C 2 xyp }
5734: 0130 { 200 2 --p  210 2 --p  201 2 --p  211 2 --p }
5735: 0130 { 202 2 --p  212 2 --p  203 2 --p  213 2 --p }
5736: 0025 { 24C 2 --p  24C 2 --p  1F0 2 --p  1F1 2 --p }
5737: 014B { 24E 2 --p  25E 2 --p  24F 2 --p  25F 2 --p }
5738: 0130 { 202 2 --p  212 2 --p  203 2 --p  213 2 --p }
5739: 0130 { 200 2 --p  210 2 --p  201 2 --p  211 2 --p }
573A: 0130 { 206 2 --p  216 2 --p  207 2 --p  217 2 --p }
573B: 0025 { 1C4 2 --p  1D4 2 --p  24C 2 --p  24C 2 --p }
573C: ~
573D: ~
573E: ~
573F: 0025 { 24C 2 xyp  24C 2 xyp  24C 2 xyp  24C 2 xyp }
5740: 0025 { 1E4 2 --p  1F4 2 --p  185 2 --p  24C 2 xyp }
5741: 0025 { 186 2 --p  24C 2 --p  1F0 2 --p  1F1 2 --p }
5742: 0025 { 184 2 --p  24C 2 xyp  185 2 --p  1F1 2 --p }
5743: ~
5744: 0130 { 00A 2 --p  01A 2 --p  00B 2 --p  01B 2 --p }
5745: 0130 { 02C 2 --p  03C 2 --p  02D 2 --p  03D 2 --p }
5746: 0025 { 24C 2 --p  24C 2 --p  1F2 2 --p  1F3 2 --p }
5747: 014D { 1A0 2 --p  01A 2 --p  1A1 2 --p  01B 2 --p }
5748: 0130 { 02C 2 --p  03C 2 --p  02D 2 --p  03D 2 --p }
5749: 0130 { 00A 2 --p  01A 2 --p  00B 2 --p  01B 2 --p }
574A: 0130 { 226 2 --p  03C 2 --p  227 2 --p  237 2 --p }
574B: 0025 { 1E4 2 --p  1F4 2 --p  24C 2 --p  24C 2 --p }
574C: ~
574D: ~
574E: ~
574F: 0130 { 24C 2 xyp  24C 2 xyp  24C 2 xyp  24C 2 xyp }
5750: 0025 { 194 3 ---  1A4 3 ---  195 3 ---  1A5 3 --- }
5751: 0025 { 1B4 3 ---  1A4 3 ---  1B5 3 ---  1A5 3 --- }
5752: 0025 { 196 3 ---  1B6 3 ---  197 3 ---  1B7 3 --- }
5753: ~
5754: 0025 { 184 2 --p  24C 2 xyp  185 2 --p  24C 2 xyp }
5755: 0025 { 186 2 --p  24C 2 xyp  187 2 --p  24C 2 xyp }
5756: 0025 { 24C 2 x-p  24C 2 -yp  1D1 2 xyp  24C 2 -yp }
5757: 0025 { 184 2 --p  24C 2 xyp  185 2 --p  24C 2 xyp }
5758: 0025 { 186 2 --p  24C 2 xyp  187 2 --p  24C 2 xyp }
5759: 0025 { 184 2 --p  24C 2 xyp  185 2 --p  24C 2 xyp }
575A: 0025 { 186 2 --p  24C 2 xyp  187 2 --p  24C 2 xyp }
575B: 0025 { 24C 2 --p  24C 2 xyp  24C 2 --p  24C 2 xyp }
575C: ~
575D: 0130 { 24C 2 --p  24C 2 xyp  08B 2 ---  08B 2 --- }
575E: 0130 { 099 2 ---  099 2 ---  09A 2 ---  09A 2 --- }
575F: 0130 { 08B 2 x--  08B 2 x--  24C 2 x-p  24C 2 -yp }
5760: ~
5761: ~
5762: 0025 { 24C 2 --p  24C 2 --p  1DC 3 ---  1A4 3 --- }
5763: 0025 { 1DD 3 ---  1A5 3 ---  24C 2 --p  24C 2 --p }
5764: 0025 { 1DC 3 ---  1A4 3 ---  1DD 3 ---  1A5 3 --- }
5765: ~
5766: 0025 { 24C 2 -yp  1D0 2 x-p  1E4 2 x-p  1C3 2 x-p }
5767: 0025 { 1E4 2 --p  1C3 2 --p  24C 2 xyp  1D0 2 --p }
5768: 0025 { 186 2 --p  24C 2 --p  187 2 --p  1F1 2 --p }
5769: 0025 { 184 2 --p  24C 2 --p  185 2 --p  1F1 2 --p }
576A: 0025 { 1E4 2 --p  1F4 2 --p  185 2 --p  24C 2 xyp }
576B: 0025 { 1E4 2 --p  1C3 2 --p  24C 2 --p  1D0 2 --p }
576C: 0025 { 24C 2 xyp  004 4 ---  24C 2 xyp  004 4 --- }
576D: ~
576E: ~
576F: 0130 { 24C 2 --p  24C 2 --p  1F2 2 --p  1F3 2 --p }
5770: ~
5771: ~
5772: 0025 { 24C 2 --p  24C 2 --p  196 3 ---  1A6 3 --- }
5773: 0025 { 197 3 ---  1A7 3 ---  24C 2 --p  24C 2 --p }
5774: 0025 { 196 3 ---  1A6 3 ---  197 3 ---  1A7 3 --- }
5775: ~
5776: 0025 { 186 2 --p  24C 2 xyp  187 2 --p  24C 2 xyp }
5777: 0025 { 24C 2 xyp  1C3 2 --p  1F2 2 --p  1F3 2 --p }
5778: 0025 { 186 2 --p  24C 2 --p  1F9 2 ---  1F1 2 --p }
5779: 0025 { 1F1 2 xyp  1D9 2 ---  24C 2 xyp  186 2 xyp }
577A: 0025 { 24C 2 -yp  186 2 -yp  1F1 2 -yp  1D9 2 x-- }
577B: 0025 { 24C 2 xyp  1C3 2 --p  1F2 2 --p  1F3 2 --p }
577C: ~
577D: ~
577E: 0130 { 00A 2 --p  1E9 2 --p  00B 2 --p  01B 2 --p }
577F: 0130 { 1C4 2 --p  1D4 2 --p  24C 2 --p  24C 2 --p }
5780: 0106 { 1C6 2 --p  1D6 2 --p  1C7 2 --p  1D7 2 --p }
5781: 0106 { 1E6 2 --p  1F6 2 --p  1E7 2 --p  1F7 2 --p }
5782: ~
5783: ~
5784: ~
5785: ~
5786: ~
5787: ~
5788: 0025 { 24C 2 --p  24C 2 --p  1F0 2 --p  1F1 2 --p }
5789: 014B { 24E 2 ---  25E 2 ---  24F 2 ---  25F 2 --- }
578A: 0130 { 206 2 --p  216 2 --p  207 2 --p  217 2 --p }
578B: 0025 { 1C4 2 --p  1D4 2 --p  24C 2 --p  24C 2 --p }
578C: ~
578D: ~
578E: 0130 { 228 2 --p  238 2 --p  24D 2 --p  239 2 --p }
578F: 0130 { 018 2 -y-  008 2 -y-  019 2 -y-  07E 2 --- }
5790: 0106 { 1CC 2 --p  1D4 2 --p  1C7 2 --p  1D7 2 --p }
5791: 0106 { 1E6 2 --p  1F6 2 --p  1CC 2 x-p  1F1 2 --p }
5792: ~
5793: ~
5794: ~
5795: ~
5796: ~
5797: ~
5798: 0025 { 24C 2 --p  24C 2 --p  1F2 2 --p  1F3 2 --p }
5799: 014D { 1A0 2 --p  01A 2 --p  1A1 2 --p  01B 2 --p }
579A: 0130 { 226 2 --p  03C 2 --p  227 2 --p  237 2 --p }
579B: 0025 { 1E4 2 --p  1F4 2 --p  24C 2 --p  24C 2 --p }
579C: 0130 { 07E 2 xy-  010 2 ---  07F 2 xy-  019 2 --- }
579D: 0130 { 000 2 ---  010 2 ---  030 2 xy-  020 2 xy- }
579E: 0130 { 07D 2 -y-  067 2 -y-  037 2 -y-  027 2 -y- }
579F: 0130 { 038 2 -y-  028 2 -y-  07E 2 -y-  029 2 -y- }
57A0: 0025 { 24C 2 --p  0C1 2 ---  08B 2 ---  08B 2 --- }
57A1: 0025 { 08B 2 x--  08B 2 x--  24C 2 x-p  0C1 2 --- }
57A2: ~
57A3: 0025 { 04E 2 --p  05E 2 --p  04E 2 x-p  05F 2 --p }
57A4: ~
57A5: ~
57A6: ~
57A7: ~
57A8: 0025 { 24C 2 x-p  24C 2 -yp  1D1 2 xy-  24C 2 -yp }
57A9: 0025 { 184 2 --p  24C 2 xyp  185 2 --p  24C 2 xyp }
57AA: 0025 { 186 2 --p  24C 2 xyp  187 2 --p  24C 2 xyp }
57AB: 0025 { 24C 2 --p  24C 2 xyp  24C 2 --p  24C 2 xyp }
57AC: 0130 { 020 2 ---  030 2 ---  029 2 ---  039 2 --- }
57AD: 0130 { 020 2 ---  07F 2 ---  010 2 xy-  07E 2 --- }
57AE: 0130 { 057 2 -y-  047 2 -y-  017 2 -y-  007 2 -y- }
57AF: 0130 { 018 2 -y-  008 2 -y-  019 2 -y-  009 2 -y- }
57B0: 0025 { 24C 2 --p  24C 2 xyp  08B 2 ---  08B 2 --- }
57B1: 0002 { 099 2 ---  099 2 ---  09A 2 ---  09A 2 --- }
57B2: 0025 { 08B 2 x--  08B 2 x--  24C 2 x-p  24C 2 -yp }
57B3: 0025 { 184 2 --p  24C 2 xyp  0B0 2 --p  24C 2 xyp }
57B4: 0025 { 184 2 --p  24C 2 xyp  0B1 2 --p  24C 2 xyp }
57B5: 0130 { 048 3 ---  058 3 ---  049 3 ---  059 3 --- }
57B6: 0130 { 04A 3 ---  05A 3 ---  04B 3 ---  05B 3 --- }
57B7: 0025 { 040 2 ---  050 2 ---  041 2 ---  051 2 --- }
57B8: 001F { 042 2 ---  052 2 ---  043 2 ---  053 2 --- }
57B9: 0130 { 048 3 ---  078 3 ---  04B 3 ---  07B 3 --- }
57BA: 0130 { 07E 2 xy-  009 2 xy-  038 2 xy-  002 2 xy- }
57BB: 0130 { 037 2 xy-  001 2 xy-  07D 2 xy-  046 2 -y- }
57BC: 0130 { 046 2 x--  07D 2 ---  001 2 ---  037 2 --- }
57BD: 0130 { 002 2 ---  038 2 ---  009 2 ---  07E 2 --- }
57BE: 0130 { 000 2 ---  010 2 ---  001 2 ---  011 2 --- }
57BF: 0130 { 002 2 ---  012 2 ---  046 2 ---  056 2 --- }
57C0: 0025 { 24C 2 --p  24C 2 xyp  08B 2 ---  08B 2 --- }
57C1: 0002 { 099 2 ---  099 2 ---  0A1 2 ---  0A1 2 --- }
57C2: 0002 { 0A0 2 ---  0A0 2 ---  0A1 2 ---  0A1 2 --- }
57C3: 0002 { 0A0 2 ---  0A0 2 ---  09A 2 ---  09A 2 --- }
57C4: 0025 { 08B 2 x--  08B 2 x--  24C 2 x-p  24C 2 -yp }
57C5: 0130 { 068 3 ---  078 3 ---  069 3 ---  079 3 --- }
57C6: 0130 { 06A 3 ---  07A 3 ---  06B 3 ---  07B 3 --- }
57C7: 0025 { 060 2 ---  070 2 ---  061 2 ---  071 2 --- }
57C8: 0020 { 062 2 ---  072 2 ---  063 2 ---  073 2 --- }
57C9: 0130 { 07E 2 xy-  07F 2 ---  046 2 ---  07C 2 --- }
57CA: 0130 { 07D 2 -y-  046 2 xy-  037 2 -y-  001 2 -y- }
57CB: 0130 { 038 2 -y-  002 2 -y-  07E 2 -y-  009 2 -y- }
57CC: 0130 { 046 2 x--  076 2 x--  009 2 ---  039 2 --- }
57CD: 0130 { 000 2 ---  07F 2 ---  046 2 ---  07C 2 --- }
57CE: 0130 { 020 2 ---  07F 2 ---  021 2 ---  031 2 --- }
57CF: 0130 { 022 2 ---  032 2 ---  066 2 ---  07C 2 --- }
57D0: 0025 { 24C 2 -yp  0C3 2 x-p  24C 2 -yp  0C2 2 x-p }
57D1: 0025 { 24C 2 -yp  0C1 2 x-p  24C 2 -yp  0C0 2 x-p }
57D2: 0025 { 24C 2 xyp  0C0 2 --p  24C 2 xyp  0C1 2 --p }
57D3: 0025 { 24C 2 xyp  0C2 2 --p  24C 2 xyp  0C3 2 --p }
57D4: 0130 { 1EC 2 ---  1D5 2 ---  1E5 2 ---  1F5 2 --- }
57D5: 0025 { 1EC 2 ---  1FC 2 ---  1ED 2 ---  1FD 2 --- }
57D6: 0025 { 1C4 2 --p  1D4 2 --p  24C 2 -yp  0C0 2 x-p }
57D7: 0025 { 24C 2 --p  0C0 2 --p  1F0 2 --p  1F1 2 --p }
57D8: 0002 { 24C 2 -yp  24C 2 -yp  24C 2 -yp  24C 2 -yp }
57D9: 0130 { 07F 2 -y-  010 2 ---  001 2 ---  011 2 --- }
57DA: 0130 { 07F 2 -y-  000 2 -y-  07E 2 -y-  009 2 -y- }
57DB: 0130 { 000 2 ---  030 2 ---  009 2 ---  039 2 --- }
57DC: 0130 { 07F 2 -y-  000 2 -y-  07C 2 -y-  046 2 -y- }
57DD: 0130 { 000 2 ---  07D 2 ---  009 2 ---  07E 2 --- }
57DE: 0130 { 000 2 ---  010 2 ---  030 2 xy-  020 2 xy- }
57DF: 0130 { 000 2 ---  010 2 ---  009 2 ---  019 2 --- }
57E0: 0000 { 089 2 --p  087 2 --p  0D0 2 --p  086 2 --p }
57E1: 0000 { 0D0 2 --p  085 2 --p  0D0 2 --p  086 2 --p }
57E2: 0000 { 0D0 2 --p  085 2 --p  08A 2 --p  088 2 --p }
57E3: 0130 { 000 2 ---  010 2 ---  001 2 ---  011 2 --- }
57E4: 0130 { 002 2 ---  012 2 ---  003 2 ---  013 2 --- }
57E5: 0130 { 004 2 ---  014 2 ---  005 2 ---  015 2 --- }
57E6: 0130 { 006 2 ---  016 2 ---  007 2 ---  017 2 --- }
57E7: 0130 { 008 2 ---  018 2 ---  009 2 ---  019 2 --- }
57E8: 0130 { 000 2 ---  010 2 ---  001 2 ---  011 2 --- }
57E9: 0130 { 002 2 ---  012 2 ---  046 2 ---  056 2 --- }
57EA: 0130 { 047 2 ---  057 2 ---  007 2 ---  017 2 --- }
57EB: 0130 { 008 2 ---  018 2 ---  009 2 ---  019 2 --- }
57EC: 0130 { 000 2 ---  030 2 ---  009 2 ---  039 2 --- }
57ED: 0130 { 07F 2 -y-  000 2 -y-  07C 2 -y-  046 2 -y- }
57EE: 0130 { 020 2 ---  030 2 ---  010 2 xy-  000 2 xy- }
57EF: 0130 { 020 2 ---  030 2 ---  029 2 ---  039 2 --- }
57F0: 0002 { 097 2 --p  087 2 --p  096 2 --p  086 2 --p }
57F1: 0002 { 095 2 --p  085 2 --p  096 2 --p  086 2 --p }
57F2: 0002 { 095 2 --p  085 2 --p  098 2 --p  088 2 --p }
57F3: 0130 { 020 2 ---  030 2 ---  021 2 ---  031 2 --- }
57F4: 0130 { 022 2 ---  032 2 ---  023 2 ---  033 2 --- }
57F5: 0130 { 024 2 ---  034 2 ---  025 2 ---  035 2 --- }
57F6: 0130 { 026 2 ---  036 2 ---  027 2 ---  037 2 --- }
57F7: 0130 { 028 2 ---  038 2 ---  029 2 ---  039 2 --- }
57F8: 0130 { 020 2 ---  030 2 ---  021 2 ---  031 2 --- }
57F9: 0130 { 022 2 ---  032 2 ---  066 2 ---  076 2 --- }
57FA: 0130 { 067 2 ---  077 2 ---  027 2 ---  037 2 --- }
57FB: 0130 { 028 2 ---  038 2 ---  029 2 ---  039 2 --- }
57FC: 0130 { 020 2 ---  07F 2 ---  021 2 ---  031 2 --- }
57FD: 0130 { 022 2 ---  032 2 ---  066 2 ---  07C 2 --- }
57FE: 0130 { 067 2 ---  07D 2 ---  027 2 ---  037 2 --- }
57FF: 0130 { 028 2 ---  038 2 ---  029 2 ---  07E 2 --- }
