0700: 0025 { 1A9 3 ---  1B9 3 ---  1AA 3 ---  1BA 3 --- }
0701: 0025 { 0A6 3 ---  0B6 3 ---  0A7 3 ---  0B7 3 --- }
0702: 0701 { 0A8 3 ---  0B8 3 ---  0A9 3 ---  0B9 3 --- }
0703: 0701 { 0C6 3 ---  0D6 3 ---  0C7 3 ---  0D7 3 --- }
0704: 0701 { 0C8 3 ---  0D8 3 ---  0C9 3 ---  0D9 3 --- }
0705: ~
0706: 0025 { 1E0 0 ---  1E4 0 ---  1E1 0 ---  1E5 0 --- }
0707: 0025 { 1E1 0 x--  1E5 0 x--  1E0 0 x--  1E4 0 x-- }
0708: 0025 { 1E2 0 ---  1E0 0 ---  1E5 0 ---  1E1 0 --- }
0709: 0025 { 1E5 0 x--  1E1 0 x--  1E2 0 x--  1E0 0 x-- }
070A: 0025 { 1E2 0 ---  1E2 0 ---  1E5 0 ---  1E5 0 --- }
070B: 0025 { 1E5 0 x--  1E5 0 x--  1E2 0 x--  1E2 0 x-- }
070C: 0025 { 0F8 7 ---  00E 7 ---  0F8 7 ---  00F 7 --- }
070D: 0025 { 0F8 7 ---  08C 7 ---  0F8 7 ---  00B 7 --- }
070E: 0025 { 0F8 7 x--  00B 7 x--  0F8 7 x--  08C 7 x-- }
070F: 0025 { 0F8 7 x--  00F 7 x--  0F8 7 x--  00E 7 x-- }
0710: 0025 { 0A6 3 ---  0B6 3 ---  0A7 3 ---  0B7 3 --- }
0711: 0025 { 0A8 3 ---  0B8 3 ---  0A9 3 ---  0B9 3 --- }
0712: 0130 { 1F4 2 ---  1F7 2 ---  1F6 2 ---  1F8 2 --- }
0713: 0130 { 1F7 2 ---  1F9 2 ---  1F8 2 ---  1FB 2 --- }
0714: 0130 { 1F7 2 ---  1F7 2 ---  1F8 2 ---  1F8 2 --- }
0715: ~
0716: ~
0717: ~
0718: ~
0719: ~
071A: ~
071B: ~
071C: 0025 { 01E 7 ---  0F8 7 ---  01F 7 ---  0D5 7 --- }
071D: 0025 { 09C 7 ---  0F8 7 ---  0F8 7 ---  0F8 7 --- }
071E: 0025 { 0F8 7 x--  0F8 7 x--  09C 7 x--  0F8 7 x-- }
071F: 0025 { 01F 7 x--  0D5 7 x--  01E 7 x--  0F8 7 x-- }
0720: 0025 { 200 2 ---  210 2 ---  201 2 ---  211 2 --- }
0721: 0025 { 202 2 ---  212 2 ---  203 2 ---  213 2 --- }
0722: 0025 { 207 2 x--  217 2 x--  206 2 x--  215 2 --- }
0723: 0025 { 206 2 ---  216 2 ---  207 2 ---  217 2 --- }
0724: 0025 { 208 2 ---  218 2 ---  209 2 ---  219 2 --- }
0725: 0025 { 20A 2 ---  21A 2 ---  20B 2 ---  21B 2 --- }
0726: 0025 { 20C 2 ---  21C 2 ---  20D 2 ---  21D 2 --- }
0727: 0025 { 20E 2 ---  21E 2 ---  20F 2 ---  21F 2 --- }
0728: 0025 { 240 2 ---  250 2 ---  241 2 ---  251 2 --- }
0729: 0025 { 242 2 ---  252 2 ---  243 2 ---  253 2 --- }
072A: 0025 { 194 2 ---  192 2 ---  0AA 3 ---  0AA 3 --- }
072B: 0025 { 194 2 ---  192 2 ---  195 2 ---  25B 3 -y- }
072C: 0025 { 194 2 ---  25B 3 xy-  195 2 ---  193 2 --- }
072D: 0025 { 194 2 ---  0AB 3 ---  195 2 ---  0AB 3 --- }
072E: 0025 { 24A 6 ---  25A 6 ---  24A 6 x--  25A 6 x-- }
072F: 0025 { 0F8 6 ---  0F8 6 ---  0F8 6 ---  27B 6 --- }
0730: 0025 { 220 2 ---  230 2 ---  221 2 ---  231 2 --- }
0731: 0025 { 222 2 ---  232 2 ---  223 2 ---  233 2 --- }
0732: 0025 { 227 2 x--  237 2 x--  225 2 ---  236 2 x-- }
0733: 0025 { 226 2 ---  236 2 ---  227 2 ---  237 2 --- }
0734: 0025 { 228 2 ---  238 2 ---  229 2 ---  239 2 --- }
0735: 0025 { 22A 2 ---  23A 2 ---  22B 2 ---  23B 2 --- }
0736: 0025 { 22C 2 ---  23C 2 ---  22D 2 ---  23D 2 --- }
0737: 0025 { 22E 2 ---  23E 2 ---  22F 2 ---  23F 2 --- }
0738: 0025 { 260 2 ---  270 2 ---  261 2 ---  271 2 --- }
0739: 0025 { 262 2 ---  272 2 ---  263 2 ---  273 2 --- }
073A: 0025 { 0AA 3 xy-  0AA 3 xy-  195 2 ---  193 2 --- }
073B: 0025 { 194 2 ---  192 2 ---  25B 3 ---  193 2 --- }
073C: 0025 { 25B 3 x--  192 2 ---  195 2 ---  193 2 --- }
073D: 0025 { 0AB 3 -y-  192 2 ---  0AB 3 -y-  193 2 --- }
073E: 0025 { 26A 6 ---  27A 6 ---  26A 6 x--  27A 6 x-- }
073F: 0025 { 0F8 6 x--  27B 6 x--  0F8 6 x--  0F8 6 x-- }
0740: 0025 { 24C 4 ---  26B 4 ---  24D 4 ---  24B 4 --- }
0741: 0025 { 24E 4 ---  25C 4 ---  24F 4 ---  26B 4 --- }
0742: 0025 { 24E 4 ---  25D 4 ---  24F 4 ---  26B 4 --- }
0743: 0025 { 24E 4 ---  25E 4 ---  24F 4 ---  26B 4 --- }
0744: 0025 { 24E 4 ---  25F 4 ---  24F 4 ---  26B 4 --- }
0745: 0025 { 24E 4 ---  26C 4 ---  24F 4 ---  26B 4 --- }
0746: 0025 { 26B 2 ---  26B 2 ---  26B 2 ---  26B 2 --- }
0747: 0025 { 194 2 ---  25B 3 -y-  195 2 ---  0AB 3 --- }
0748: 0025 { 194 2 ---  0AB 3 ---  195 2 ---  25B 3 xy- }
0749: 0025 { 25B 3 ---  192 2 ---  0AB 3 -y-  193 2 --- }
074A: 0025 { 0AB 3 -y-  192 2 ---  25B 3 x--  193 2 --- }
074B: ~
074C: 0130 { 264 4 ---  268 4 ---  265 4 ---  269 4 --- }
074D: 0130 { 266 4 ---  279 4 ---  266 4 ---  279 4 --- }
074E: 0130 { 265 4 ---  269 4 ---  265 4 ---  269 4 --- }
074F: 0130 { 266 4 ---  279 4 ---  267 4 ---  278 4 x-- }
0750: 0025 { 204 2 ---  214 2 ---  205 2 ---  215 2 --- }
0751: 0025 { 205 2 x--  216 2 ---  204 2 x--  214 2 x-- }
0752: 0025 { 204 2 ---  214 2 ---  205 2 ---  244 2 --- }
0753: 0025 { 205 2 x--  245 2 ---  204 2 x--  214 2 x-- }
0754: 0025 { 204 2 ---  214 2 ---  205 2 ---  246 2 --- }
0755: 0025 { 205 2 x--  247 2 ---  204 2 x--  214 2 x-- }
0756: 0025 { 0F8 7 ---  0F8 7 ---  0D7 7 ---  0C6 7 --- }
0757: 0025 { 0F8 7 ---  0C7 7 ---  0F8 7 ---  0F8 7 --- }
0758: ~
0759: ~
075A: ~
075B: ~
075C: 0130 { 278 4 ---  0FB 4 ---  279 4 ---  0FB 4 --- }
075D: 0130 { 269 4 ---  0F9 4 ---  269 4 ---  0F9 4 --- }
075E: 0130 { 279 4 ---  0FB 4 ---  279 4 ---  0FB 4 --- }
075F: 0130 { 269 4 ---  0F9 4 ---  268 4 x--  277 4 --- }
0760: 0025 { 224 2 ---  234 2 ---  225 2 ---  235 2 --- }
0761: 0025 { 226 2 ---  235 2 x--  224 2 x--  234 2 x-- }
0762: 0025 { 224 2 ---  234 2 ---  254 2 ---  235 2 --- }
0763: 0025 { 255 2 ---  235 2 x--  224 2 x--  234 2 x-- }
0764: 0025 { 224 2 ---  234 2 ---  256 2 ---  235 2 --- }
0765: 0025 { 257 2 ---  235 2 x--  224 2 x--  234 2 x-- }
0766: 0025 { 0F8 7 ---  0F8 7 ---  0C8 7 ---  0D8 7 --- }
0767: 0025 { 0C9 7 ---  0D9 7 ---  0D6 7 ---  0F8 7 --- }
0768: ~
0769: ~
076A: ~
076B: ~
076C: 0130 { 277 4 x--  274 4 ---  0F9 4 ---  275 4 --- }
076D: 0130 { 0FB 4 ---  0FB 4 ---  0FB 4 ---  0FB 4 --- }
076E: 0130 { 0F9 4 ---  275 4 ---  0F9 4 ---  275 4 --- }
076F: 0130 { 0F9 4 x--  275 4 x--  277 4 ---  274 4 x-- }
0770: 0025 { 0E1 4 ---  0F1 4 ---  0E2 4 ---  0F2 4 --- }
0771: 0025 { 0E3 4 ---  0FB 4 ---  0E4 4 ---  0E2 4 --- }
0772: 0025 { 0E4 4 ---  0E3 4 ---  0FB 4 ---  0F1 4 --- }
0773: 0025 { 0E5 4 ---  0E2 4 ---  0FB 4 ---  0F3 4 --- }
0774: 0025 { 0B0 4 ---  0FB 4 ---  0B1 4 ---  0FB 4 --- }
0775: 0025 { 0E2 4 ---  0FB 4 ---  0B2 4 ---  0FB 4 --- }
0776: 0025 { 0B3 4 ---  0FB 4 ---  0B2 4 ---  0FB 4 --- }
0777: 0025 { 0C0 4 ---  0FB 4 ---  0D2 4 ---  0FB 4 --- }
0778: 0025 { 0C1 4 ---  0D1 4 ---  0F2 4 ---  0F2 4 --- }
0779: 0025 { 0C2 4 ---  0B2 4 ---  0E3 4 ---  0E4 4 --- }
077A: 0025 { 0E2 4 ---  0F1 4 ---  0FB 4 ---  0E2 4 --- }
077B: 0025 { 0C3 4 ---  0C3 4 ---  0B2 4 ---  0D1 4 --- }
077C: 0025 { 0D0 4 ---  0F1 4 ---  0E3 4 ---  0B3 4 --- }
077D: 0025 { 0E2 4 ---  0F2 4 ---  0FB 4 ---  0B2 4 --- }
077E: ~
077F: ~
0780: 0025 { 1A9 3 ---  1B9 3 ---  1AA 3 ---  1E0 0 --- }
0781: 0025 { 1A0 3 ---  1E1 0 ---  1F3 3 ---  1E1 0 x-- }
0782: 0025 { 1A9 3 ---  1E0 0 x--  1AA 3 ---  1BA 3 --- }
0783: 0025 { 1A0 3 ---  19A 3 ---  1F3 3 ---  1E0 0 --- }
0784: 0025 { 1A9 3 ---  1E1 0 ---  1AA 3 ---  1E1 0 x-- }
0785: 0025 { 1A0 3 ---  1E0 0 x--  1F3 3 ---  19B 3 --- }
0786: 0006 { 089 7 ---  08A 7 ---  092 7 ---  082 7 --- }
0787: 0006 { 092 7 ---  082 7 ---  092 7 ---  082 7 --- }
0788: 0006 { 092 7 ---  082 7 ---  089 7 x--  08A 7 x-- }
0789: ~
078A: ~
078B: ~
078C: ~
078D: ~
078E: 0094 { 1A5 3 ---  1B5 3 ---  1A6 3 ---  1B6 3 --- }
078F: 0095 { 1A7 3 ---  1B7 3 ---  1A8 3 ---  1B8 3 --- }
0790: 0025 { 1A5 3 ---  1B5 3 ---  1E4 0 ---  1E2 0 --- }
0791: 0025 { 1E5 3 ---  1E5 3 ---  1E5 3 ---  1E5 3 --- }
0792: 0025 { 1E4 0 x--  1E2 0 x--  1A6 3 ---  1B6 3 --- }
0793: 0025 { 1A7 3 ---  1B7 3 ---  1E4 0 ---  1E2 0 --- }
0794: 0025 { 0F8 4 ---  0F8 4 ---  0F8 4 ---  0F8 4 --- }
0795: 0025 { 1E4 0 x--  1E2 0 x--  1A8 3 ---  1B8 3 --- }
0796: 0006 { 08A 7 ---  08A 7 ---  082 7 ---  082 7 --- }
0797: 0006 { 082 7 ---  082 7 ---  082 7 ---  082 7 --- }
0798: 0006 { 082 7 ---  082 7 ---  08A 7 x--  08A 7 x-- }
0799: ~
079A: ~
079B: ~
079C: ~
079D: ~
079E: 0096 { 1A9 3 ---  1B9 3 ---  1AA 3 ---  1BA 3 --- }
079F: 0097 { 1A0 3 ---  19A 3 ---  1F3 3 ---  19B 3 --- }
07A0: 0025 { 1A9 3 ---  1B9 3 ---  1E2 0 ---  1E2 0 --- }
07A1: 0025 { 1E5 3 ---  1E5 3 ---  1E5 3 ---  1E5 3 --- }
07A2: 0025 { 1E2 0 x--  1E2 0 x--  1AA 3 ---  1BA 3 --- }
07A3: 0025 { 1A0 3 ---  19A 3 ---  1E2 0 ---  1E2 0 --- }
07A4: 0025 { 0F8 4 ---  0F8 4 ---  0F8 4 ---  0F8 4 --- }
07A5: 0025 { 1E2 0 x--  1E2 0 x--  1F3 3 ---  19B 3 --- }
07A6: 0006 { 08A 7 ---  089 7 -y-  082 7 ---  092 7 -y- }
07A7: 0006 { 082 7 ---  092 7 -y-  082 7 ---  092 7 -y- }
07A8: 0006 { 082 7 ---  092 7 -y-  08A 7 x--  089 7 xy- }
07A9: ~
07AA: ~
07AB: ~
07AC: ~
07AD: ~
07AE: ~
07AF: ~
07B0: 0025 { 1A5 3 ---  1B5 3 ---  1E0 0 ---  1B6 3 --- }
07B1: 0025 { 1E1 0 ---  1B7 3 ---  1E1 0 x--  1B8 3 --- }
07B2: 0025 { 1E0 0 x--  1B5 3 ---  1A6 3 ---  1B6 3 --- }
07B3: 0025 { 1A7 3 ---  1B7 3 ---  1E0 0 ---  1B8 3 --- }
07B4: 0025 { 1E1 0 ---  1B5 3 ---  1E1 0 x--  1B6 3 --- }
07B5: 0025 { 1E0 0 x--  1B7 3 ---  1A8 3 ---  1B8 3 --- }
07B6: ~
07B7: ~
07B8: ~
07B9: ~
07BA: ~
07BB: ~
07BC: ~
07BD: ~
07BE: ~
07BF: ~
07C0: 0130 { 265 4 ---  269 4 ---  265 4 ---  269 4 --- }
07C1: 0124 { 060 6 ---  062 6 ---  061 6 ---  063 6 --- }
07C2: 0124 { 060 6 ---  062 6 ---  061 6 ---  063 6 --- }
07C3: 0124 { 060 6 ---  062 6 ---  061 6 ---  063 6 --- }
07C4: 0124 { 060 6 ---  062 6 ---  061 6 ---  063 6 --- }
07C5: 0124 { 060 6 ---  062 6 ---  061 6 ---  063 6 --- }
07C6: 0025 { 095 6 ---  095 6 ---  096 6 ---  096 6 --- }
07C7: 0098 { 1EB 4 ---  1ED 4 ---  1EC 4 ---  1DD 4 --- }
07C8: 0099 { 1EC 4 x--  1DD 4 x--  1EB 4 x--  1ED 4 x-- }
07C9: 009A { 1DD 4 x--  1DD 4 x--  1DD 4 ---  1EF 4 --- }
07CA: 009B { 1DD 4 x--  1EF 4 x--  1DD 4 ---  1DD 4 --- }
07CB: 009C { 1DD 4 x--  1EE 4 ---  1DD 4 ---  1EE 4 x-- }
07CC: ~
07CD: ~
07CE: ~
07CF: ~
07D0: 0025 { 0AA 3 ---  0AA 3 ---  200 2 ---  210 2 --- }
07D1: 0025 { 201 2 ---  211 2 ---  202 2 ---  212 2 --- }
07D2: 0025 { 203 2 ---  213 2 ---  0AA 3 xy-  0AA 3 xy- }
07D3: 0025 { 0AA 3 ---  0AA 3 ---  207 2 x--  217 2 x-- }
07D4: 0025 { 206 2 x--  215 2 ---  206 2 ---  216 2 --- }
07D5: 0025 { 207 2 ---  217 2 ---  0AA 3 xy-  0AA 3 xy- }
07D6: 0025 { 0AA 3 ---  0AA 3 ---  208 2 ---  218 2 --- }
07D7: 0025 { 209 2 ---  219 2 ---  20A 2 ---  21A 2 --- }
07D8: 0025 { 20B 2 ---  21B 2 ---  0AA 3 xy-  0AA 3 xy- }
07D9: 0025 { 0AA 3 ---  0AA 3 ---  20C 2 ---  21C 2 --- }
07DA: 0025 { 20D 2 ---  21D 2 ---  20E 2 ---  21E 2 --- }
07DB: 0025 { 20F 2 ---  21F 2 ---  0AA 3 xy-  0AA 3 xy- }
07DC: 0025 { 0AA 3 ---  0AA 3 ---  240 2 ---  250 2 --- }
07DD: 0025 { 241 2 ---  251 2 ---  242 2 ---  252 2 --- }
07DE: 0025 { 243 2 ---  253 2 ---  0AA 3 xy-  0AA 3 xy- }
07DF: ~
07E0: 0025 { 0AA 3 ---  0AA 3 ---  220 2 ---  230 2 --- }
07E1: 0025 { 221 2 ---  231 2 ---  222 2 ---  232 2 --- }
07E2: 0025 { 223 2 ---  233 2 ---  0AA 3 xy-  0AA 3 xy- }
07E3: 0025 { 0AA 3 ---  0AA 3 ---  227 2 x--  237 2 x-- }
07E4: 0025 { 225 2 ---  236 2 x--  226 2 ---  236 2 --- }
07E5: 0025 { 227 2 ---  237 2 ---  0AA 3 xy-  0AA 3 xy- }
07E6: 0025 { 0AA 3 ---  0AA 3 ---  228 2 ---  238 2 --- }
07E7: 0025 { 229 2 ---  239 2 ---  22A 2 ---  23A 2 --- }
07E8: 0025 { 22B 2 ---  23B 2 ---  0AA 3 xy-  0AA 3 xy- }
07E9: 0025 { 0AA 3 ---  0AA 3 ---  22C 2 ---  23C 2 --- }
07EA: 0025 { 22D 2 ---  23D 2 ---  22E 2 ---  23E 2 --- }
07EB: 0025 { 22F 2 ---  23F 2 ---  0AA 3 xy-  0AA 3 xy- }
07EC: 0025 { 0AA 3 ---  0AA 3 ---  260 2 ---  270 2 --- }
07ED: 0025 { 261 2 ---  271 2 ---  262 2 ---  272 2 --- }
07EE: 0025 { 263 2 ---  273 2 ---  0AA 3 xy-  0AA 3 xy- }
07EF: ~
07F0: 0130 { 0AE 7 ---  0CE 7 ---  0AF 7 ---  0CF 7 --- }
07F1: 0005 { 0FC 3 ---  0FC 3 ---  0FC 3 ---  0FC 3 --- }
07F2: 07F1 { 002 3 ---  003 3 ---  000 3 ---  001 3 --- }
07F3: 0204 { 02D 4 ---  02D 4 -y-  02D 4 x--  02D 4 xy- }
07F4: ~
07F5: ~
07F6: ~
07F7: ~
07F8: ~
07F9: ~
07FA: ~
07FB: ~
07FC: ~
07FD: ~
07FE: ~
07FF: ~
