1500: 0000 { 0A0 7 ---  0A2 7 ---  0A1 7 ---  0A3 7 --- }
1501: 0000 { 0A1 7 x--  0A3 7 x--  0A0 7 x--  0A2 7 x-- }
1502: 0130 { 000 3 ---  010 3 ---  001 3 ---  011 3 --- }
1503: 0130 { 002 3 ---  012 3 ---  003 3 ---  013 3 --- }
1504: 0130 { 004 3 ---  014 3 ---  005 3 ---  015 3 --- }
1505: 0130 { 02E 3 ---  03E 3 ---  02E 3 ---  03E 3 --- }
1506: 0130 { 02E 3 ---  03E 3 ---  02E 3 ---  03E 3 --- }
1507: 0130 { 005 3 x--  015 3 x--  004 3 x--  014 3 x-- }
1508: 013F { 004 3 ---  014 3 ---  005 3 ---  015 3 --- }
1509: 013F { 02E 3 ---  03E 3 ---  02E 3 ---  03E 3 --- }
150A: 0130 { 1EE 3 ---  1FE 3 ---  1EF 3 ---  1FF 3 --- }
150B: 0025 { 0F8 3 --p  0F8 3 --p  185 3 x-p  0F8 3 --p }
150C: 0025 { 18D 2 --p  19D 2 --p  18E 2 --p  19E 2 --p }
150D: 0025 { 18F 2 --p  19F 2 --p  185 2 --p  0F8 2 --p }
150E: 0025 { 185 3 x-p  0F8 2 --p  18A 2 --p  19A 2 --p }
150F: 0025 { 18B 2 --p  19B 2 --p  18C 2 --p  19C 2 --p }
1510: 0000 { 0A4 7 ---  0A6 7 ---  0A5 7 ---  0A7 7 --- }
1511: 0000 { 0A5 7 x--  0A7 7 x--  0A4 7 x--  0A6 7 x-- }
1512: 0130 { 020 3 ---  020 3 ---  021 3 ---  021 3 --- }
1513: 0130 { 022 3 ---  022 3 ---  023 3 ---  023 3 --- }
1514: 0130 { 024 3 ---  034 3 ---  025 3 ---  035 3 --- }
1515: 0130 { 02F 3 ---  03F 3 ---  02F 3 ---  03F 3 --- }
1516: 0130 { 02F 3 ---  03F 3 ---  02F 3 ---  03F 3 --- }
1517: 0130 { 025 3 x--  035 3 x--  024 3 x--  034 3 x-- }
1518: 013F { 024 3 ---  034 3 ---  025 3 ---  035 3 --- }
1519: 013F { 02F 3 ---  03F 3 ---  02F 3 ---  03F 3 --- }
151A: 0130 { 1FA 3 ---  1FA 3 ---  1FB 3 ---  1FB 3 --- }
151B: 0025 { 185 3 --p  0F8 3 x-p  0F8 3 x-p  0F8 3 x-p }
151C: 0025 { 1AD 2 --p  1BD 2 --p  1AE 2 --p  1BE 2 --p }
151D: 0025 { 1AF 2 --p  1BF 2 --p  0F8 2 --p  0F8 2 --p }
151E: 0025 { 0F8 2 --p  0F8 2 --p  1AA 2 --p  1BD 2 --p }
151F: 0025 { 1AB 2 --p  1BE 2 --p  1AC 2 --p  1BF 2 --p }
1520: 0000 { 0A8 7 ---  0AA 7 ---  0A9 7 ---  0AB 7 --- }
1521: 0000 { 0A9 7 x--  0AB 7 x--  0A8 7 x--  0AA 7 x-- }
1522: 0130 { 020 3 -y-  020 3 -y-  021 3 -y-  021 3 -y- }
1523: 0130 { 022 3 -y-  022 3 -y-  023 3 -y-  023 3 -y- }
1524: 01ED { 192 2 ---  194 2 -y-  193 2 -y-  186 2 xy- }
1525: 01EC { 192 2 -y-  186 2 -y-  193 2 -y-  195 2 -y- }
1526: 0130 { 180 2 ---  180 2 -y-  183 2 ---  183 2 -y- }
1527: 0130 { 183 2 ---  182 2 -y-  182 2 ---  183 2 -y- }
1528: 0130 { 182 2 ---  182 2 -y-  180 2 x--  180 2 xy- }
1529: 0130 { 1ED 3 x--  1FD 3 x--  1EC 3 x--  1FC 3 x-- }
152A: 0130 { 1FE 3 -y-  1EE 3 -y-  1FF 3 -y-  1EF 3 -y- }
152B: 0130 { 004 3 --p  014 3 --p  005 3 --p  015 3 --p }
152C: 0130 { 02E 3 --p  03E 3 --p  02E 3 --p  03E 3 --p }
152D: 0130 { 02E 3 x-p  03E 3 x-p  02E 3 x-p  03E 3 x-p }
152E: 0130 { 005 3 x-p  015 3 x-p  004 3 x-p  014 3 x-p }
152F: 0130 { 02E 3 --p  03E 3 --p  02E 3 --p  03E 3 --p }
1530: 0000 { 0C2 7 ---  0B2 7 ---  0C3 7 ---  0B3 7 --- }
1531: 0000 { 0C3 7 x--  0B3 7 x--  0C2 7 x--  0B2 7 x-- }
1532: 0130 { 010 3 -y-  000 3 -y-  011 3 -y-  001 3 -y- }
1533: 0130 { 012 3 -y-  002 3 -y-  013 3 -y-  003 3 -y- }
1534: 01E4 { 194 2 ---  192 2 ---  186 2 x--  193 2 --- }
1535: 01E2 { 186 2 ---  192 2 ---  195 2 ---  193 2 --- }
1536: 0130 { 1EA 3 ---  1EB 3 ---  1EA 3 ---  1EB 3 --- }
1537: 0130 { 1EC 3 ---  1FC 3 ---  1ED 3 ---  1FD 3 --- }
1538: 0130 { 188 3 ---  188 3 -y-  188 3 x--  188 3 xy- }
1539: 0130 { 184 2 ---  190 2 ---  184 2 x--  190 2 x-- }
153A: 014C { 194 2 ---  186 2 -y-  184 2 x--  190 2 x-- }
153B: 0130 { 024 3 --p  034 3 --p  025 3 --p  035 3 --p }
153C: 0130 { 02F 3 --p  03F 3 --p  02F 3 --p  03F 3 --p }
153D: 0130 { 02F 3 x-p  03F 3 x-p  02F 3 x-p  03F 3 x-p }
153E: 0130 { 025 3 x-p  035 3 x-p  024 3 x-p  034 3 x-p }
153F: 0130 { 02F 3 --p  03F 3 --p  02F 3 --p  03F 3 --p }
1540: 0000 { 0C0 7 ---  0B2 7 ---  0C1 7 ---  0B3 7 --- }
1541: 0000 { 0C1 7 x--  0B3 7 x--  0C0 7 x--  0B2 7 x-- }
1542: 0145 { 180 2 ---  190 2 ---  183 2 ---  193 2 --- }
1543: 0100 { 182 2 ---  192 2 ---  183 2 ---  193 2 --- }
1544: 0148 { 182 2 ---  192 2 ---  180 2 x--  190 2 x-- }
1545: 0025 { 1CE 0 --p  1DE 0 --p  1CF 0 --p  1DF 0 --p }
1546: 0025 { 1CF 0 x-p  1DF 0 x-p  1CE 0 x-p  1DE 0 x-p }
1547: 0025 { 0F8 3 x--  0F8 3 x--  1CF 0 x--  1DF 0 x-- }
1548: 0025 { 1CE 0 x--  1DE 0 x--  0F8 3 x--  0F8 3 x-- }
1549: 014B { 184 2 ---  190 2 ---  186 2 x--  193 2 --- }
154A: 014C { 194 2 ---  192 2 ---  187 2 ---  197 2 --- }
154B: 0130 { 000 3 ---  010 3 ---  001 3 ---  011 3 --- }
154C: 0130 { 002 3 ---  012 3 ---  003 3 ---  013 3 --- }
154D: 0025 { 0F8 3 ---  0F8 3 ---  1CE 0 ---  1DE 0 --- }
154E: 0025 { 1CF 0 ---  1DF 0 ---  0F8 3 ---  0F8 3 --- }
154F: 011F { 1C7 6 ---  1D7 6 ---  1C8 6 ---  1D8 6 --- }
1550: 0000 { 0B4 7 ---  0B6 7 ---  0B5 7 ---  0B7 7 --- }
1551: 0000 { 0B5 7 x--  0B7 7 x--  0B4 7 x--  0B6 7 x-- }
1552: 014B { 184 2 ---  190 2 ---  195 2 ---  193 2 --- }
1553: 003F { 194 2 ---  192 2 ---  195 2 ---  193 2 --- }
1554: 014C { 194 2 ---  192 2 ---  184 2 x--  190 2 x-- }
1555: 0025 { 1CE 0 ---  1DE 0 ---  1CF 0 ---  1DF 0 --- }
1556: 0025 { 1CF 0 x--  1DF 0 x--  1CE 0 x--  1DE 0 x-- }
1557: 0130 { 1CD 3 x--  1DD 3 x--  1CC 3 x--  1DC 3 x-- }
1558: 0130 { 1CB 3 x--  1DB 3 x--  1CB 3 ---  1DB 3 --- }
1559: 0130 { 1CC 3 ---  1DC 3 ---  1CD 3 ---  1DD 3 --- }
155A: 014C { 194 2 ---  192 2 ---  1A7 2 ---  1B7 2 --- }
155B: 0130 { 020 3 ---  020 3 ---  021 3 ---  021 3 --- }
155C: 0130 { 1A8 3 ---  1B8 3 ---  1A9 3 ---  1B9 3 --- }
155D: 0130 { 188 3 ---  198 3 ---  189 3 ---  0FE 3 --- }
155E: 0130 { 189 3 ---  0FE 3 ---  188 3 x--  198 3 x-- }
155F: ~
1560: 0000 { 0B0 7 ---  0B2 7 ---  0B1 7 ---  0B3 7 --- }
1561: 0000 { 0B1 7 x--  0B3 7 x--  0B0 7 x--  0B2 7 x-- }
1562: 014D { 190 2 -y-  180 2 -y-  193 2 -y-  183 2 -y- }
1563: 014E { 192 2 ---  182 2 -y-  193 2 ---  183 2 -y- }
1564: 014F { 192 2 -y-  182 2 -y-  190 2 xy-  180 2 xy- }
1565: 0025 { 0F8 4 x--  1E0 4 ---  1D1 4 ---  1E1 4 --- }
1566: 0025 { 1D2 4 ---  1E2 4 ---  0F8 4 x--  0F8 4 x-- }
1567: 0025 { 0F8 7 ---  00E 7 ---  0F8 7 ---  00F 7 --- }
1568: 0025 { 0F8 7 ---  08C 7 ---  0F8 7 ---  0F8 7 --- }
1569: 0025 { 01E 7 ---  0F8 7 ---  01F 7 ---  0D5 7 --- }
156A: 0025 { 09C 7 ---  0F8 7 ---  0F8 7 ---  0F8 7 --- }
156B: 0130 { 020 3 ---  1A0 3 ---  021 3 ---  1A1 3 --- }
156C: 0130 { 196 3 ---  1A2 3 ---  199 3 ---  1A3 3 --- }
156D: 0130 { 198 3 ---  188 3 -y-  0FE 3 ---  189 3 -y- }
156E: 0130 { 0FE 3 ---  189 3 -y-  198 3 x--  188 3 xy- }
156F: ~
1570: 0000 { 1E8 7 ---  1F8 7 ---  1E9 7 ---  1F9 7 --- }
1571: 0130 { 182 2 ---  192 2 ---  230 2 ---  190 2 x-- }
1572: 0130 { 231 2 ---  190 2 ---  183 2 ---  193 2 --- }
1573: 0025 { 263 7 ---  273 7 ---  264 7 ---  274 7 --- }
1574: 0025 { 265 7 ---  275 7 ---  078 7 ---  078 7 --- }
1575: 0025 { 1F0 4 ---  0F8 4 x--  1F1 4 ---  0F8 4 x-- }
1576: 011F { 1C3 6 ---  1D3 6 ---  1C4 6 ---  1D4 6 --- }
1577: 0025 { 01E 7 ---  093 5 ---  01F 7 ---  0D5 7 --- }
1578: 0025 { 09C 7 ---  0F8 7 ---  0F8 7 ---  094 5 --- }
1579: 0124 { 1C3 6 ---  1D3 6 ---  1C4 6 ---  1D4 6 --- }
157A: ~
157B: ~
157C: ~
157D: ~
157E: ~
157F: ~
1580: ~
1581: ~
1582: ~
1583: ~
1584: ~
1585: ~
1586: ~
1587: ~
1588: 0025 { 0A0 4 --p  0A2 4 --p  0A1 4 --p  0A3 4 --p }
1589: 0025 { 0A0 7 --p  0A2 7 --p  0A1 7 --p  0A3 7 --p }
158A: 003C { 004 4 ---  004 4 ---  004 4 ---  004 4 --- }
158B: ~
158C: ~
158D: ~
158E: ~
158F: ~
1590: ~
1591: ~
1592: ~
1593: ~
1594: ~
1595: ~
1596: ~
1597: 0025 { 0F8 2 --p  0A0 4 --p  0F8 2 --p  0A1 4 --p }
1598: 0025 { 0A2 4 --p  0A2 4 --p  0A3 4 --p  0A3 4 --p }
1599: 0025 { 0A2 7 --p  0A2 7 --p  0A3 7 --p  0A3 7 --p }
159A: 0025 { 0F8 2 ---  0A0 7 --p  0F8 2 ---  0A1 7 --p }
159B: ~
159C: ~
159D: ~
159E: ~
159F: ~
15A0: ~
15A1: ~
15A2: ~
15A3: ~
15A4: ~
15A5: ~
15A6: ~
15A7: 0025 { 0A2 4 --p  0A2 4 --p  0A3 4 --p  0A3 4 --p }
15A8: 0130 { 0A2 4 --p  0A2 4 --p  0A3 4 --p  0A3 4 --p }
15A9: 0130 { 0A2 7 --p  0A2 7 --p  0A3 7 --p  0A3 7 --p }
15AA: 0130 { 0A2 7 --p  0A2 7 --p  0A3 7 --p  0A3 7 --p }
15AB: ~
15AC: ~
15AD: ~
15AE: ~
15AF: ~
15B0: ~
15B1: ~
15B2: ~
15B3: ~
15B4: ~
15B5: ~
15B6: ~
15B7: ~
15B8: ~
15B9: ~
15BA: ~
15BB: ~
15BC: ~
15BD: ~
15BE: ~
15BF: ~
15C0: ~
15C1: ~
15C2: ~
15C3: ~
15C4: ~
15C5: ~
15C6: ~
15C7: ~
15C8: ~
15C9: ~
15CA: ~
15CB: ~
15CC: ~
15CD: ~
15CE: ~
15CF: ~
15D0: ~
15D1: ~
15D2: ~
15D3: ~
15D4: ~
15D5: ~
15D6: ~
15D7: ~
15D8: ~
15D9: ~
15DA: ~
15DB: ~
15DC: ~
15DD: ~
15DE: ~
15DF: ~
15E0: ~
15E1: ~
15E2: ~
15E3: ~
15E4: ~
15E5: ~
15E6: ~
15E7: ~
15E8: ~
15E9: ~
15EA: ~
15EB: ~
15EC: ~
15ED: ~
15EE: ~
15EF: ~
15F0: ~
15F1: ~
15F2: ~
15F3: ~
15F4: ~
15F5: ~
15F6: ~
15F7: ~
15F8: ~
15F9: ~
15FA: ~
15FB: ~
15FC: ~
15FD: ~
15FE: ~
15FF: ~
