6200: 0025 { 29B 6 ---  08C 6 ---  29B 4 ---  08D 6 --- }
6201: 0025 { 29B 6 ---  08E 6 ---  29B 4 ---  0E5 7 --- }
6202: 0025 { 0C9 3 x--  0C8 3 x--  0D9 3 x--  0C7 3 x-- }
6203: 0025 { 0DE 5 ---  0A7 5 x--  0DE 5 x--  0A6 5 x-- }
6204: 0025 { 0DE 5 --p  0EE 5 --p  0DF 5 --p  0EF 5 --p }
6205: 0025 { 0E0 3 --p  08F 5 --p  29B 6 ---  29B 6 --- }
6206: ~
6207: ~
6208: 0025 { 0E5 7 ---  29B 4 ---  0E6 7 ---  0F6 7 --- }
6209: 0025 { 0E1 7 ---  0F1 7 ---  0E2 7 ---  0F2 7 --- }
620A: 0025 { 0E5 7 ---  0E5 7 ---  0E5 7 ---  1EC 5 --- }
620B: 0025 { 0E5 7 ---  1ED 5 ---  0E5 7 ---  0E5 7 --- }
620C: 0025 { 0E5 7 x--  2DE 5 x--  0E5 7 ---  0E5 7 x-- }
620D: 0025 { 0E5 7 ---  0E5 7 ---  0E5 7 ---  2DE 5 --- }
620E: 0025 { 0E5 7 x--  2CE 5 x--  0E5 7 ---  0E5 7 x-- }
620F: 0025 { 0E5 7 ---  0E5 7 ---  0E5 7 ---  2CE 5 --- }
6210: 0025 { 09C 6 ---  0AC 6 ---  09D 6 ---  0A0 6 --- }
6211: 0025 { 09E 6 ---  0A1 6 ---  09F 6 ---  0AF 6 --- }
6212: 0025 { 0D8 3 x--  0E8 3 x--  0D7 3 x--  0E7 3 x-- }
6213: 0025 { 0B7 5 x--  0F7 4 ---  0B6 5 x--  0BB 4 --- }
6214: 0025 { 0C3 5 --p  0E9 5 --p  0C4 5 --p  0CB 5 --p }
6215: 0025 { 087 5 --p  097 5 --p  29B 6 ---  29B 6 --- }
6216: 0025 { 29B 4 --p  29B 4 --p  088 4 --p  098 4 --p }
6217: 0025 { 089 4 --p  099 4 --p  08A 4 --p  09A 4 --p }
6218: 0025 { 29B 4 ---  0A2 5 ---  0E5 7 ---  0A3 5 --- }
6219: 0025 { 0E3 7 ---  0F3 7 ---  0E4 7 ---  0F4 7 --- }
621A: 0025 { 1E8 5 ---  1F8 5 ---  0D2 5 ---  1F9 5 --- }
621B: 0025 { 0D3 5 ---  1FA 5 ---  1EB 5 ---  1FB 5 --- }
621C: 0025 { 0E5 7 x--  2DE 5 x--  0E5 7 ---  2CE 5 x-- }
621D: 0025 { 0E5 7 ---  2CE 5 ---  0E5 7 ---  2DE 5 --- }
621E: 0025 { 2CE 5 xy-  0E5 7 xy-  0E5 7 xy-  0E5 7 --- }
621F: 0025 { 0E5 7 -y-  0E5 7 ---  2CE 5 -y-  0E5 7 -y- }
6220: 0025 { 0BC 6 ---  0CC 6 ---  0C0 6 ---  0D0 6 --- }
6221: 0025 { 0C1 6 ---  0D1 6 ---  0C2 6 ---  0CF 6 --- }
6222: 0025 { 2E6 5 ---  2F6 5 ---  2E0 5 ---  2F0 5 --- }
6223: 0025 { 2E1 5 ---  2F1 5 ---  2E7 5 ---  2F7 5 --- }
6224: 0025 { 2E6 5 ---  2F6 5 ---  1CA 5 ---  1DA 5 --- }
6225: 0025 { 1CB 5 ---  1DB 5 ---  2E7 5 ---  2F7 5 --- }
6226: 0025 { 29B 4 --p  29B 4 --p  0A8 4 --p  0B8 4 --p }
6227: 0025 { 0A9 4 --p  0B9 4 --p  0AA 4 --p  0BA 4 --p }
6228: 0025 { 0B2 5 ---  0F7 4 ---  0B3 5 ---  0BB 4 --- }
6229: 0025 { 0CA 7 ---  0CA 7 ---  0CA 7 x--  0CA 7 x-- }
622A: 0025 { 1FC 5 ---  110 5 ---  1FD 5 ---  111 5 --- }
622B: 0025 { 1FE 5 ---  112 5 ---  1FF 5 ---  113 5 --- }
622C: 0025 { 2DE 5 xy-  0E5 7 xy-  0E5 7 xy-  0E5 7 --- }
622D: 0025 { 0E5 7 -y-  0E5 7 ---  2DE 5 -y-  0E5 7 -y- }
622E: 0137 { 2D5 0 ---  010 0 ---  001 0 ---  011 0 --- }
622F: 0138 { 002 0 ---  012 0 ---  003 0 ---  013 0 --- }
6230: 0130 { 182 2 ---  1B3 2 xy-  183 2 ---  18C 2 xy- }
6231: 0130 { 182 2 ---  18C 2 -y-  183 2 ---  1B3 2 -y- }
6232: 0025 { 083 5 ---  093 5 ---  084 5 ---  094 5 --- }
6233: 0025 { 084 3 x--  094 3 x--  083 3 x--  093 3 x-- }
6234: 0025 { 085 1 ---  095 1 ---  29B 1 ---  29B 1 --- }
6235: 0025 { 086 5 x--  096 5 x--  29B 5 ---  29B 5 --- }
6236: 0025 { 082 1 ---  29B 1 ---  29B 1 ---  29B 1 --- }
6237: 0025 { 29B 4 ---  29B 4 ---  29B 4 ---  092 4 x-- }
6238: 0025 { 29B 4 ---  29B 4 ---  0F0 4 ---  29B 4 --- }
6239: 0025 { 29B 2 ---  0F0 2 x--  29B 2 ---  29B 2 --- }
623A: 0025 { 0E5 5 ---  0F5 5 ---  2B0 5 ---  0F5 5 --- }
623B: 0025 { 2B1 5 ---  0F5 5 ---  0E5 5 ---  0F5 5 --- }
623C: 0025 { 0E5 5 ---  0F5 5 ---  2A0 5 ---  2B3 5 --- }
623D: 0025 { 2B2 5 ---  2B4 5 ---  0E5 5 ---  0F5 5 --- }
623E: 0135 { 020 0 ---  020 0 ---  021 0 ---  021 0 --- }
623F: 0136 { 022 0 ---  022 0 ---  023 0 ---  023 0 --- }
6240: 0106 { 2CB 5 x--  2DB 5 x--  2CA 5 x--  2DA 5 x-- }
6241: 0106 { 2CA 5 ---  2DA 5 ---  2CA 5 x--  2DA 5 x-- }
6242: 0106 { 2CA 5 ---  2DA 5 ---  2CB 5 ---  2DB 5 --- }
6243: 0025 { 2E8 5 --p  2F8 5 --p  2E9 5 --p  2F9 5 --p }
6244: 0025 { 0E5 7 ---  0F5 7 ---  280 5 ---  290 5 --- }
6245: 0025 { 1C0 5 ---  1D0 5 ---  1C1 5 ---  1D1 5 --- }
6246: 0025 { 1C2 5 ---  1D2 5 ---  1C3 5 ---  1D3 5 --- }
6247: 0025 { 1C4 5 ---  1D4 5 ---  1C5 5 ---  1D5 5 --- }
6248: 0025 { 1C6 5 ---  1D6 5 ---  1C7 5 ---  1D7 5 --- }
6249: 0025 { 2D9 5 xy-  2C9 5 xy-  2D8 5 xy-  2C8 5 xy- }
624A: 0025 { 29B 4 ---  29B 4 ---  287 5 x--  297 5 x-- }
624B: 0025 { 286 5 x--  296 5 x--  0F5 5 ---  283 5 x-- }
624C: 0025 { 0F5 5 ---  29B 4 ---  0F5 5 ---  283 5 x-- }
624D: 0025 { 0F5 5 ---  282 5 x--  0F5 5 ---  281 5 x-- }
624E: 0025 { 281 5 ---  291 5 ---  282 5 ---  292 5 --- }
624F: 0025 { 283 5 ---  293 5 ---  29B 4 ---  29B 4 --- }
6250: 0025 { 2E8 5 ---  2F8 5 ---  2E9 5 ---  2F9 5 --- }
6251: 0025 { 2EA 5 ---  2FA 5 ---  2EB 5 ---  2FB 5 --- }
6252: 0130 { 2AA 4 ---  2BA 4 ---  2AB 4 ---  2BB 4 --- }
6253: 0025 { 2EA 5 --p  2FA 5 --p  2EB 5 --p  2FB 5 --p }
6254: 0025 { 280 5 x--  290 5 x--  0E5 7 ---  0F5 7 --- }
6255: 0025 { 1E0 5 ---  1F0 5 ---  1E1 5 ---  1F1 5 --- }
6256: 0025 { 1E2 5 ---  1F2 5 ---  1E3 5 ---  1F3 5 --- }
6257: 0025 { 1E4 5 ---  1F4 5 ---  1E5 5 ---  1F5 5 --- }
6258: 0025 { 1E6 5 ---  1F6 5 ---  1E7 5 ---  1F7 5 --- }
6259: 0025 { 2B9 5 xy-  2A9 5 xy-  2B8 5 xy-  2A8 5 xy- }
625A: 0025 { 29B 4 ---  29B 4 ---  297 5 x--  2A7 5 x-- }
625B: 0025 { 296 5 x--  2A6 5 x--  293 5 x--  2A3 5 x-- }
625C: 0025 { 29B 4 ---  29B 4 ---  293 5 x--  2A3 5 x-- }
625D: 0025 { 292 5 x--  2A2 5 x--  291 5 x--  2A1 5 x-- }
625E: 0025 { 291 5 ---  2A1 5 ---  292 5 ---  2A2 5 --- }
625F: 0025 { 293 5 ---  2A3 5 ---  29B 4 ---  29B 4 --- }
6260: 0025 { 288 5 ---  298 5 ---  289 5 ---  299 5 --- }
6261: 0025 { 28A 5 ---  29A 5 ---  28B 5 ---  29B 5 --- }
6262: 0025 { 2C4 5 ---  2D4 5 ---  2C5 5 ---  2D6 5 --- }
6263: 0025 { 2C5 5 x--  2D6 5 ---  2C4 5 x--  2D4 5 x-- }
6264: 0025 { 0F5 5 ---  0C6 7 x--  0F5 5 ---  0D4 7 x-- }
6265: 0025 { 1C3 5 x--  1D3 5 x--  1C2 5 x--  1D2 5 x-- }
6266: 0025 { 1C1 5 x--  1D1 5 x--  1C0 5 x--  1D0 5 x-- }
6267: 0025 { 284 5 ---  294 5 ---  285 5 ---  295 5 --- }
6268: 0025 { 29F 5 ---  2AF 5 ---  29F 5 x--  2AF 5 x-- }
6269: 0025 { 2D8 5 -y-  2C8 5 -y-  2D9 5 -y-  2C9 5 -y- }
626A: 0025 { 2A9 5 x--  2B9 5 x--  2A8 5 x--  2B8 5 x-- }
626B: 0025 { 2A8 5 ---  2B8 5 ---  2A9 5 ---  2B9 5 --- }
626C: 0025 { 2C2 5 ---  2D2 5 ---  2C3 5 ---  2D3 5 --- }
626D: 0025 { 28C 5 ---  29C 5 ---  28D 5 ---  29D 5 --- }
626E: 0025 { 2CC 5 ---  2DC 5 ---  2CD 5 ---  2DD 5 --- }
626F: 0025 { 2BE 5 x--  28E 5 x--  2BE 5 ---  28E 5 --- }
6270: 0025 { 28B 5 x--  29B 5 x--  28A 5 x--  29A 5 x-- }
6271: 0025 { 289 5 x--  299 5 x--  288 5 x--  298 5 x-- }
6272: 0025 { 2E4 5 ---  2F4 5 ---  2D6 5 ---  2D6 5 --- }
6273: 0025 { 2D6 5 ---  2D6 5 ---  2E4 5 x--  2F4 5 x-- }
6274: 0025 { 0D6 7 x--  0F7 4 ---  0D5 7 x--  0BB 4 --- }
6275: 0025 { 1E3 5 x--  1F3 5 x--  1E2 5 x--  1F2 5 x-- }
6276: 0025 { 1E1 5 x--  1F1 5 x--  1E0 5 x--  1F0 5 x-- }
6277: 0025 { 2A4 5 ---  2A4 5 ---  2A5 5 ---  2A5 5 --- }
6278: 0025 { 2BF 5 ---  0F5 5 ---  2BF 5 x--  0F5 5 --- }
6279: 0025 { 2B8 5 -y-  2A8 5 -y-  2B9 5 -y-  2A9 5 -y- }
627A: 0025 { 2C9 5 x--  2D9 5 x--  2C8 5 x--  2D8 5 x-- }
627B: 0025 { 2C8 5 ---  2D8 5 ---  2C9 5 ---  2D9 5 --- }
627C: 0025 { 2C0 5 ---  2D0 5 ---  2C1 5 ---  2D1 5 --- }
627D: 0025 { 2AC 5 ---  2BC 5 ---  2AD 5 ---  2BD 5 --- }
627E: 0025 { 2EE 5 ---  2FE 5 ---  2EF 5 ---  2FF 5 --- }
627F: 0025 { 29E 5 x--  28F 5 ---  29E 5 ---  28F 5 x-- }
6280: 0025 { 288 5 --p  298 5 --p  289 5 --p  299 5 --p }
6281: 0025 { 28A 5 --p  29A 5 --p  28B 5 --p  29B 5 --p }
6282: 0025 { 2C4 5 ---  2D4 5 ---  2C5 5 ---  2D6 5 --- }
6283: 0025 { 2C5 5 x--  2D6 5 ---  2C4 5 x--  2D4 5 x-- }
6284: 01AA { 160 5 ---  170 5 ---  161 5 ---  171 5 --- }
6285: 0025 { 0A4 5 ---  0B4 5 ---  0A5 5 ---  0B5 5 --- }
6286: 0025 { 0A5 5 x--  0B5 5 x--  0A4 5 x--  0B4 5 x-- }
6287: 0025 { 1C8 5 ---  1D8 5 ---  1C9 5 ---  1D9 5 --- }
6288: 0025 { 1C9 5 x--  1D9 5 x--  1C8 5 x--  1D8 5 x-- }
6289: 0025 { 29B 4 ---  29B 4 ---  0A5 5 x--  0B5 5 x-- }
628A: 0025 { 0A4 5 x--  0B4 5 x--  1C1 5 ---  1D1 5 --- }
628B: 0025 { 1C1 5 x--  1D1 5 x--  1C8 5 ---  1D8 5 --- }
628C: 0025 { 1C9 5 ---  1D9 5 ---  29B 4 ---  29B 4 --- }
628D: 0025 { 29B 4 ---  29B 4 ---  0A5 5 x--  0B5 5 x-- }
628E: 0025 { 0A4 5 x--  0B4 5 x--  29B 4 ---  29B 4 --- }
628F: 0025 { 221 5 x--  231 5 x--  220 5 x--  230 5 x-- }
6290: 0025 { 28B 5 x-p  29B 5 x-p  28A 5 x-p  29A 5 x-p }
6291: 0025 { 289 5 x-p  299 5 x-p  288 5 x-p  298 5 x-p }
6292: 0025 { 2E4 5 ---  2F4 5 ---  2D6 5 ---  2D6 5 --- }
6293: 0025 { 2D6 5 ---  2D6 5 ---  2E4 5 x--  2F4 5 x-- }
6294: 01E2 { 144 5 ---  154 5 ---  145 5 ---  155 5 --- }
6295: 0130 { 164 5 ---  174 5 ---  165 5 ---  175 5 --- }
6296: 0130 { 166 5 ---  176 5 ---  167 5 ---  177 5 --- }
6297: 0130 { 166 5 ---  176 5 ---  167 5 ---  177 5 --- }
6298: 0130 { 168 5 ---  178 5 ---  169 5 ---  179 5 --- }
6299: 0025 { 164 5 ---  174 5 ---  165 5 ---  175 5 --- }
629A: 0025 { 165 5 x--  175 5 x--  164 5 x--  174 5 x-- }
629B: 0106 { 227 7 ---  0F8 5 ---  227 7 ---  0F8 5 --- }
629C: 0025 { 221 5 ---  202 5 x--  2C0 5 ---  2D0 5 --- }
629D: 0025 { 0F8 5 ---  0A6 3 ---  0F8 5 ---  0A7 3 --- }
629E: 0025 { 0F8 5 ---  0A7 3 x--  0F8 5 ---  0A6 3 x-- }
629F: 0025 { 241 5 x--  0F8 5 ---  240 5 x--  0F8 5 --- }
62A0: 01AA { 160 5 ---  170 5 ---  161 5 ---  171 5 --- }
62A1: 0025 { 086 7 ---  096 7 ---  087 7 ---  097 7 --- }
62A2: 0020 { 2C4 5 ---  2D4 5 ---  2C5 5 ---  2D6 5 --- }
62A3: 0020 { 2C5 5 x--  2D6 5 ---  2C4 5 x--  2D4 5 x-- }
62A4: 0025 { 1CC 0 ---  1DC 0 ---  1CD 0 ---  1DD 0 --- }
62A5: ~
62A6: ~
62A7: 0025 { 10C 5 ---  11C 5 ---  10E 5 ---  10E 5 --- }
62A8: 01AA { 10E 5 ---  11E 5 ---  10F 5 ---  11F 5 --- }
62A9: 01AF { 10F 5 x--  11F 5 x--  10E 5 x--  11E 5 x-- }
62AA: 0025 { 10E 5 x--  10E 5 x--  10C 5 x--  11C 5 x-- }
62AB: 0025 { 270 7 --p  0F8 7 --p  271 7 --p  0F8 7 --p }
62AC: 0025 { 272 7 --p  274 7 --p  273 7 --p  275 7 --p }
62AD: 0025 { 0C6 3 ---  0D6 3 ---  0C7 3 ---  0D7 3 --- }
62AE: 0025 { 0C7 3 x--  0D7 3 x--  0C6 3 x--  0D6 3 x-- }
62AF: 0025 { 0F8 5 ---  23A 5 -y-  0F8 5 ---  23A 5 -y- }
62B0: 01E2 { 144 5 ---  154 5 ---  145 5 ---  155 5 --- }
62B1: 0025 { 082 7 ---  092 7 ---  083 7 ---  093 7 --- }
62B2: 0020 { 2E4 5 ---  2F4 5 ---  2D6 5 ---  2D6 5 --- }
62B3: 0020 { 2D6 5 ---  2D6 5 ---  2E4 5 x--  2F4 5 x-- }
62B4: 0025 { 10C 5 x--  11C 5 x--  10D 5 x--  11D 5 x-- }
62B5: 0025 { 10D 5 ---  11D 5 ---  10C 5 ---  11C 5 --- }
62B6: 0130 { 108 5 ---  118 5 ---  109 5 ---  119 5 --- }
62B7: 01AA { 12C 5 ---  13C 5 ---  12D 5 ---  13D 5 --- }
62B8: 01E2 { 12E 5 ---  13E 5 ---  12F 5 ---  13F 5 --- }
62B9: 01E4 { 12F 5 x--  13F 5 x--  12E 5 x--  13E 5 x-- }
62BA: 01AF { 12D 5 x--  13D 5 x--  12C 5 x--  13C 5 x-- }
62BB: 0025 { 105 5 x--  115 5 x--  104 5 x--  114 5 x-- }
62BC: 0130 { 004 4 x--  004 4 x--  004 4 x--  004 4 x-- }
62BD: 0025 { 0F8 5 ---  0F8 5 ---  20D 3 ---  21D 3 --- }
62BE: 0025 { 20E 3 ---  21E 3 ---  20F 3 ---  21F 3 --- }
62BF: 0025 { 22A 5 -y-  0F8 5 ---  22A 5 -y-  0F8 5 --- }
62C0: 0025 { 0A0 7 ---  0B0 7 ---  0A1 7 ---  0B1 7 --- }
62C1: 0025 { 0A2 7 ---  0B2 7 ---  0A3 7 ---  0B3 7 --- }
62C2: 0025 { 0A4 6 ---  0B4 6 ---  0A5 6 ---  0B5 6 --- }
62C3: 0025 { 100 5 ---  110 5 ---  101 5 ---  111 5 --- }
62C4: 0025 { 102 5 ---  112 5 ---  103 5 ---  113 5 --- }
62C5: 0025 { 104 5 ---  114 5 ---  105 5 ---  115 5 --- }
62C6: 01AA { 106 5 ---  116 5 ---  107 5 ---  117 5 --- }
62C7: 01E2 { 14C 5 ---  15C 5 ---  14D 5 ---  15D 5 --- }
62C8: 0130 { 14E 5 ---  15E 5 ---  14F 5 ---  15F 5 --- }
62C9: 0130 { 14F 5 x--  15F 5 x--  14E 5 x--  15E 5 x-- }
62CA: 01E4 { 14D 5 x--  15D 5 x--  14C 5 x--  15C 5 x-- }
62CB: 01AF { 107 5 x--  117 5 x--  106 5 x--  116 5 x-- }
62CC: 0025 { 105 5 x--  115 5 x--  104 5 x--  114 5 x-- }
62CD: 0025 { 22C 3 ---  23C 3 ---  22D 3 ---  23D 3 --- }
62CE: 0025 { 22E 3 ---  23E 3 ---  22F 3 ---  23F 3 --- }
62CF: 0025 { 24C 5 ---  25C 5 ---  24D 5 ---  25D 5 --- }
62D0: 0025 { 0C0 7 ---  0D0 7 ---  0C1 7 ---  0D1 7 --- }
62D1: 0025 { 0C2 6 ---  0D2 6 ---  0C3 6 ---  0D3 6 --- }
62D2: 0025 { 0C4 7 ---  0D4 7 ---  0C5 7 ---  0D5 7 --- }
62D3: 0025 { 120 5 ---  130 5 ---  121 5 ---  131 5 --- }
62D4: 0025 { 122 5 ---  132 5 ---  123 5 ---  133 5 --- }
62D5: 01AA { 124 5 ---  134 5 ---  125 5 ---  135 5 --- }
62D6: 01E2 { 126 5 ---  136 5 ---  127 5 ---  137 5 --- }
62D7: 0130 { 16C 5 ---  17C 5 ---  16D 5 ---  17D 5 --- }
62D8: 0130 { 16E 5 ---  17E 5 ---  16F 5 ---  17F 5 --- }
62D9: 0130 { 16F 5 x--  17F 5 x--  16E 5 x--  17E 5 x-- }
62DA: 0130 { 16D 5 x--  17D 5 x--  16C 5 x--  17C 5 x-- }
62DB: 01E4 { 127 5 x--  137 5 x--  126 5 x--  136 5 x-- }
62DC: 01AF { 125 5 x--  135 5 x--  124 5 x--  134 5 x-- }
62DD: 0025 { 10E 5 x--  115 5 x--  10C 5 x--  114 5 x-- }
62DE: 0025 { 25E 5 ---  26E 5 ---  25F 5 ---  26F 5 --- }
62DF: 0025 { 26C 5 ---  27C 5 ---  26D 5 ---  27D 5 --- }
62E0: 0130 { 200 6 ---  210 6 ---  201 6 ---  211 6 --- }
62E1: 0025 { 0F8 6 --p  2E8 6 ---  0F8 5 ---  2E8 6 x-- }
62E2: 0025 { 084 7 ---  094 7 ---  085 7 ---  095 7 --- }
62E3: 0025 { 140 5 ---  150 5 ---  141 5 ---  151 5 --- }
62E4: 01AA { 142 5 ---  152 5 ---  143 5 ---  153 5 --- }
62E5: 01E2 { 144 5 ---  154 5 ---  145 5 ---  155 5 --- }
62E6: 0130 { 146 5 ---  156 5 ---  147 5 ---  157 5 --- }
62E7: 0130 { 166 5 ---  176 5 ---  167 5 ---  177 5 --- }
62E8: 0130 { 148 5 ---  158 5 ---  149 5 ---  159 5 --- }
62E9: 0130 { 149 5 x--  159 5 x--  148 5 x--  158 5 x-- }
62EA: ~
62EB: 0130 { 147 5 x--  157 5 x--  146 5 x--  156 5 x-- }
62EC: 01E4 { 145 5 x--  155 5 x--  144 5 x--  154 5 x-- }
62ED: 01AF { 125 5 x--  135 5 x--  124 5 x--  134 5 x-- }
62EE: 0025 { 27E 5 ---  0F8 5 ---  27F 5 ---  0F8 5 --- }
62EF: 0025 { 24A 5 ---  25A 5 ---  24B 5 ---  25B 5 --- }
62F0: 0025 { 2C8 7 ---  2D8 7 ---  2C9 7 ---  2D9 7 --- }
62F1: 0025 { 2CA 6 ---  2DA 6 ---  2CB 6 ---  2DB 6 --- }
62F2: 0025 { 2CC 7 ---  2DC 7 ---  2CD 7 ---  2DD 7 --- }
62F3: 0130 { 160 5 ---  170 5 ---  161 5 ---  171 5 --- }
62F4: 01E2 { 162 5 ---  172 5 ---  163 5 ---  173 5 --- }
62F5: 0130 { 164 5 ---  174 5 ---  165 5 ---  175 5 --- }
62F6: 0130 { 030 4 ---  032 4 ---  031 4 ---  033 4 --- }
62F7: 0130 { 0F8 5 ---  0F8 5 ---  0F8 5 ---  0F8 5 --- }
62F8: ~
62F9: ~
62FA: ~
62FB: 0130 { 167 5 x--  177 5 x--  166 5 x--  176 5 x-- }
62FC: 0130 { 165 5 x--  175 5 x--  164 5 x--  174 5 x-- }
62FD: 01E4 { 145 5 x--  155 5 x--  144 5 x--  154 5 x-- }
62FE: 0025 { 27C 5 ---  0F8 5 ---  27D 5 ---  0F8 5 --- }
62FF: 0025 { 25C 5 ---  26C 5 ---  25D 5 ---  26D 5 --- }
