4100: 0130 { 0D3 7 ---  0D3 7 ---  0D3 7 x--  0D3 7 x-- }
4101: 0130 { 0C2 0 ---  1DC 0 ---  0C3 0 ---  1DC 0 --- }
4102: 0130 { 1DC 0 ---  1DC 0 ---  1DC 0 ---  1DC 0 --- }
4103: 0130 { 0C2 4 ---  1DC 4 ---  0C3 4 ---  1DC 4 --- }
4104: 0130 { 1DC 4 ---  1DC 4 ---  1DC 4 ---  1DC 4 --- }
4105: 0130 { 0C0 0 ---  0D0 0 ---  0C1 0 ---  0D1 0 --- }
4106: 0130 { 0C2 4 ---  1DC 4 ---  0C3 4 ---  1DC 4 --- }
4107: 0130 { 0C2 4 ---  1DC 4 ---  0C3 4 ---  1DC 4 --- }
4108: 0130 { 0F8 3 ---  0F8 3 ---  0F8 3 ---  0F8 3 --- }
4109: 0130 { 0F8 3 ---  0F8 3 ---  1ED 2 ---  1ED 2 --- }
410A: 0130 { 1FD 2 ---  1FD 2 ---  0F8 3 ---  0F8 3 --- }
410B: 0130 { 0F8 3 ---  0F8 3 ---  1A2 0 ---  1B2 0 --- }
410C: 0130 { 1A3 0 ---  1B3 0 ---  0F8 3 ---  0F8 3 --- }
410D: 0130 { 1A0 2 ---  1B0 2 ---  1A1 2 ---  1B1 2 --- }
410E: 0130 { 1E7 2 ---  1F7 2 ---  1E8 2 ---  1F8 2 --- }
410F: 0130 { 1E9 2 ---  1F9 2 ---  1EA 2 ---  1FA 2 --- }
4110: 0130 { 0F8 3 ---  0F8 3 ---  0F8 3 ---  2D1 0 --- }
4111: 0130 { 2C2 0 ---  2D2 0 ---  2C3 0 ---  2D3 0 --- }
4112: 0130 { 2C4 0 ---  2D4 0 ---  2C5 0 ---  2D5 0 --- }
4113: 0130 { 0F8 3 ---  2D6 0 ---  0F8 3 ---  0F8 3 --- }
4114: 0130 { 2C0 5 ---  2D0 5 ---  2ED 5 ---  2FD 5 --- }
4115: 0130 { 2EE 5 ---  2FE 5 ---  2EF 5 ---  2FF 5 --- }
4116: 0130 { 2C0 5 ---  2D0 5 ---  2EF 5 ---  2FF 5 --- }
4117: 0130 { 18E 2 x--  19E 2 x--  19B 2 x--  19D 2 x-- }
4118: 0130 { 0F8 2 ---  19C 2 x--  0F8 2 ---  19B 2 x-- }
4119: 0130 { 0F8 2 ---  196 2 ---  187 2 ---  197 2 --- }
411A: 0130 { 187 2 x--  197 2 x--  0F8 2 ---  196 2 x-- }
411B: 0130 { 1A2 0 ---  1B2 0 ---  1A3 0 ---  1B3 0 --- }
411C: 0130 { 1E0 3 ---  1F0 3 ---  1E1 3 ---  1F1 3 --- }
411D: 0130 { 1E2 3 ---  1F2 3 ---  1E3 3 ---  1F3 3 --- }
411E: 0130 { 0F8 4 ---  0F8 4 ---  1EB 2 ---  1FB 2 --- }
411F: 0130 { 1EC 2 ---  1FC 2 ---  0F8 4 ---  0F8 4 --- }
4120: 0130 { 2E0 0 ---  2F2 0 ---  2E1 0 ---  2F3 0 --- }
4121: 0130 { 2E1 0 ---  2F3 0 ---  2E2 0 ---  2F2 0 --- }
4122: 0130 { 2E2 0 ---  2F2 0 ---  2E3 0 ---  2F3 0 --- }
4123: 0130 { 2E6 0 ---  2F2 0 ---  2E7 0 ---  2F3 0 --- }
4124: 0130 { 2F8 0 ---  2F2 0 ---  2F9 0 ---  2F3 0 --- }
4125: 0130 { 2FA 0 ---  2F2 0 ---  2FB 0 ---  2FC 0 --- }
4126: 0130 { 0F8 3 ---  2C4 0 ---  0F8 3 ---  2C5 0 --- }
4127: 0130 { 194 2 ---  192 2 ---  195 2 ---  193 2 --- }
4128: 0130 { 195 2 ---  192 2 ---  1A6 2 x--  193 2 --- }
4129: 0130 { 0C2 4 ---  1DC 4 ---  0C3 4 ---  1DC 4 --- }
412A: 0130 { 0C2 4 ---  1DC 4 ---  0C3 4 ---  1DC 4 --- }
412B: 0130 { 1ED 2 ---  1ED 2 ---  1FD 2 ---  1FD 2 --- }
412C: 0130 { 0F8 3 ---  0F8 3 ---  1E4 3 ---  1E4 3 --- }
412D: 0130 { 1F4 3 ---  1F4 3 ---  0F8 3 ---  0F8 3 --- }
412E: 0130 { 0F8 4 ---  0F8 4 ---  1FB 2 ---  1FB 2 --- }
412F: 0130 { 1FC 2 ---  1FC 2 ---  0F8 4 ---  0F8 4 --- }
4130: 0130 { 0F8 3 ---  0F8 3 ---  1CD 3 ---  1DD 3 --- }
4131: 0130 { 1CE 3 ---  1DE 3 ---  188 3 ---  198 3 --- }
4132: 0130 { 189 3 ---  199 3 ---  0F8 3 ---  0F8 3 --- }
4133: 0130 { 284 1 x--  294 1 x--  283 1 x--  293 1 x-- }
4134: 0130 { 2A7 1 x--  2B7 1 x--  2A6 1 x--  2B6 1 x-- }
4135: 0130 { 2E3 0 ---  2F3 0 ---  2E2 0 ---  2F2 0 --- }
4136: 0130 { 2E2 0 ---  2F2 0 ---  2D5 0 ---  2F3 0 --- }
4137: 0130 { 2D6 0 ---  2F7 0 ---  0F8 3 ---  2E7 0 --- }
4138: 0130 { 0F8 3 ---  2F8 0 ---  0F8 3 ---  2C5 0 --- }
4139: 0130 { 1CF 2 ---  194 2 ---  194 2 ---  1DF 2 --- }
413A: 0130 { 182 2 ---  1E5 2 ---  183 2 ---  1E6 2 --- }
413B: 0130 { 1E5 2 ---  1F5 2 ---  1E6 2 ---  1F6 2 --- }
413C: 0130 { 1E6 2 x--  1F6 2 x--  1E5 2 x--  1F5 2 x-- }
413D: 0130 { 180 2 ---  190 2 ---  183 2 ---  193 2 --- }
413E: 0130 { 182 2 ---  192 2 ---  183 2 ---  193 2 --- }
413F: 0130 { 182 2 ---  192 2 ---  180 2 x--  190 2 x-- }
4140: 0130 { 13F 6 ---  14F 6 ---  14B 6 ---  16D 6 --- }
4141: 0130 { 110 7 ---  120 7 ---  111 7 ---  121 7 --- }
4142: 0130 { 112 7 ---  122 7 ---  112 7 ---  146 7 --- }
4143: 0130 { 114 7 ---  146 7 ---  114 7 x--  146 7 --- }
4144: 0130 { 116 7 ---  146 7 ---  117 7 ---  127 7 --- }
4145: 0130 { 118 7 ---  128 7 ---  119 7 ---  129 7 --- }
4146: 0130 { 1C3 2 ---  1D3 2 ---  1C4 2 ---  1D4 2 --- }
4147: 0130 { 1C5 2 ---  1D5 2 ---  1C8 2 ---  1D8 2 --- }
4148: 0130 { 0F8 3 -y-  109 7 -y-  109 7 -y-  108 7 -y- }
4149: 0130 { 192 2 ---  193 2 ---  285 2 ---  195 2 --- }
414A: 0130 { 1CF 2 ---  193 2 ---  194 2 ---  195 2 --- }
414B: 0130 { 1C5 2 ---  1D5 2 ---  1C6 2 ---  1D6 2 --- }
414C: 0130 { 1C7 2 ---  1D7 2 ---  1C8 2 ---  1D8 2 --- }
414D: 0130 { 184 2 ---  190 2 ---  195 2 ---  193 2 --- }
414E: 0130 { 192 2 ---  193 2 ---  194 2 ---  195 2 --- }
414F: 0130 { 194 2 ---  192 2 ---  184 2 x--  190 2 x-- }
4150: 0130 { 0F8 4 ---  0F8 4 ---  0F8 4 ---  113 7 --- }
4151: 0130 { 130 7 ---  140 7 ---  131 7 ---  146 7 --- }
4152: 0130 { 132 7 ---  146 7 ---  146 7 ---  0D2 7 --- }
4153: 0130 { 146 7 ---  146 7 ---  146 7 ---  146 7 --- }
4154: 0130 { 146 7 ---  146 7 ---  137 7 ---  147 7 --- }
4155: 0130 { 138 7 ---  148 7 ---  139 7 ---  149 7 --- }
4156: 0130 { 0F8 4 ---  14A 7 ---  0F8 4 ---  0F8 4 --- }
4157: 0130 { 13C 7 ---  14C 7 ---  13D 7 ---  14D 7 --- }
4158: 0130 { 13E 7 ---  14E 7 ---  0F8 4 ---  0F8 4 --- }
4159: 0130 { 192 2 ---  285 2 ---  194 2 ---  195 2 --- }
415A: 0130 { 192 2 ---  193 2 ---  194 2 ---  1DF 2 --- }
415B: 0130 { 1C7 2 x--  1D7 2 x--  1C6 2 x--  1D6 2 x-- }
415C: 0130 { 1C6 2 ---  1D6 2 ---  1C7 2 ---  1D7 2 --- }
415D: 0130 { 190 2 -y-  180 2 -y-  193 2 -y-  183 2 -y- }
415E: 0130 { 192 2 -y-  182 2 -y-  193 2 -y-  183 2 -y- }
415F: 0130 { 192 2 -y-  182 2 -y-  190 2 xy-  180 2 xy- }
4160: 0130 { 09C 4 ---  0CB 4 ---  09D 4 ---  0CC 4 --- }
4161: 0130 { 0BE 4 ---  0CD 4 ---  0BF 4 ---  0B6 4 --- }
4162: 0130 { 0DE 4 ---  0B7 4 ---  0DF 4 ---  0BA 4 --- }
4163: 0130 { 08F 4 ---  0BB 4 ---  02B 4 x--  02A 4 x-- }
4164: 0130 { 02B 4 ---  02A 4 ---  0D8 4 ---  0EE 4 --- }
4165: 0130 { 0D9 4 ---  0EF 4 ---  0F0 4 ---  2A0 4 --- }
4166: 0130 { 0D4 4 ---  2A1 4 ---  0D5 4 ---  2A2 4 --- }
4167: 0130 { 0D6 4 ---  2A3 4 ---  0D7 4 ---  2A4 4 --- }
4168: 0130 { 171 7 ---  108 7 ---  171 7 ---  0F8 7 --- }
4169: 0130 { 109 7 ---  0F8 3 ---  108 7 ---  109 7 --- }
416A: 0130 { 182 2 ---  285 2 ---  183 2 ---  193 2 --- }
416B: 0130 { 182 2 ---  192 2 ---  183 2 ---  1CF 2 --- }
416C: 0130 { 087 7 x--  097 7 x--  086 7 x--  096 7 x-- }
416D: 0130 { 085 7 x--  095 7 x--  084 7 x--  094 7 x-- }
416E: 0130 { 083 7 x--  093 7 x--  082 7 x--  092 7 x-- }
416F: 0130 { 0F8 7 x--  0B5 7 x--  0F8 7 x--  0F8 7 x-- }
4170: 0130 { 1FC 2 ---  1FC 2 ---  0F2 6 x--  168 6 x-- }
4171: 0130 { 0F1 6 x--  167 6 x--  0F8 3 ---  0F8 3 --- }
4172: 0130 { 2C5 0 ---  2D5 0 ---  0F8 3 ---  2D6 0 --- }
4173: 0130 { 119 7 x--  129 7 x--  118 7 x--  128 7 x-- }
4174: 0130 { 117 7 x--  127 7 x--  116 7 x--  146 7 x-- }
4175: 0130 { 114 7 ---  146 7 x--  114 7 x--  146 7 x-- }
4176: 0130 { 112 7 x--  146 7 x--  112 7 x--  122 7 x-- }
4177: 0130 { 111 7 x--  121 7 x--  110 7 x--  120 7 x-- }
4178: 0130 { 182 2 ---  192 2 ---  1C5 2 ---  1D5 2 --- }
4179: 0130 { 1C8 2 ---  1D8 2 ---  183 2 ---  193 2 --- }
417A: 0130 { 174 6 ---  178 6 ---  177 6 ---  17B 6 --- }
417B: 0130 { 178 6 ---  17C 6 ---  17B 6 ---  15F 6 --- }
417C: 0130 { 0C2 0 ---  1DC 0 ---  0F4 0 x--  1DC 0 --- }
417D: 0130 { 0E4 0 ---  1DC 0 ---  0E5 0 ---  1DC 0 --- }
417E: 0130 { 0E4 0 ---  1DC 0 ---  0F3 0 x--  1DC 0 --- }
417F: 0130 { 0A7 7 x--  093 7 x--  0A6 7 x--  092 7 x-- }
4180: 0130 { 0F8 4 x--  0F8 4 x--  13E 7 x--  14E 7 x-- }
4181: 0130 { 13D 7 x--  14D 7 x--  13C 7 x--  14C 7 x-- }
4182: 0130 { 0F8 4 x--  0F8 4 x--  0F8 4 x--  14A 7 x-- }
4183: 0130 { 139 7 x--  149 7 x--  138 7 x--  148 7 x-- }
4184: 0130 { 137 7 x--  147 7 x--  146 7 x--  146 7 x-- }
4185: 0130 { 146 7 x--  146 7 x--  146 7 x--  146 7 x-- }
4186: 0130 { 146 7 x--  0D2 7 x--  132 7 x--  146 7 x-- }
4187: 0130 { 131 7 x--  146 7 x--  130 7 x--  140 7 x-- }
4188: 0130 { 0F8 4 x--  113 7 x--  0F8 4 x--  0F8 4 x-- }
4189: 0130 { 0F8 3 ---  2D1 0 ---  0F8 3 ---  2C5 0 --- }
418A: 0130 { 17C 6 ---  12C 6 ---  15F 6 ---  12F 6 --- }
418B: 0130 { 174 6 ---  12C 6 ---  177 6 ---  12F 6 --- }
418C: 0130 { 0F8 7 ---  0F8 7 ---  0F8 7 ---  0B5 7 --- }
418D: 0130 { 082 7 ---  092 7 ---  083 7 ---  093 7 --- }
418E: 0130 { 084 7 ---  094 7 ---  085 7 ---  095 7 --- }
418F: 0130 { 086 7 ---  096 7 ---  087 7 ---  097 7 --- }
4190: 0130 { 13E 7 ---  14E 7 ---  13E 7 x--  14E 7 x-- }
4191: 0130 { 01E 4 ---  02A 4 ---  01F 4 ---  089 4 --- }
4192: 0130 { 01F 4 x--  08A 4 ---  01F 4 ---  08B 4 --- }
4193: 0130 { 01F 4 x--  08C 4 ---  01F 4 ---  08D 4 --- }
4194: 0130 { 01F 4 x--  0AE 4 ---  01F 4 ---  0AF 4 --- }
4195: 0130 { 01F 4 x--  0CE 4 ---  01F 4 ---  0CF 4 --- }
4196: 0130 { 01F 4 x--  08E 4 ---  01E 4 x--  02A 4 x-- }
4197: 0130 { 02B 4 ---  02A 4 ---  099 4 ---  0C8 4 --- }
4198: 0130 { 09A 4 ---  0C9 4 ---  09B 4 ---  0CA 4 --- }
4199: 0130 { 171 7 ---  108 7 x--  171 7 ---  107 7 x-- }
419A: 0130 { 0F8 2 ---  196 2 ---  187 2 ---  197 2 --- }
419B: 0130 { 0C2 4 ---  1DC 4 ---  0C3 4 ---  1DC 4 --- }
419C: 0130 { 0A6 7 ---  092 7 ---  0A7 7 ---  093 7 --- }
419D: 0130 { 0F3 0 ---  1DC 0 ---  0E5 0 ---  1DC 0 --- }
419E: 0130 { 0E4 0 ---  1DC 0 ---  0E5 0 ---  1DC 0 --- }
419F: 0130 { 0F4 0 ---  1DC 0 ---  0C3 0 ---  1DC 0 --- }
41A0: 0130 { 0F8 4 ---  1B4 2 ---  0F8 4 ---  1B5 2 --- }
41A1: 0130 { 0F8 4 ---  1B6 2 ---  0F8 4 ---  1B7 2 --- }
41A2: 0130 { 1B4 2 ---  1B8 2 ---  1B5 2 ---  1B9 2 --- }
41A3: 0130 { 1A4 2 ---  1BA 2 ---  1A5 2 ---  193 2 --- }
41A4: 0130 { 1A5 2 x--  192 2 ---  1A4 2 x--  194 2 --- }
41A5: 0130 { 1B5 2 x--  1B9 2 x--  1B4 2 x--  1B8 2 x-- }
41A6: 0130 { 0F8 4 ---  1B7 2 x--  0F8 4 ---  1B6 2 x-- }
41A7: 0130 { 0F8 4 ---  1B5 2 x--  0F8 4 ---  1B4 2 x-- }
41A8: 0130 { 187 2 x--  197 2 x--  0F8 2 ---  196 2 x-- }
41A9: 0130 { 109 7 x--  0F8 7 x--  0F8 7 x--  0F8 7 x-- }
41AA: 0130 { 1A6 2 ---  192 2 ---  195 2 ---  193 2 --- }
41AB: 0130 { 0C2 4 ---  1DC 4 ---  0C3 4 ---  1DC 4 --- }
41AC: 0130 { 112 7 ---  146 7 ---  112 7 ---  146 7 --- }
41AD: 0130 { 02B 4 ---  02A 4 ---  00A 4 ---  2CE 4 --- }
41AE: 0130 { 00B 4 ---  2CF 4 ---  2B0 4 ---  2E4 4 --- }
41AF: 0130 { 2B1 4 ---  2E5 4 ---  2B2 4 ---  2F0 4 --- }
41B0: 0130 { 1A9 2 ---  192 2 ---  1A7 2 ---  193 2 --- }
41B1: 0130 { 1A8 2 ---  192 2 ---  195 2 ---  193 2 --- }
41B2: 0130 { 1A8 2 ---  192 2 ---  195 2 ---  193 2 --- }
41B3: 0130 { 192 2 ---  193 2 ---  194 2 ---  195 2 --- }
41B4: 0130 { 192 2 ---  193 2 ---  194 2 ---  195 2 --- }
41B5: 0130 { 192 2 ---  193 2 ---  194 2 ---  195 2 --- }
41B6: 0130 { 192 2 ---  192 2 ---  194 2 ---  194 2 --- }
41B7: 0130 { 1A7 2 x--  192 2 ---  1A9 2 x--  194 2 --- }
41B8: 0130 { 192 2 ---  193 2 ---  1A6 2 x--  195 2 --- }
41B9: 0130 { 0F8 4 ---  0F8 4 ---  0F8 4 ---  0F8 4 --- }
41BA: 0130 { 0F8 3 ---  0F8 3 ---  0F8 3 ---  0F8 3 --- }
41BB: 0130 { 170 7 ---  0F8 7 ---  171 7 ---  107 7 --- }
41BC: 0130 { 0C2 0 ---  1DC 1 ---  0C3 4 ---  1DC 4 --- }
41BD: 0130 { 1DC 1 ---  1DC 1 ---  1DC 4 ---  1DC 4 --- }
41BE: 0130 { 0C2 4 ---  1DC 4 ---  0C3 0 ---  1DC 1 --- }
41BF: 0130 { 1DC 4 x--  1DC 4 x--  1DC 1 x--  1DC 1 x-- }
41C0: 0130 { 0E0 0 ---  1DC 0 ---  0E1 0 ---  1DC 0 --- }
41C1: 0130 { 0E2 0 ---  18B 0 ---  0E3 0 ---  18C 0 --- }
41C2: 0130 { 0E4 0 ---  18D 0 ---  0E5 0 ---  18D 0 --- }
41C3: 0130 { 0E6 0 ---  18D 0 ---  0E7 0 ---  18F 0 --- }
41C4: 0130 { 0E8 0 ---  1AA 0 ---  0E9 0 ---  1DC 0 --- }
41C5: 0130 { 0F8 3 ---  2D6 0 x--  2C5 0 x--  2D5 0 x-- }
41C6: 0130 { 0F8 3 ---  2C2 0 ---  0F8 3 ---  2C3 0 --- }
41C7: 0130 { 0F8 3 ---  2C4 0 ---  0F8 3 ---  2C5 0 --- }
41C8: 0130 { 0F8 3 ---  2C4 0 ---  0F8 3 ---  2C5 0 --- }
41C9: 0130 { 0F8 2 ---  0F8 2 ---  141 2 ---  115 2 --- }
41CA: 0130 { 142 2 ---  144 2 ---  0F1 6 ---  167 6 --- }
41CB: 0130 { 0F2 6 ---  168 6 ---  1FB 2 ---  1FB 2 --- }
41CC: 0130 { 171 7 ---  173 7 ---  171 7 ---  0F8 2 --- }
41CD: 0130 { 171 7 ---  0F8 2 ---  171 7 ---  173 7 --- }
41CE: 0130 { 171 7 ---  173 7 ---  172 7 ---  0F8 7 --- }
41CF: 0130 { 170 7 ---  0F8 7 ---  171 7 ---  173 7 --- }
41D0: 0130 { 0B0 0 ---  1DC 0 x--  0B1 0 ---  1AA 0 x-- }
41D1: 0130 { 0B2 0 ---  18F 0 x--  0B3 0 ---  18D 0 x-- }
41D2: 0130 { 0C4 0 ---  18C 0 x--  0C5 0 ---  18B 0 x-- }
41D3: 0130 { 0C6 0 ---  1DC 0 x--  0C7 0 ---  1DC 0 x-- }
41D4: 0130 { 0F8 3 ---  0F8 3 ---  0F8 3 ---  2C2 0 --- }
41D5: 0130 { 0F8 3 ---  2E0 0 ---  2D1 0 ---  2E1 0 --- }
41D6: 0130 { 2D2 0 ---  2E2 0 ---  2D3 0 ---  2E3 0 --- }
41D7: 0130 { 2D4 0 ---  2E2 0 ---  2D5 0 ---  2E3 0 --- }
41D8: 0130 { 2C5 0 ---  2D5 0 ---  0F8 3 ---  2D6 0 --- }
41D9: 0130 { 10A 6 ---  11A 6 ---  10B 6 ---  11B 6 --- }
41DA: 0130 { 10C 6 ---  11C 6 ---  10D 6 ---  11D 6 --- }
41DB: 0130 { 10E 6 ---  11E 6 ---  10F 6 ---  11F 6 --- }
41DC: 0130 { 170 7 ---  105 7 ---  172 7 ---  106 7 --- }
41DD: 0130 { 105 7 ---  105 7 ---  106 7 ---  106 7 --- }
41DE: 0130 { 173 7 ---  173 7 ---  0F8 7 ---  0F8 7 --- }
41DF: 0130 { 0F8 7 ---  0F8 7 ---  173 7 ---  173 7 --- }
41E0: 0130 { 1CD 3 ---  1DD 3 ---  1CE 3 ---  1DE 3 --- }
41E1: 0130 { 1EE 3 ---  1FE 3 ---  1EF 3 ---  1FF 3 --- }
41E2: 0130 { 188 3 ---  198 3 ---  189 3 ---  199 3 --- }
41E3: 0130 { 09E 5 ---  09E 5 ---  09F 5 ---  09F 5 --- }
41E4: 0130 { 0F5 4 ---  2A5 4 ---  0F6 4 ---  2CC 4 --- }
41E5: 0130 { 0F7 4 ---  2CD 4 ---  02B 4 x--  02A 4 x-- }
41E6: 0130 { 0F8 3 ---  2C0 5 ---  0F8 3 ---  2ED 5 --- }
41E7: 0130 { 0F8 3 ---  2EE 5 ---  0F8 3 ---  2EF 5 --- }
41E8: 0130 { 0F8 3 ---  2C0 5 ---  0F8 3 ---  2EF 5 --- }
41E9: 0130 { 12A 6 ---  13A 6 ---  12B 6 ---  13B 6 --- }
41EA: 0130 { 174 6 ---  178 6 ---  175 6 ---  179 6 --- }
41EB: 0130 { 176 6 ---  17A 6 ---  177 6 ---  17B 6 --- }
41EC: 0130 { 173 7 ---  173 7 ---  0F8 7 ---  2C2 0 --- }
41ED: 0130 { 13A 6 ---  16E 6 ---  13B 6 ---  16F 6 --- }
41EE: 0130 { 171 7 ---  0F8 7 ---  171 7 ---  107 7 --- }
41EF: 0130 { 171 7 ---  108 7 ---  171 7 ---  173 7 --- }
41F0: 0130 { 1CD 3 ---  1DD 3 ---  1CE 3 ---  1DE 3 --- }
41F1: 0130 { 188 3 ---  198 3 ---  189 3 ---  199 3 --- }
41F2: 0130 { 09E 5 ---  0AA 5 ---  09F 5 ---  0AB 5 --- }
41F3: 0130 { 2B3 4 ---  2F1 4 ---  2B4 4 ---  2F6 4 --- }
41F4: 0130 { 2B5 4 ---  2EC 4 ---  2DC 4 ---  2C6 4 --- }
41F5: 0130 { 2DD 4 ---  2C7 4 ---  02B 4 x--  02A 4 x-- }
41F6: 0130 { 2D0 5 ---  2C2 0 ---  2FD 5 ---  2C3 0 --- }
41F7: 0130 { 2FE 5 ---  2C4 0 ---  2FF 5 ---  2C5 0 --- }
41F8: 0130 { 2D0 5 ---  2C4 0 ---  2FF 5 ---  2C5 0 --- }
41F9: 0130 { 16E 6 ---  17E 6 ---  16F 6 ---  17F 6 --- }
41FA: 0130 { 17C 6 ---  12C 6 ---  17D 6 ---  12D 6 --- }
41FB: 0130 { 15E 6 ---  12E 6 ---  15F 6 ---  12F 6 --- }
41FC: 0130 { 170 7 ---  0F8 7 ---  171 7 ---  0F8 7 --- }
41FD: 0130 { 171 7 ---  0F8 7 ---  171 7 ---  0F8 7 --- }
41FE: 0130 { 171 7 ---  0F8 7 ---  172 7 ---  0F8 7 --- }
41FF: 0130 { 109 7 ---  0F8 7 ---  173 7 ---  173 7 --- }
