6400: 0025 { 0F8 5 x--  0F8 5 x--  0F8 5 x--  2BB 5 x-- }
6401: 0025 { 0F8 5 x--  2BA 5 x--  0F8 5 x--  289 5 x-- }
6402: 0025 { 0F8 5 x--  288 5 x--  0F8 5 x--  287 5 x-- }
6403: 0025 { 0F8 5 x--  0F8 5 x--  0F8 5 x--  0F8 5 x-- }
6404: 0025 { 240 4 ---  250 4 ---  241 4 ---  251 4 --- }
6405: 0025 { 242 4 ---  252 4 ---  0F8 5 x--  0F8 5 x-- }
6406: 0025 { 275 6 ---  277 6 ---  276 6 ---  278 6 --- }
6407: 0025 { 0F8 5 x--  0F8 5 x--  27B 4 x--  214 4 x-- }
6408: 0025 { 200 4 ---  210 4 ---  201 4 ---  211 4 --- }
6409: 0025 { 202 4 ---  212 4 ---  203 4 ---  213 4 --- }
640A: 0025 { 204 4 ---  0F8 5 x--  205 4 ---  215 4 --- }
640B: 0025 { 206 4 ---  216 4 ---  207 4 ---  217 4 --- }
640C: 0025 { 208 4 ---  218 4 ---  209 4 ---  219 4 --- }
640D: 0025 { 20A 4 ---  21A 4 ---  20B 4 ---  21B 4 --- }
640E: 0025 { 27B 4 ---  214 4 ---  0F8 5 x--  0F8 5 x-- }
640F: 0130 { 28E 5 ---  29E 5 ---  28F 5 ---  29F 5 --- }
6410: 0025 { 0F8 5 x--  0F8 5 x--  2CB 5 x--  2DB 5 x-- }
6411: 0025 { 2CA 5 x--  2DA 5 x--  299 5 x--  2BD 5 x-- }
6412: 0025 { 298 5 x--  2BC 5 x--  297 5 x--  29D 5 x-- }
6413: 0025 { 296 5 x--  29C 5 x--  0F8 5 x--  0F8 5 x-- }
6414: 0025 { 260 4 ---  270 4 ---  261 4 ---  271 4 --- }
6415: 0025 { 262 4 ---  272 4 ---  0F8 5 x--  0F8 5 x-- }
6416: 0025 { 279 6 ---  0F8 6 x--  27A 6 ---  0F8 6 x-- }
6417: 0025 { 0F8 5 x--  0F8 5 x--  225 4 x--  0F8 5 x-- }
6418: 0025 { 220 4 ---  230 4 ---  221 4 ---  231 4 --- }
6419: 0025 { 222 4 ---  232 4 ---  223 4 ---  233 4 --- }
641A: 0025 { 224 4 ---  234 4 ---  0F8 5 x--  235 4 --- }
641B: 0025 { 226 4 ---  236 4 ---  227 4 ---  237 4 --- }
641C: 0025 { 228 4 ---  238 4 ---  229 4 ---  239 4 --- }
641D: 0025 { 22A 4 ---  23A 4 ---  22B 4 ---  23B 4 --- }
641E: 0025 { 225 4 ---  0F8 5 x--  0F8 5 x--  0F8 5 x-- }
641F: 0130 { 2AE 5 ---  2BE 5 ---  2AF 5 ---  2BF 5 --- }
6420: 0025 { 0F8 5 x--  0F8 5 x--  2DD 5 x--  2E7 5 x-- }
6421: 0025 { 2DC 5 x--  2E6 5 x--  2CD 5 x--  2D8 5 x-- }
6422: 0025 { 2CC 5 x--  2C8 5 x--  2AD 5 x--  2F3 5 x-- }
6423: 0025 { 2AC 5 x--  286 5 x--  0F8 5 x--  0F8 5 x-- }
6424: 0025 { 0F8 5 x--  0F8 5 x--  242 4 x--  252 4 x-- }
6425: 0025 { 241 4 x--  251 4 x--  240 4 x--  250 4 x-- }
6426: 0130 { 273 3 ---  257 3 ---  274 3 ---  266 3 --- }
6427: 0025 { 0F8 5 x--  0F8 5 x--  0F8 5 x--  0F8 5 x-- }
6428: 0025 { 0F8 5 x--  0F8 5 x--  263 4 ---  0F8 5 x-- }
6429: 0025 { 264 4 ---  0F8 5 x--  243 4 ---  253 4 --- }
642A: 0025 { 244 4 ---  254 4 ---  245 4 ---  255 4 --- }
642B: 0025 { 246 4 ---  256 4 ---  247 4 ---  254 4 x-- }
642C: 0025 { 267 4 ---  253 4 x--  264 4 x--  0F8 5 x-- }
642D: 0025 { 263 4 x--  0F8 5 x--  0F8 5 x--  0F8 5 x-- }
642E: 0025 { 0F8 5 x--  0F8 5 x--  0F8 5 x--  0F8 5 x-- }
642F: 0130 { 2CE 5 ---  2DE 5 ---  2CF 5 ---  2DF 5 --- }
6430: 0025 { 0F8 5 x--  0F8 5 x--  20C 4 ---  21C 4 --- }
6431: 0025 { 20D 4 ---  21D 4 ---  20E 4 ---  21E 4 --- }
6432: 0025 { 20F 4 ---  21F 4 ---  0F8 5 x--  0F8 5 x-- }
6433: 0025 { 0F8 5 x--  0F8 5 x--  0F8 5 x--  0F8 5 x-- }
6434: 0025 { 0F8 5 x--  0F8 5 x--  262 4 x--  272 4 x-- }
6435: 0025 { 261 4 x--  271 4 x--  260 4 x--  270 4 x-- }
6436: 0130 { 0F8 5 x--  0F8 5 x--  25E 5 ---  26E 5 --- }
6437: 0025 { 25F 5 ---  26F 5 ---  0F8 5 x--  0F8 5 x-- }
6438: 0025 { 28B 5 x--  29B 5 x--  28A 5 x--  29A 5 x-- }
6439: 0025 { 28C 5 x--  0F8 5 x--  0F8 5 x--  0F8 5 x-- }
643A: 0025 { 0F8 5 xy-  2AB 5 xy-  0F8 5 xy-  2AA 5 xy- }
643B: 0106 { 252 7 --p  262 7 --p  252 7 x-p  262 7 x-p }
643C: 0130 { 2EA 5 ---  2FA 5 ---  2EF 5 ---  2FF 5 --- }
643D: 0130 { 2EA 5 ---  2FA 5 ---  2EB 5 ---  2FB 5 --- }
643E: 0130 { 2EC 5 ---  2FC 5 ---  2ED 5 ---  2FD 5 --- }
643F: 0130 { 2EE 5 ---  2FE 5 ---  2EF 5 ---  2FF 5 --- }
6440: 0025 { 0F8 5 x--  0F8 5 x--  22C 4 ---  23C 4 --- }
6441: 0025 { 22D 4 ---  23D 4 ---  22E 4 ---  23E 4 --- }
6442: 0025 { 22F 4 ---  23F 4 ---  0F8 5 x--  0F8 5 x-- }
6443: 0106 { 250 7 --p  260 7 --p  251 7 --p  261 7 --p }
6444: 0106 { 252 7 --p  262 7 --p  252 7 x-p  262 7 x-p }
6445: 0106 { 251 7 x-p  261 7 x-p  250 7 x-p  260 7 x-p }
6446: 0130 { 0F8 5 x--  0F8 5 x--  27E 5 ---  0F8 5 --- }
6447: 0025 { 27F 5 ---  0F8 5 ---  0F8 5 x--  0F8 5 x-- }
6448: 0025 { 2AB 5 x--  0F8 5 x--  2AA 5 x--  0F8 5 x-- }
6449: 0025 { 20B 7 --p  21B 7 --p  20C 7 --p  21C 7 --p }
644A: 0025 { 29B 5 xy-  28B 5 xy-  29A 5 xy-  28A 5 xy- }
644B: 0025 { 0F8 5 xy-  28C 5 xy-  0F8 5 xy-  0F8 5 xy- }
644C: 006E { 0F8 5 x--  0F8 5 x--  0F8 5 x--  0F8 5 x-- }
644D: 0025 { 0A0 4 --p  0B0 4 --p  0A1 4 --p  0B1 4 --p }
644E: 0025 { 0A1 4 x-p  0B1 4 x-p  0A0 4 x-p  0B0 4 x-p }
644F: 0025 { 0F8 5 x--  0F8 5 x--  0F8 5 x--  0F8 5 x-- }
6450: 0025 { 0F8 5 x--  0F8 5 x--  24C 5 ---  25C 5 --- }
6451: 0025 { 24D 4 ---  25D 4 ---  24E 4 ---  25E 4 --- }
6452: 0025 { 24F 4 ---  25F 4 ---  0F8 5 x--  0F8 5 x-- }
6453: 0025 { 0F8 5 x-p  0F8 5 x-p  255 7 x-p  265 7 x-p }
6454: 0025 { 253 7 --p  263 7 --p  082 3 --p  092 3 --p }
6455: 0025 { 255 7 --p  265 7 --p  0F8 5 x-p  0F8 5 x-p }
6456: 0025 { 0F8 5 x--  0F8 5 x--  0F8 5 x--  0F8 5 x-- }
6457: ~
6458: ~
6459: ~
645A: ~
645B: ~
645C: ~
645D: ~
645E: ~
645F: ~
6460: 0025 { 0F8 5 x--  0F8 5 x--  26C 4 ---  26C 4 --- }
6461: 0025 { 0F8 5 x--  26D 4 ---  0F8 5 x--  26E 4 --- }
6462: 0025 { 26C 4 x--  26F 4 ---  0F8 5 x--  0F8 5 x-- }
6463: 0025 { 0F8 5 x-p  0F8 5 x-p  0F8 5 x-p  256 7 --p }
6464: 0025 { 248 7 --p  258 7 --p  249 7 --p  259 7 --p }
6465: 0025 { 0F8 5 x-p  256 7 x-p  0F8 5 x-p  0F8 5 x-p }
6466: ~
6467: ~
6468: ~
6469: ~
646A: ~
646B: ~
646C: ~
646D: ~
646E: ~
646F: ~
6470: 0025 { 0F8 5 x--  0F8 5 x--  27C 4 ---  248 4 --- }
6471: 0025 { 27D 4 ---  249 4 ---  27E 4 ---  24A 4 --- }
6472: 0025 { 27F 4 ---  24B 4 ---  0F8 5 x--  0F8 5 x-- }
6473: 0025 { 236 5 ---  246 5 ---  237 5 ---  247 5 --- }
6474: 0130 { 268 7 --p  278 7 --p  269 7 --p  279 7 --p }
6475: ~
6476: ~
6477: ~
6478: ~
6479: ~
647A: ~
647B: ~
647C: ~
647D: ~
647E: ~
647F: ~
6480: 0025 { 0F8 5 x--  0F8 5 x--  258 4 ---  268 4 --- }
6481: 0025 { 259 4 ---  269 4 ---  25A 4 ---  26A 4 --- }
6482: 0025 { 25B 4 ---  26B 4 ---  0F8 5 x--  0F8 5 x-- }
6483: ~
6484: ~
6485: ~
6486: ~
6487: ~
6488: ~
6489: ~
648A: ~
648B: ~
648C: ~
648D: ~
648E: ~
648F: ~
6490: 0025 { 0F8 5 x--  0F8 5 x--  21F 4 xy-  20F 4 xy- }
6491: 0025 { 21E 4 xy-  20E 4 xy-  21D 4 xy-  20D 4 xy- }
6492: 0025 { 21C 4 xy-  20C 4 xy-  0F8 5 x--  0F8 5 x-- }
6493: ~
6494: ~
6495: ~
6496: ~
6497: ~
6498: ~
6499: ~
649A: ~
649B: ~
649C: ~
649D: ~
649E: ~
649F: ~
64A0: ~
64A1: ~
64A2: ~
64A3: ~
64A4: ~
64A5: ~
64A6: ~
64A7: ~
64A8: ~
64A9: ~
64AA: ~
64AB: ~
64AC: ~
64AD: ~
64AE: ~
64AF: ~
64B0: ~
64B1: ~
64B2: ~
64B3: ~
64B4: ~
64B5: ~
64B6: ~
64B7: ~
64B8: ~
64B9: ~
64BA: ~
64BB: ~
64BC: ~
64BD: ~
64BE: ~
64BF: ~
64C0: ~
64C1: ~
64C2: ~
64C3: ~
64C4: ~
64C5: ~
64C6: ~
64C7: ~
64C8: ~
64C9: ~
64CA: ~
64CB: ~
64CC: ~
64CD: ~
64CE: ~
64CF: ~
64D0: ~
64D1: ~
64D2: ~
64D3: ~
64D4: ~
64D5: ~
64D6: ~
64D7: ~
64D8: ~
64D9: ~
64DA: ~
64DB: ~
64DC: ~
64DD: ~
64DE: ~
64DF: ~
64E0: ~
64E1: ~
64E2: ~
64E3: ~
64E4: ~
64E5: ~
64E6: ~
64E7: ~
64E8: ~
64E9: ~
64EA: ~
64EB: ~
64EC: ~
64ED: ~
64EE: ~
64EF: ~
64F0: ~
64F1: ~
64F2: ~
64F3: ~
64F4: ~
64F5: ~
64F6: ~
64F7: ~
64F8: ~
64F9: ~
64FA: ~
64FB: ~
64FC: ~
64FD: ~
64FE: ~
64FF: ~
