2900: 0130 { 1C8 4 ---  1D8 4 ---  1C9 4 ---  1D9 4 --- }
2901: 0049 { 0A0 1 --p  0A0 1 --p  0A0 1 --p  0A0 1 --p }
2902: 0049 { 0FA 1 ---  0FA 1 ---  0FA 1 ---  0FA 1 --- }
2903: 0049 { 0A0 1 --p  07F 1 --p  0A0 1 --p  0A0 1 --p }
2904: 0049 { 0A0 1 --p  0A0 1 -yp  0A0 1 x-p  0A0 1 xyp }
2905: 0049 { 0A0 1 --p  0A2 1 --p  0A2 1 --p  0A0 1 --p }
2906: 0049 { 0A3 1 --p  0A2 1 --p  0A2 1 --p  0A3 1 --p }
2907: 01E4 { 192 2 -y-  194 2 -y-  193 2 -y-  186 2 xy- }
2908: 01E4 { 193 2 xy-  186 2 -y-  192 2 xy-  194 2 xy- }
2909: 0049 { 0A0 3 --p  0A2 3 --p  0A2 3 --p  0A0 3 --p }
290A: 0049 { 0A0 3 --p  07F 3 --p  0A2 3 --p  0A0 3 --p }
290B: 0049 { 0A2 3 x-p  0A0 3 x-p  0A0 3 x-p  07F 3 x-p }
290C: ~
290D: 0025 { 19A 7 ---  19C 7 ---  19B 7 ---  19D 7 --- }
290E: 0025 { 19B 7 x--  1A1 7 ---  1A0 7 ---  1A2 7 --- }
290F: ~
2910: 0049 { 087 5 ---  123 6 ---  088 5 ---  123 6 x-- }
2911: ~
2912: ~
2913: ~
2914: ~
2915: ~
2916: 0049 { 0A0 1 --p  07F 1 --p  0A2 1 --p  0A0 1 --p }
2917: 0049 { 0A0 1 --p  0A0 1 --p  0A0 1 --p  0A0 1 x-p }
2918: 0049 { 0A0 1 --p  0A0 1 --p  0A0 1 --p  0A0 1 -yp }
2919: 01E3 { 1D0 2 -y-  18B 2 -y-  193 2 -y-  195 2 x-- }
291A: 0049 { 07F 3 -yp  0A0 3 -yp  0A0 3 -yp  0A2 3 -yp }
291B: 0049 { 0A0 3 xyp  0A2 3 xyp  07F 3 xyp  0A0 3 xyp }
291C: ~
291D: 0025 { 19C 7 ---  19C 7 -y-  19E 7 ---  19F 7 --- }
291E: 0025 { 19E 7 x--  19F 7 -y-  1A2 7 ---  1A2 7 -y- }
291F: ~
2920: 0049 { 04C 6 ---  04E 6 ---  04C 6 x--  04E 6 x-- }
2921: 0100 { 155 5 ---  147 5 ---  156 5 ---  156 5 -y- }
2922: 0100 { 156 5 x--  156 5 xy-  155 5 x--  147 5 x-- }
2923: 0100 { 156 5 x--  156 5 xy-  156 5 x--  156 5 -y- }
2924: 0100 { 100 5 ---  111 5 ---  156 5 ---  156 5 -y- }
2925: 0100 { 156 5 x--  156 5 xy-  100 5 x--  111 5 x-- }
2926: 0049 { 0A0 1 --p  0A2 1 --p  07F 1 --p  0A0 1 --p }
2927: 0139 { 000 5 ---  010 5 ---  001 5 ---  011 5 --- }
2928: 013A { 002 5 ---  012 5 ---  003 5 ---  013 5 --- }
2929: ~
292A: ~
292B: ~
292C: ~
292D: ~
292E: ~
292F: ~
2930: 0049 { 123 6 -y-  07E 6 xy-  123 6 xy-  07E 6 xy- }
2931: 0049 { 145 7 ---  145 7 ---  145 7 xy-  145 7 x-- }
2932: 0049 { 146 7 ---  146 7 ---  146 7 ---  146 7 --- }
2933: 0049 { 145 7 ---  145 7 ---  146 7 ---  146 7 --- }
2934: 0049 { 146 7 x--  146 7 x--  145 7 x--  145 7 x-- }
2935: 0000 { 070 1 ---  072 1 ---  071 1 ---  073 1 --- }
2936: 0146 { 190 2 -y-  191 2 -y-  193 2 -y-  183 2 -y- }
2937: 0146 { 193 2 xy-  183 2 xy-  190 2 xy-  191 2 xy- }
2938: 0049 { 1D1 2 xy-  07E 2 ---  1D1 2 -y-  07E 2 --- }
2939: 0049 { 07E 2 xy-  1D1 2 x--  07E 2 xy-  1D1 2 --- }
293A: 0025 { 083 4 -y-  083 4 ---  083 4 xy-  083 4 x-- }
293B: 0025 { 083 4 -y-  083 4 ---  083 4 xy-  083 4 x-- }
293C: 0029 { 02D 4 ---  02D 4 -y-  02D 4 x--  02D 4 xy- }
293D: 0130 { 0CD 6 ---  0CD 6 ---  021 7 x--  031 7 x-- }
293E: 0130 { 020 7 x--  030 7 x--  020 7 ---  030 7 --- }
293F: 0130 { 021 7 ---  031 7 ---  0CD 6 ---  0CD 6 --p }
2940: 0049 { 123 6 -y-  07E 6 xy-  123 6 xy-  07E 6 xy- }
2941: 0049 { 07E 1 ---  123 6 ---  07E 1 x--  123 6 x-- }
2942: 002B { 02D 4 ---  02D 4 -y-  02D 4 x--  02D 4 xy- }
2943: 0049 { 145 7 --p  145 7 --p  146 7 --p  146 7 --p }
2944: 0049 { 146 7 --p  146 7 --p  146 7 --p  146 7 --p }
2945: 0049 { 146 7 x-p  146 7 x-p  145 7 x-p  145 7 x-p }
2946: 0130 { 08E 1 ---  08E 1 -y-  08E 1 x--  08E 1 xy- }
2947: 0117 { 068 6 ---  068 6 -y-  068 6 x--  068 6 xy- }
2948: 0100 { 156 5 x-p  156 5 xyp  156 5 x-p  156 5 -yp }
2949: 0100 { 100 5 --p  111 5 --p  156 5 --p  156 5 -yp }
294A: 0100 { 156 5 x-p  156 5 xyp  100 5 x-p  111 5 x-p }
294B: 0130 { 18F 5 ---  192 5 ---  190 5 ---  193 5 --- }
294C: 0130 { 191 5 ---  193 5 ---  18F 5 x--  192 5 --- }
294D: 0130 { 0CD 6 ---  0CD 6 ---  041 7 x--  041 7 xy- }
294E: 0130 { 040 7 x--  040 7 xy-  040 7 ---  040 7 -y- }
294F: 0130 { 041 7 ---  041 7 -y-  0CD 6 ---  0CD 6 --p }
2950: 0049 { 156 5 -y-  07E 5 xy-  111 5 x--  07E 5 x-- }
2951: 0049 { 111 5 ---  07E 5 ---  156 5 xy-  07E 5 -y- }
2952: 0049 { 156 5 -y-  145 7 ---  156 5 xy-  145 7 xy- }
2953: 0000 { 145 7 --p  145 7 --p  146 7 --p  146 7 --p }
2954: 0000 { 146 7 --p  146 7 --p  146 7 --p  146 7 --p }
2955: 0000 { 146 7 x-p  146 7 x-p  145 7 x-p  145 7 x-p }
2956: 0130 { 08E 0 ---  08E 0 -y-  08E 0 x--  08E 0 xy- }
2957: 0132 { 058 6 ---  059 6 xy-  059 6 ---  059 6 -y- }
2958: 0029 { 08F 6 ---  08F 6 -y-  08F 6 x--  08F 6 xy- }
2959: 0130 { 188 4 ---  18D 4 ---  18C 4 ---  18E 4 --- }
295A: 0025 { 19E 7 xy-  19F 7 -y-  19F 7 ---  19E 7 --- }
295B: 0130 { 194 5 ---  194 5 x--  193 5 -y-  193 5 --- }
295C: 0130 { 193 5 -y-  193 5 ---  194 5 x--  194 5 --- }
295D: 0130 { 0CD 6 ---  0CD 6 ---  031 7 xy-  021 7 xy- }
295E: 0130 { 030 7 xy-  020 7 xy-  030 7 -y-  020 7 -y- }
295F: 0130 { 031 7 -y-  021 7 -y-  0CD 6 ---  0CD 6 --p }
2960: 0100 { 182 3 ---  192 3 ---  183 3 ---  193 3 --- }
2961: 0101 { 181 3 ---  1D0 3 ---  183 3 ---  193 3 --- }
2962: 0102 { 18D 3 ---  1D0 3 ---  183 3 ---  193 3 --- }
2963: 0103 { 182 3 ---  192 3 ---  181 3 x--  1D0 3 x-- }
2964: 0104 { 182 3 ---  192 3 ---  18D 3 x--  1D0 3 x-- }
2965: 01F0 { 192 3 -y-  194 3 -y-  193 3 -y-  195 3 -y- }
2966: 01FA { 194 3 ---  1B0 3 -y-  1F3 3 x--  193 3 --- }
2967: 0130 { 180 2 ---  182 2 ---  181 2 ---  183 2 --- }
2968: 0130 { 184 4 ---  186 4 ---  185 4 ---  187 4 --- }
2969: 0130 { 189 4 x--  18B 4 ---  189 4 ---  18B 4 --- }
296A: 0130 { 187 4 ---  18A 4 ---  18A 4 -y-  187 4 xy- }
296B: 0130 { 195 5 ---  18F 5 ---  193 5 -y-  190 5 --- }
296C: 0130 { 193 5 -y-  191 5 ---  195 5 ---  18F 5 x-- }
296D: 0025 { 004 4 ---  004 4 ---  004 4 ---  004 4 --- }
296E: 0130 { 2E6 2 ---  2E8 2 ---  2E7 2 ---  2E9 2 --- }
296F: 0130 { 2E6 2 ---  2C8 2 ---  2E7 2 ---  2C9 2 --- }
2970: 01E7 { 1C0 3 ---  1D0 3 ---  195 3 ---  193 3 --- }
2971: 01E8 { 194 3 ---  192 3 ---  1C0 3 x--  1D0 3 x-- }
2972: 0049 { 1D1 3 xy-  07E 3 ---  1D1 3 -y-  07E 3 --- }
2973: 0049 { 07E 3 xy-  1D1 3 x--  07E 3 xy-  1D1 3 --- }
2974: 01E4 { 192 3 -y-  194 3 -y-  193 3 -y-  186 3 xy- }
2975: 01E4 { 193 3 xy-  186 3 -y-  192 3 xy-  194 3 xy- }
2976: 01E3 { 1D0 3 -y-  18B 3 -y-  193 3 -y-  195 3 x-- }
2977: 00A2 { 1F2 3 ---  193 3 ---  194 3 ---  1B0 3 --- }
2978: 0130 { 188 4 ---  188 4 ---  185 4 -y-  185 4 --- }
2979: 0130 { 189 4 ---  0FB 4 ---  18A 4 ---  185 4 -y- }
297A: ~
297B: 0130 { 196 5 ---  198 5 ---  197 5 ---  199 5 --- }
297C: 0130 { 196 5 ---  198 5 ---  197 5 ---  199 5 --- }
297D: 0025 { 004 4 ---  004 4 ---  004 4 ---  004 4 --- }
297E: 0025 { 2F8 2 ---  0CF 6 ---  2F9 2 ---  0CF 6 x-- }
297F: 0130 { 2D8 2 ---  0CF 6 ---  2D9 2 ---  0CF 6 x-- }
2980: 01B0 { 189 3 x--  197 3 x--  195 3 ---  188 3 x-- }
2981: 01AB { 194 3 ---  188 3 ---  189 3 ---  197 3 --- }
2982: 01A1 { 1A1 3 x--  19E 3 x--  1EC 3 x--  19D 3 x-- }
2983: 01A6 { 194 3 ---  1B1 3 x--  195 3 ---  1A0 3 x-- }
2984: 0197 { 194 3 ---  1A0 3 ---  195 3 ---  1B1 3 --- }
2985: 019C { 1EC 3 ---  19D 3 ---  1A1 3 ---  19E 3 --- }
2986: 00AC { 194 3 ---  1D1 3 -y-  1D1 3 -y-  0F8 3 --- }
2987: 00AC { 1D1 3 xy-  0F8 3 x--  194 3 x--  1D1 3 xy- }
2988: 0025 { 0F8 0 ---  100 3 ---  0F8 0 ---  134 3 --- }
2989: 0025 { 0F8 0 ---  135 3 ---  0F8 0 ---  0F8 0 --- }
298A: 0025 { 0F8 0 ---  136 3 ---  0F8 0 ---  137 3 --- }
298B: 0025 { 0F8 0 ---  138 3 ---  0F8 0 ---  0F8 0 --- }
298C: ~
298D: 0025 { 004 4 ---  004 4 ---  004 4 ---  004 4 --- }
298E: 0025 { 004 4 ---  004 4 ---  004 4 ---  004 4 --- }
298F: ~
2990: 0085 { 1E7 3 ---  1EA 3 ---  1E8 3 ---  1F0 3 --- }
2991: 0086 { 1E8 3 ---  1F0 3 ---  1E9 3 ---  1F1 3 --- }
2992: 0087 { 1E8 3 ---  1F0 3 ---  1E7 3 x--  1EA 3 x-- }
2993: 01E2 { 186 3 ---  192 3 ---  195 3 ---  193 3 --- }
2994: 01E4 { 194 3 ---  192 3 ---  186 3 x--  193 3 --- }
2995: 00B0 { 194 3 ---  1B0 3 x--  1F2 3 x--  195 3 --- }
2996: 0025 { 0F8 0 ---  147 3 ---  139 3 ---  148 3 --- }
2997: 0025 { 13A 3 ---  149 3 ---  13B 3 ---  14A 3 --- }
2998: 0025 { 13C 3 ---  14B 3 ---  13D 3 ---  14C 3 --- }
2999: 0025 { 13E 3 ---  14D 3 ---  13F 3 ---  14E 3 --- }
299A: 0025 { 140 3 ---  14F 3 ---  141 3 ---  150 3 --- }
299B: 0025 { 142 3 ---  151 3 ---  0F8 0 ---  152 3 --- }
299C: 0025 { 0F8 0 ---  153 3 ---  143 3 ---  154 3 --- }
299D: 0025 { 144 3 ---  155 3 ---  0F8 0 ---  156 3 --- }
299E: 0025 { 145 3 ---  157 3 ---  146 3 ---  158 3 --- }
299F: 0025 { 139 3 x--  159 3 ---  0F8 0 ---  0F8 0 --- }
29A0: 00AA { 194 3 ---  1B0 3 x--  1B0 3 x--  195 3 --- }
29A1: 00A4 { 1B0 3 xy-  193 3 ---  193 3 ---  1B0 3 xy- }
29A2: 01E0 { 1B3 3 x--  192 3 ---  18C 3 x--  193 3 --- }
29A3: 01DE { 18C 3 ---  192 3 ---  1B3 3 ---  193 3 --- }
29A4: 01C2 { 18A 3 x--  19A 3 x--  0F8 3 ---  196 3 x-- }
29A5: 01AF { 187 3 x--  197 3 x--  0F8 3 ---  196 3 x-- }
29A6: 0025 { 15A 3 ---  16D 3 ---  15B 3 ---  16E 3 --- }
29A7: 0025 { 15C 3 ---  16F 3 ---  15D 3 ---  170 3 --- }
29A8: 0025 { 15E 3 ---  171 3 ---  15F 3 ---  172 3 --- }
29A9: 0025 { 160 3 ---  173 3 ---  161 3 ---  174 3 --- }
29AA: 0025 { 162 3 ---  175 3 ---  163 3 ---  176 3 --- }
29AB: 0025 { 164 3 ---  177 3 ---  165 3 ---  178 3 --- }
29AC: 0025 { 166 3 ---  179 3 ---  167 3 ---  17A 3 --- }
29AD: 0025 { 168 3 ---  17B 3 ---  169 3 ---  17C 3 --- }
29AE: 0025 { 16A 3 ---  17D 3 ---  16B 3 ---  17E 3 --- }
29AF: 0025 { 16C 3 ---  0F8 0 ---  0F8 0 ---  0F8 0 --- }
29B0: 0130 { 0F8 2 ---  0F8 2 ---  0F8 2 ---  0F8 2 --- }
29B1: 0130 { 101 2 ---  107 2 ---  102 2 ---  108 2 --- }
29B2: 0130 { 103 2 ---  0FB 2 ---  104 2 ---  109 2 --- }
29B3: 0130 { 0F8 2 ---  10A 2 ---  0F8 2 ---  0F8 2 --- }
29B4: 0130 { 105 2 ---  0FB 2 ---  106 2 ---  10B 2 --- }
29B5: 0130 { 0F8 2 ---  114 2 ---  10C 2 ---  115 2 --- }
29B6: 0130 { 10D 2 ---  116 2 ---  10E 2 ---  117 2 --- }
29B7: 0130 { 0FB 2 ---  0FB 2 ---  0FB 2 ---  0FB 2 --- }
29B8: 0130 { 10F 2 ---  0FB 2 ---  110 2 ---  118 2 --- }
29B9: 0130 { 111 2 ---  119 2 ---  112 2 ---  11A 2 --- }
29BA: 0130 { 0FB 2 ---  0FB 2 ---  113 2 ---  0FB 2 --- }
29BB: 0130 { 0F8 2 ---  11B 2 ---  0F8 2 ---  0F8 2 --- }
29BC: 0130 { 0F8 2 ---  0F8 2 ---  0F8 2 ---  11C 2 --- }
29BD: 0130 { 0F8 2 ---  11D 2 ---  0F8 2 ---  11E 2 --- }
29BE: 0130 { 105 2 ---  0FB 2 ---  106 2 ---  11F 2 --- }
29BF: 0130 { 120 2 ---  0FB 2 ---  0FB 2 ---  0FB 2 --- }
29C0: 0130 { 0FB 2 ---  0FB 2 ---  121 2 ---  0FB 2 --- }
29C1: 0130 { 0F8 2 ---  12B 2 ---  0F8 2 ---  12C 2 --- }
29C2: 0130 { 122 2 ---  12D 2 ---  123 2 ---  0FB 2 --- }
29C3: 0130 { 124 2 ---  0FB 2 ---  125 2 ---  12E 2 --- }
29C4: 0130 { 103 2 ---  0FB 2 ---  104 2 ---  12F 2 --- }
29C5: 0130 { 11C 2 ---  128 2 ---  11D 2 ---  129 2 --- }
29C6: 0130 { 0FB 2 ---  0FB 2 ---  126 2 ---  0FB 2 --- }
29C7: 0130 { 127 2 ---  130 2 ---  128 2 ---  131 2 --- }
29C8: 0130 { 129 2 ---  132 2 ---  0FB 2 ---  0FB 2 --- }
29C9: 0130 { 10F 2 ---  0FB 2 ---  110 2 ---  126 2 --- }
29CA: 0130 { 0FB 2 ---  0FB 2 ---  12A 2 ---  0FB 2 --- }
29CB: 0130 { 131 2 ---  0FB 2 ---  132 2 ---  0FB 2 --- }
29CC: 0130 { 103 2 ---  0FB 2 ---  104 2 ---  133 2 --- }
29CD: 0130 { 0CB 2 ---  0CB 2 -y-  0CA 2 ---  0FA 2 --- }
29CE: 0130 { 0CA 2 ---  0FA 2 ---  0CB 2 ---  0CB 2 -y- }
29CF: ~
29D0: 0025 { 026 2 ---  027 2 -y-  026 2 ---  1C2 2 --- }
29D1: 0025 { 026 2 ---  1C3 2 ---  026 2 ---  1C4 2 --- }
29D2: 0025 { 026 2 ---  1C5 2 ---  026 2 ---  1C6 2 --- }
29D3: 0025 { 026 2 ---  1C7 2 ---  026 2 ---  1C8 2 --- }
29D4: 0025 { 026 2 ---  1C9 2 ---  026 2 ---  027 2 -y- }
29D5: 0039 { 0E0 4 ---  0D3 4 ---  0C4 4 ---  0D4 4 --- }
29D6: 003A { 0D3 4 ---  0D3 4 ---  0D4 4 ---  0D4 4 --- }
29D7: 021F { 1CC 2 ---  1DC 2 ---  1CD 2 ---  1DD 2 --- }
29D8: 021F { 1CE 2 ---  1DE 2 ---  1CF 2 ---  1DF 2 --- }
29D9: 0130 { 1DC 2 ---  1EC 2 ---  1DD 2 ---  1ED 2 --- }
29DA: 0130 { 1DE 2 ---  1EE 2 ---  1DF 2 ---  1EF 2 --- }
29DB: 0130 { 1DD 0 ---  1ED 0 ---  0AE 2 ---  0AE 2 --- }
29DC: 0130 { 0AE 2 --p  0AE 2 --p  1DE 0 --p  1EE 0 --p }
29DD: 0130 { 0CB 2 ---  0CB 2 -y-  0FA 2 -y-  0CA 2 -y- }
29DE: 0130 { 0FA 2 -y-  0CA 2 -y-  0CB 2 ---  0CB 2 -y- }
29DF: ~
29E0: 0025 { 04A 2 ---  071 2 ---  1D2 2 ---  1E2 2 --- }
29E1: 0025 { 1D3 2 ---  1E3 2 ---  1D4 2 ---  1E4 2 --- }
29E2: 0025 { 1D5 2 ---  1E5 2 ---  1D6 2 ---  1E6 2 --- }
29E3: 0025 { 1D7 2 ---  1E7 2 ---  1D8 2 ---  1E8 2 --- }
29E4: 0025 { 1D9 2 ---  1E9 2 ---  04A 2 ---  072 2 --- }
29E5: 0039 { 0E0 5 ---  0D3 5 ---  0C4 5 ---  0D4 5 --- }
29E6: 003A { 0D3 5 ---  0D3 5 ---  0D4 5 ---  0D4 5 --- }
29E7: 021F { 1EC 2 ---  1FC 2 ---  1ED 2 ---  1FD 2 --- }
29E8: 021F { 1EE 2 ---  1FE 2 ---  1EF 2 ---  1FF 2 --- }
29E9: 0130 { 1DD 2 ---  1ED 2 ---  1DE 2 ---  1EE 2 --- }
29EA: 0130 { 18A 7 ---  19A 7 ---  18B 7 ---  19B 7 --- }
29EB: 0130 { 18A 4 ---  19A 4 ---  18B 4 ---  19B 4 --- }
29EC: 0130 { 053 6 -y-  053 6 -yp  054 6 -y-  054 6 -yp }
29ED: 0130 { 1DD 0 ---  1ED 0 ---  0BE 2 -yp  0BE 2 -yp }
29EE: 0130 { 0BE 2 xyp  0BE 2 xyp  1DE 0 --p  1EE 0 --p }
29EF: ~
29F0: 0130 { 22B 7 ---  23B 7 ---  22E 7 ---  23E 7 --- }
29F1: 0130 { 22D 7 ---  23D 7 ---  22E 7 ---  23E 7 --- }
29F2: 0130 { 22D 7 --p  23D 7 --p  22E 7 --p  23E 7 --p }
29F3: 0025 { 22D 7 --p  23D 7 --p  22C 7 --p  23C 7 --p }
29F4: ~
29F5: 0039 { 0E0 7 ---  0D3 7 ---  0C4 7 ---  0D4 7 --- }
29F6: 003A { 0D3 7 ---  0D3 7 ---  0D4 7 ---  0D4 7 --- }
29F7: 0130 { 1FE 2 -y-  1FF 2 ---  0AE 2 ---  0AE 2 --- }
29F8: 0130 { 0AE 2 --p  0AE 2 --p  1FF 2 -yp  1FE 2 x-p }
29F9: 0130 { 1FE 2 -y-  1FF 2 ---  0BE 2 -yp  0BE 2 -yp }
29FA: 0130 { 0BE 2 xyp  0BE 2 xyp  1FF 2 -yp  1FE 2 x-p }
29FB: 0130 { 043 0 ---  053 6 ---  044 0 ---  054 6 --- }
29FC: 0130 { 043 0 --p  053 6 --p  044 0 --p  054 6 --p }
29FD: ~
29FE: ~
29FF: ~
