4000: 01FF { 0FB 3 -yp  04A 3 -yp  0FB 3 -yp  04B 3 -yp }
4001: 01FF { 048 3 x-p  049 3 x-p  04A 3 x-p  0FB 3 x-p }
4002: 01FF { 049 3 x-p  049 3 x-p  0FB 3 x-p  0FB 3 x-p }
4003: 01FF { 049 3 xyp  048 3 xyp  0FB 3 xyp  04A 3 xyp }
4004: 01FF { 0FB 3 -yp  04A 3 -yp  049 3 -yp  048 3 -yp }
4005: 01FF { 04C 3 -yp  0F8 3 -yp  04D 3 -yp  0F8 3 -yp }
4006: 01FF { 04E 3 -yp  04C 3 -yp  04F 3 -yp  04D 3 -yp }
4007: 01FF { 043 3 xyp  041 3 xyp  042 3 xyp  040 3 xyp }
4008: 01FF { 041 3 xyp  0F8 3 -yp  040 3 xyp  0F8 3 -yp }
4009: 01FF { 044 3 -yp  0F8 3 -yp  045 3 -yp  044 3 -yp }
400A: 01FF { 047 3 xyp  046 3 xyp  046 3 xyp  0F8 3 -yp }
400B: 01FF { 0FB 3 -yp  04E 3 -yp  0FB 3 -yp  04F 3 -yp }
400C: 01FF { 0FB 3 -yp  043 3 xyp  0FB 3 -yp  042 3 xyp }
400D: 01FF { 0FB 3 -yp  045 3 -yp  0FB 3 -yp  0FB 3 -yp }
400E: 01FF { 0FB 3 -yp  0FB 3 -yp  0FB 3 -yp  047 3 xyp }
400F: 01FF { 0FB 3 --p  0FB 3 --p  049 3 --p  049 3 --p }
4010: 01E4 { 192 2 -y-  194 2 -y-  193 2 -y-  186 2 xy- }
4011: 01E4 { 193 2 xy-  186 2 -y-  192 2 xy-  194 2 xy- }
4012: 0069 { 10E 1 ---  0F8 3 -yp  119 1 ---  0F8 3 -yp }
4013: 0069 { 10D 1 ---  0F8 3 -yp  12D 1 ---  0F8 3 -yp }
4014: 0069 { 12C 1 ---  0F8 3 -yp  118 1 ---  0F8 3 -yp }
4015: 0069 { 128 1 ---  0F8 3 -yp  129 1 ---  0F8 3 -yp }
4016: 0069 { 119 1 ---  0F8 3 -yp  0F8 3 -yp  0F8 3 -yp }
4017: 0069 { 10A 1 ---  0F8 3 -yp  11C 1 ---  0F8 3 -yp }
4018: 0069 { 119 1 ---  0F8 3 -yp  11D 1 ---  0F8 3 -yp }
4019: 0069 { 109 1 ---  0F8 3 -yp  10C 1 ---  0F8 3 -yp }
401A: 0069 { 10B 1 ---  0F8 3 -yp  0F8 3 -yp  0F8 3 -yp }
401B: 0069 { 10B 1 ---  0F8 3 -yp  12E 1 ---  0F8 3 -yp }
401C: 0069 { 10A 1 ---  0F8 3 -yp  11B 1 ---  0F8 3 -yp }
401D: 0069 { 11D 1 ---  0F8 3 -yp  128 1 ---  0F8 3 -yp }
401E: 0069 { 12E 1 ---  0F8 3 -yp  11E 1 ---  0F8 3 -yp }
401F: 0069 { 12D 1 ---  0F8 3 -yp  108 1 ---  0F8 3 -yp }
4020: 0069 { 119 1 ---  0F8 3 -yp  11E 1 ---  0F8 3 -yp }
4021: 0069 { 108 1 ---  0F8 3 -yp  11E 1 ---  0F8 3 -yp }
4022: 0069 { 10B 1 ---  0F8 3 -yp  0F8 3 -yp  0F8 3 -yp }
4023: 0069 { 108 1 ---  0F8 3 -yp  11C 1 ---  0F8 3 -yp }
4024: 0069 { 11C 1 ---  0F8 3 -yp  0F8 3 -yp  0F8 3 -yp }
4025: 0069 { 10E 1 ---  0F8 3 -yp  128 1 ---  0F8 3 -yp }
4026: 0069 { 12D 1 ---  0F8 3 -yp  0F8 3 -yp  0F8 3 -yp }
4027: 0069 { 138 1 ---  0F8 3 -yp  108 1 ---  0F8 3 -yp }
4028: 0069 { 12C 1 ---  0F8 3 -yp  0F8 3 -yp  0F8 3 -yp }
4029: 0069 { 12D 1 ---  0F8 3 -yp  118 1 ---  0F8 3 -yp }
402A: 0069 { 119 1 ---  0F8 3 -yp  12C 1 ---  0F8 3 -yp }
402B: 0069 { 12C 1 ---  0F8 3 -yp  10A 1 ---  0F8 3 -yp }
402C: 0069 { 10C 1 ---  0F8 3 -yp  11E 1 ---  0F8 3 -yp }
402D: 0069 { 119 1 ---  0F8 3 -yp  10A 1 ---  0F8 3 -yp }
402E: 0069 { 12F 1 ---  0F8 3 -yp  119 1 ---  0F8 3 -yp }
402F: 0069 { 10C 1 ---  0F8 3 -yp  138 1 ---  0F8 3 -yp }
4030: 0130 { 064 4 ---  182 2 ---  065 4 ---  183 2 --- }
4031: 0130 { 182 2 -y-  066 4 ---  183 2 -y-  067 4 --- }
4032: 0130 { 192 2 -y-  182 2 -y-  186 2 xy-  180 2 xy- }
4033: 0130 { 186 2 -y-  180 2 -y-  192 2 xy-  182 2 xy- }
4034: 0130 { 182 2 ---  192 2 ---  180 2 x--  186 2 x-- }
4035: 0130 { 180 2 ---  186 2 ---  182 2 x--  192 2 x-- }
4036: 0130 { 190 2 ---  186 2 ---  194 2 x--  192 2 x-- }
4037: 0130 { 194 2 ---  192 2 ---  190 2 x--  186 2 x-- }
4038: 0130 { 194 2 ---  192 2 ---  195 2 ---  193 2 --- }
4039: 0023 { 02D 4 ---  02D 4 -y-  02D 4 x--  02D 4 xy- }
403A: 003F { 064 4 ---  182 2 ---  065 4 ---  183 2 --- }
403B: 003F { 064 4 ---  066 4 ---  065 4 ---  067 4 --- }
403C: 003F { 192 2 -y-  182 2 -y-  193 2 -y-  183 2 -y- }
403D: ~
403E: ~
403F: ~
4040: ~
4041: ~
4042: ~
4043: ~
4044: ~
4045: ~
4046: ~
4047: ~
4048: ~
4049: ~
404A: ~
404B: ~
404C: ~
404D: ~
404E: ~
404F: ~
4050: ~
4051: ~
4052: ~
4053: ~
4054: ~
4055: ~
4056: ~
4057: ~
4058: ~
4059: ~
405A: ~
405B: ~
405C: ~
405D: ~
405E: ~
405F: ~
4060: ~
4061: ~
4062: ~
4063: ~
4064: ~
4065: ~
4066: ~
4067: ~
4068: ~
4069: ~
406A: ~
406B: ~
406C: ~
406D: ~
406E: ~
406F: ~
4070: ~
4071: ~
4072: ~
4073: ~
4074: ~
4075: ~
4076: ~
4077: ~
4078: ~
4079: ~
407A: ~
407B: ~
407C: ~
407D: ~
407E: ~
407F: ~
4080: 0025 { 00E 1 --p  003 1 --p  01E 1 --p  011 1 --p }
4081: ~
4082: ~
4083: ~
4084: ~
4085: ~
4086: ~
4087: ~
4088: ~
4089: ~
408A: ~
408B: ~
408C: ~
408D: ~
408E: ~
408F: ~
4090: 0025 { 0A0 1 --p  0A2 1 --p  0A1 1 --p  0A3 1 --p }
4091: 0130 { 0A0 1 --p  0A2 1 --p  0A1 1 --p  0A3 1 --p }
4092: 0025 { 0F8 1 ---  0BA 2 ---  0F8 1 ---  0BB 2 --- }
4093: 0025 { 1CB 4 ---  0AE 2 ---  1CC 4 ---  0AF 2 --- }
4094: 0025 { 0F8 1 ---  0DE 2 ---  0F8 1 ---  0DF 2 --- }
4095: ~
4096: ~
4097: ~
4098: ~
4099: ~
409A: ~
409B: ~
409C: ~
409D: ~
409E: 0025 { 0F8 5 ---  038 5 ---  03A 5 ---  0F8 5 --- }
409F: 0025 { 03A 5 x--  0F8 5 x--  0F8 5 x--  038 5 x-- }
40A0: 0025 { 00E 1 ---  003 1 ---  01E 1 ---  011 1 --- }
40A1: 0025 { 007 5 x--  017 5 x--  006 5 x--  016 5 x-- }
40A2: 0025 { 0CA 2 ---  0CC 2 ---  0CB 2 ---  0CD 2 --- }
40A3: 0025 { 0BE 2 ---  0CE 2 ---  0BF 2 ---  0CF 2 --- }
40A4: 0025 { 0EE 2 ---  0DE 2 -y-  0F8 1 ---  0DF 2 -y- }
40A5: ~
40A6: ~
40A7: ~
40A8: ~
40A9: ~
40AA: ~
40AB: ~
40AC: 0025 { 0F8 5 -y-  013 0 x-p  002 0 x-p  012 0 x-p }
40AD: 0025 { 001 0 x-p  0F8 5 -y-  000 0 x-p  010 0 x-p }
40AE: 0025 { 038 5 -y-  0F8 5 -y-  0F8 5 -y-  03A 5 -y- }
40AF: 0025 { 0F8 5 xy-  03A 5 xy-  038 5 xy-  0F8 5 xy- }
40B0: 0025 { 0A0 1 ---  0A2 1 ---  0A1 1 ---  0A3 1 --- }
40B1: 0025 { 02B 5 x--  03C 5 x--  02A 5 x--  02C 5 x-- }
40B2: 0025 { 007 5 x-p  017 5 x-p  006 5 x-p  016 5 x-p }
40B3: 0025 { 1AD 4 ---  1BD 4 ---  1AE 4 ---  1BE 4 --- }
40B4: 0130 { 02B 5 x-p  03C 5 x-p  02A 5 x-p  02C 5 x-p }
40B5: 0025 { 0F8 3 ---  2D6 0 ---  0F8 3 ---  2C5 0 x-- }
40B6: 0130 { 0E2 0 ---  18B 0 ---  0E3 0 ---  18C 0 --- }
40B7: 0130 { 0E4 0 ---  18D 0 ---  0E5 0 ---  18D 0 --- }
40B8: 0002 { 0C2 4 ---  1DC 4 ---  0C3 4 ---  1DC 4 --- }
40B9: ~
40BA: ~
40BB: ~
40BC: 0025 { 023 0 x-p  033 0 x-p  022 0 x-p  032 0 x-p }
40BD: 0025 { 021 0 x-p  031 0 x-p  020 0 x-p  030 0 x-p }
40BE: 0025 { 0F8 1 --p  038 2 --p  03A 2 --p  0F8 1 --p }
40BF: 0025 { 03A 2 x-p  0F8 1 x-p  0F8 1 x-p  038 2 x-p }
40C0: 0025 { 1E0 2 ---  1F0 2 ---  1E1 2 ---  1F1 2 --- }
40C1: 0025 { 1E2 2 ---  1F2 2 ---  1E3 2 ---  1F3 2 --- }
40C2: 0025 { 01C 2 ---  0F8 1 ---  00F 2 ---  01F 2 --- }
40C3: 0025 { 1CD 4 ---  1DD 4 ---  1CE 4 ---  1DE 4 --- }
40C4: 0025 { 0F8 1 ---  0F8 1 ---  08E 2 ---  09E 2 --- }
40C5: 0025 { 08F 2 ---  09F 2 ---  09B 2 ---  0AA 2 --- }
40C6: 0025 { 09C 2 ---  0AB 2 ---  0F8 1 ---  0F8 1 --- }
40C7: 0020 { 1B4 6 ---  1B6 6 ---  1B5 6 ---  1B7 6 --- }
40C8: 0130 { 0C2 4 ---  1DC 4 ---  0C3 4 ---  1DC 4 --- }
40C9: 0002 { 1DC 4 ---  1DC 4 ---  1DC 4 ---  1DC 4 --- }
40CA: 0025 { 000 2 ---  010 2 ---  001 2 ---  0F8 5 -y- }
40CB: 0025 { 002 2 ---  012 2 ---  0F8 5 -y-  013 2 --- }
40CC: 0025 { 0F8 6 --p  038 6 --p  03A 6 --p  0F8 6 --p }
40CD: 0025 { 03A 6 x-p  0F8 6 x-p  0F8 6 x-p  038 6 x-p }
40CE: 0025 { 038 2 -yp  0F8 1 -yp  0F8 1 -yp  03A 2 -yp }
40CF: 0025 { 0F8 1 xyp  03A 2 xyp  038 2 xyp  0F8 1 xyp }
40D0: 0025 { 0F8 1 ---  0F8 1 ---  1E4 2 ---  1E4 2 --- }
40D1: 0025 { 1F4 2 ---  1F4 2 ---  0F8 1 ---  0F8 1 --- }
40D2: 0025 { 029 2 ---  039 2 ---  0F8 1 ---  0F8 1 --- }
40D3: 0025 { 1E7 4 ---  1F7 4 ---  1E8 4 ---  1F8 4 --- }
40D4: 0025 { 0F8 1 ---  0F8 1 ---  008 2 ---  018 2 --- }
40D5: 0025 { 009 2 ---  019 2 ---  00A 2 ---  01A 2 --- }
40D6: 0025 { 00B 2 ---  01B 2 ---  0F8 1 ---  0F8 1 --- }
40D7: 0025 { 0F8 1 ---  0F8 1 ---  2C0 5 ---  2D0 5 --- }
40D8: 0025 { 2EF 5 ---  2FF 5 ---  0F8 1 ---  0F8 1 --- }
40D9: 0002 { 0C2 4 ---  1DC 4 ---  0C3 4 ---  1DC 4 --- }
40DA: 0025 { 020 2 ---  030 2 ---  021 2 ---  031 2 --- }
40DB: 0025 { 022 2 ---  032 2 ---  023 2 ---  033 2 --- }
40DC: 0025 { 038 6 -yp  0F8 6 -yp  0F8 6 -yp  03A 6 -yp }
40DD: 0025 { 0F8 6 xyp  03A 6 xyp  038 6 xyp  0F8 6 xyp }
40DE: 0130 { 1D9 4 ---  1E9 4 ---  1DA 4 ---  1EA 4 --- }
40DF: 0130 { 1DB 4 ---  1EB 4 ---  1CA 4 ---  1EC 4 --- }
40E0: 01D8 { 192 2 ---  1E6 2 x--  194 2 ---  1E5 2 x-- }
40E1: 0130 { 142 2 x--  144 2 x--  141 2 x--  115 2 x-- }
40E2: 019B { 2CC 1 ---  2DC 1 ---  2CD 1 ---  2DD 1 --- }
40E3: 0106 { 2CE 1 ---  2DE 1 ---  2CE 1 ---  2CF 1 --- }
40E4: 0106 { 2DF 1 ---  2CF 1 ---  2DF 1 x--  2CF 1 --- }
40E5: 0106 { 2CE 1 ---  2F0 1 ---  2CE 1 ---  2F1 1 --- }
40E6: 01A0 { 0B6 1 ---  2CF 1 ---  0B7 1 ---  0D7 1 --- }
40E7: 0025 { 0F1 6 ---  167 6 ---  0F2 6 ---  168 6 --- }
40E8: 0025 { 00C 2 ---  01C 2 ---  00D 2 ---  01D 2 --- }
40E9: 0025 { 028 2 ---  0EF 2 ---  0F8 1 ---  09D 2 --- }
40EA: 0130 { 1C4 4 ---  1D4 4 ---  1C1 4 ---  1D1 4 --- }
40EB: 0130 { 1C0 4 ---  1D0 4 ---  1C1 4 ---  1D1 4 --- }
40EC: 0130 { 1C2 4 ---  1D2 4 ---  1C3 4 ---  1D3 4 --- }
40ED: 0130 { 1AB 4 ---  1BB 4 ---  1AC 4 ---  1BC 4 --- }
40EE: 0130 { 1F9 4 ---  1CF 4 ---  1FA 4 ---  1DF 4 --- }
40EF: 0130 { 1FB 4 ---  099 4 ---  1FC 4 ---  09A 4 --- }
40F0: 0024 { 16A 3 ---  16B 3 ---  16A 3 x--  16B 3 x-- }
40F1: 0025 { 0F8 1 ---  0F8 1 ---  0F8 1 ---  2F5 1 --- }
40F2: 0025 { 2E4 1 ---  2F4 1 ---  2E5 1 ---  2CF 1 --- }
40F3: 0025 { 0F5 1 ---  0D4 1 ---  0F6 1 ---  0D5 1 --- }
40F4: 0025 { 0F7 1 ---  0D6 1 ---  2CF 1 ---  2CF 1 --- }
40F5: 0025 { 2CF 1 ---  2CF 1 ---  2CF 1 ---  2CF 1 --- }
40F6: 0025 { 2F6 1 ---  2CF 1 ---  0C8 1 ---  0D8 1 --- }
40F7: 0025 { 0F8 1 ---  0D9 1 ---  0F8 1 ---  0F8 1 --- }
40F8: 0025 { 088 1 ---  08B 1 ---  089 1 ---  08C 1 --- }
40F9: 0025 { 08A 1 ---  08D 1 ---  0F8 1 ---  0F8 1 --- }
40FA: 0025 { 189 2 x--  199 2 x--  188 2 x--  198 2 x-- }
40FB: 0025 { 188 2 ---  198 2 ---  189 2 ---  199 2 --- }
40FC: 0025 { 189 2 x--  199 2 x--  188 2 x--  198 2 x-- }
40FD: 0025 { 1EF 2 x--  1FF 2 x--  1EE 2 x--  1FE 2 x-- }
40FE: 0025 { 1EE 2 ---  1FE 2 ---  1EF 2 ---  1FF 2 --- }
40FF: 0025 { 188 2 ---  198 2 ---  189 2 ---  199 2 --- }
