7200: 0025 { 104 0 --p  104 0 --p  104 0 --p  104 0 --p }
7201: 0025 { 104 0 --p  104 0 --p  104 0 --p  114 0 x-p }
7202: 0130 { 103 0 x-p  113 0 x-p  102 0 x-p  112 0 x-p }
7203: 0025 { 101 0 x-p  111 0 x-p  100 0 x-p  110 0 x-p }
7204: 0025 { 100 0 --p  110 0 --p  101 0 --p  111 0 --p }
7205: 0130 { 102 0 --p  112 0 --p  103 0 --p  113 0 --p }
7206: 0025 { 104 0 --p  114 0 --p  104 0 --p  104 0 --p }
7207: 0025 { 104 0 --p  104 0 --p  104 0 --p  104 0 --p }
7208: 0025 { 16E 0 ---  16E 0 -y-  16F 0 ---  16F 0 -y- }
7209: 0025 { 16F 0 x--  16F 0 xy-  16E 0 x--  16E 0 xy- }
720A: 0025 { 15F 0 ---  104 0 --p  104 0 --p  17D 0 --- }
720B: 0025 { 104 0 --p  104 0 --p  104 0 --p  15F 0 xy- }
720C: 0025 { 17D 0 -y-  104 0 --p  104 0 --p  104 0 --p }
720D: 0025 { 104 0 --p  104 0 --p  104 0 --p  126 0 --- }
720E: 0025 { 104 0 x-p  126 0 x--  104 0 x-p  104 0 x-p }
720F: 0025 { 17E 0 ---  104 0 --p  17E 0 x--  104 0 --p }
7210: 0025 { 104 0 --p  104 0 --p  104 0 --p  104 0 --p }
7211: 0025 { 104 0 --p  135 0 x-p  124 0 x-p  134 0 x-p }
7212: 0130 { 123 0 x-p  133 0 x-p  122 0 x-p  132 0 x-p }
7213: 0025 { 121 0 x-p  131 0 x-p  120 0 x-p  130 0 x-p }
7214: 0025 { 120 0 --p  130 0 --p  121 0 --p  131 0 --p }
7215: 0130 { 122 0 --p  132 0 --p  123 0 --p  133 0 --p }
7216: 0025 { 124 0 --p  134 0 --p  104 0 --p  135 0 --p }
7217: 0025 { 104 0 --p  104 0 --p  104 0 --p  104 0 --p }
7218: 0025 { 104 0 --p  104 0 --p  117 0 ---  127 0 --- }
7219: 0025 { 117 0 x--  127 0 x--  104 0 x-p  104 0 x-p }
721A: 0130 { 104 0 --p  104 0 --p  104 0 --p  104 0 --p }
721B: 0130 { 12A 2 ---  13A 2 ---  12B 2 ---  13B 2 --- }
721C: 0130 { 16A 2 ---  17A 2 ---  16B 2 ---  17B 2 --- }
721D: 0025 { 13C 4 ---  14C 4 ---  13D 4 ---  14D 4 --- }
721E: 0025 { 13E 4 ---  14E 4 ---  13F 4 ---  14F 4 --- }
721F: ~
7220: 0025 { 104 0 --p  157 0 x-p  146 0 x-p  156 0 x-p }
7221: 0130 { 145 0 x-p  155 0 x-p  144 0 x-p  154 0 x-p }
7222: 0130 { 143 0 x-p  153 0 x-p  142 0 x-p  152 0 x-p }
7223: 0025 { 141 0 x-p  151 0 x-p  140 0 x-p  150 0 x-p }
7224: 0025 { 140 0 --p  150 0 --p  141 0 --p  151 0 --p }
7225: 0130 { 142 0 --p  152 0 --p  143 0 --p  153 0 --p }
7226: 0130 { 144 0 --p  154 0 --p  145 0 --p  155 0 --p }
7227: 0025 { 146 0 --p  156 0 --p  104 0 --p  157 0 --p }
7228: 0025 { 104 0 --p  104 0 --p  137 0 ---  147 0 --- }
7229: 0025 { 137 0 x--  147 0 x--  104 0 x-p  104 0 x-p }
722A: 0025 { 200 3 ---  210 3 ---  201 3 ---  211 3 --- }
722B: 0025 { 202 3 ---  212 3 ---  203 3 ---  213 3 --- }
722C: 0025 { 260 3 ---  270 3 ---  261 3 ---  271 3 --- }
722D: 0025 { 222 3 ---  232 3 ---  223 3 ---  233 3 --- }
722E: 0025 { 0F8 1 ---  0F8 1 ---  204 3 ---  214 3 --- }
722F: 0025 { 205 3 ---  215 3 ---  0F8 1 ---  0F8 1 --- }
7230: 0025 { 167 0 x-p  177 0 x-p  166 0 x-p  176 0 x-p }
7231: 0130 { 165 0 x-p  175 0 x-p  164 0 x-p  174 0 x-p }
7232: 0130 { 163 0 x-p  173 0 x-p  162 0 x-p  172 0 x-p }
7233: 0025 { 161 0 x-p  171 0 x-p  160 0 x-p  170 0 x-p }
7234: 0025 { 160 0 --p  170 0 --p  161 0 --p  171 0 --p }
7235: 0130 { 162 0 --p  172 0 --p  163 0 --p  173 0 --p }
7236: 0130 { 164 0 --p  174 0 --p  165 0 --p  175 0 --p }
7237: 0025 { 166 0 --p  176 0 --p  167 0 --p  177 0 --p }
7238: 0025 { 104 0 --p  104 0 --p  115 0 ---  104 0 --p }
7239: 0025 { 116 0 ---  104 0 --p  104 0 --p  104 0 --p }
723A: 0025 { 220 3 ---  230 3 ---  221 3 ---  231 3 --- }
723B: 0025 { 222 3 ---  232 3 ---  223 3 ---  233 3 --- }
723C: 0025 { 242 3 ---  252 3 ---  243 3 ---  253 3 --- }
723D: 0025 { 222 3 ---  232 3 ---  223 3 ---  233 3 --- }
723E: 0025 { 0F8 1 ---  0F8 1 ---  224 3 ---  234 3 --- }
723F: 0025 { 225 3 ---  235 3 ---  0F8 1 ---  0F8 1 --- }
7240: 0025 { 10F 0 x-p  11F 0 x-p  10E 0 x-p  11E 0 x-p }
7241: 0130 { 10D 0 x-p  11D 0 x-p  10C 0 x-p  11C 0 x-p }
7242: 0130 { 10B 0 x-p  11B 0 x-p  10A 0 x-p  11A 0 x-p }
7243: 0025 { 109 0 x-p  119 0 x-p  108 0 x-p  118 0 x-p }
7244: 0025 { 108 0 --p  118 0 --p  109 0 --p  119 0 --p }
7245: 0130 { 10A 0 --p  11A 0 --p  10B 0 --p  11B 0 --p }
7246: 0130 { 10C 0 --p  11C 0 --p  10D 0 --p  11D 0 --p }
7247: 0025 { 10E 0 --p  11E 0 --p  10F 0 --p  11F 0 --p }
7248: 0025 { 0F8 1 ---  0F8 1 ---  0F8 1 ---  2A8 2 --- }
7249: 0025 { 0F8 1 ---  2B8 2 ---  0F8 1 ---  0F8 1 --- }
724A: 0025 { 240 3 ---  250 3 ---  241 3 ---  251 3 --- }
724B: 0025 { 222 3 ---  232 3 ---  223 3 ---  233 3 --- }
724C: 0025 { 262 3 ---  272 3 ---  263 3 ---  273 3 --- }
724D: 0025 { 222 3 ---  232 3 ---  223 3 ---  233 3 --- }
724E: 0025 { 0F8 1 ---  0F8 1 ---  244 3 ---  254 3 --- }
724F: 0025 { 245 3 ---  255 3 ---  0F8 1 ---  0F8 1 --- }
7250: 0025 { 12F 0 x-p  13F 0 x-p  12E 0 x-p  13E 0 x-p }
7251: 0130 { 12D 0 x-p  13D 0 x-p  12C 0 x-p  13C 0 x-p }
7252: 0130 { 12B 0 x-p  13B 0 x-p  12A 0 x-p  13A 0 x-p }
7253: 0025 { 129 0 x-p  139 0 x-p  128 0 x-p  138 0 x-p }
7254: 0025 { 128 0 --p  138 0 --p  129 0 --p  139 0 --p }
7255: 0130 { 12A 0 --p  13A 0 --p  12B 0 --p  13B 0 --p }
7256: 0130 { 12C 0 --p  13C 0 --p  12D 0 --p  13D 0 --p }
7257: 0025 { 12E 0 --p  13E 0 --p  12F 0 --p  13F 0 --p }
7258: 0025 { 0F8 1 ---  0F8 1 ---  2C8 2 ---  2D8 2 --- }
7259: 0025 { 280 2 ---  2B1 2 ---  285 2 ---  2B2 2 --- }
725A: 0025 { 286 2 ---  2B3 2 ---  287 2 ---  2B4 2 --- }
725B: 0025 { 287 2 x--  2B4 2 x--  286 2 x--  2B3 2 x-- }
725C: 0025 { 285 2 x--  2B2 2 x--  297 2 ---  2B5 2 --- }
725D: 0025 { 2A7 2 ---  2B6 2 ---  0F8 1 ---  0F8 1 --- }
725E: 0025 { 0F8 1 ---  0F8 1 ---  264 3 ---  274 3 --- }
725F: 0025 { 265 3 ---  275 3 ---  0F8 1 ---  0F8 1 --- }
7260: 0025 { 14F 0 x-p  104 0 --p  14E 0 x-p  15E 0 x-p }
7261: 0025 { 14D 0 x-p  15D 0 x-p  14C 0 x-p  15C 0 x-p }
7262: 0130 { 14B 0 x-p  15B 0 x-p  14A 0 x-p  15A 0 x-p }
7263: 0025 { 149 0 x-p  159 0 x-p  148 0 x-p  158 0 x-p }
7264: 0025 { 148 0 --p  158 0 --p  149 0 --p  159 0 --p }
7265: 0130 { 14A 0 --p  15A 0 --p  14B 0 --p  15B 0 --p }
7266: 0025 { 14C 0 --p  15C 0 --p  14D 0 --p  15D 0 --p }
7267: 0025 { 14E 0 --p  15E 0 --p  14F 0 --p  104 0 --p }
7268: 0025 { 0F8 1 ---  0F8 1 ---  2E8 2 ---  2F8 2 --- }
7269: 0025 { 2E8 2 x--  2F8 2 x--  288 1 ---  298 1 --- }
726A: 0025 { 289 1 ---  299 1 ---  28A 1 ---  29A 1 --- }
726B: 0025 { 28B 1 ---  29B 1 ---  28C 1 ---  29C 1 --- }
726C: 0025 { 28D 1 ---  29D 1 ---  0F8 1 ---  0F8 1 --- }
726D: 0025 { 206 3 ---  216 3 ---  207 3 ---  217 3 --- }
726E: 0025 { 208 3 ---  218 3 ---  209 3 ---  219 3 --- }
726F: 0025 { 0F8 3 ---  0DF 3 x--  0F8 3 ---  0DF 3 --- }
7270: 0025 { 104 0 --p  104 0 --p  104 0 --p  104 0 --p }
7271: 0025 { 16D 0 x-p  104 0 --p  16C 0 x-p  17C 0 x-p }
7272: 0025 { 16B 0 x-p  17B 0 x-p  16A 0 x-p  17A 0 x-p }
7273: 0130 { 169 0 x-p  179 0 x-p  168 0 x-p  178 0 x-p }
7274: 0130 { 168 0 --p  178 0 --p  169 0 --p  179 0 --p }
7275: 0025 { 16A 0 --p  17A 0 --p  16B 0 --p  17B 0 --p }
7276: 0025 { 16C 0 --p  17C 0 --p  16D 0 --p  104 0 --p }
7277: 0025 { 104 0 --p  104 0 --p  104 0 --p  104 0 --p }
7278: 0025 { 0F8 1 ---  0F8 1 ---  2F8 2 ---  2F8 2 --- }
7279: 0025 { 2F8 2 x--  2F8 2 x--  0F8 1 ---  0F8 1 --- }
727A: 0025 { 2B0 1 ---  0F8 1 ---  2C0 1 ---  2D0 1 --- }
727B: 0025 { 2C1 1 ---  2D1 1 ---  2B0 1 x--  0F8 1 --- }
727C: 0025 { 0F4 2 ---  0E8 2 ---  0F5 2 ---  0E9 2 --- }
727D: 0025 { 226 3 ---  236 3 ---  227 3 ---  237 3 --- }
727E: 0025 { 228 3 ---  238 3 ---  229 3 ---  239 3 --- }
727F: 0130 { 0AC 6 ---  0CE 6 ---  0AD 6 ---  0CF 6 --- }
7280: 0130 { 104 0 --p  104 0 --p  104 0 --p  104 0 --p }
7281: 0130 { 104 0 --p  104 0 --p  104 0 --p  104 0 --p }
7282: 0130 { 104 0 --p  104 0 --p  107 0 x-p  104 0 --p }
7283: 0130 { 106 0 x-p  104 0 --p  105 0 x-p  104 0 --p }
7284: 0130 { 105 0 --p  104 0 --p  106 0 --p  104 0 --p }
7285: 0130 { 107 0 --p  104 0 --p  104 0 --p  104 0 --p }
7286: 0130 { 104 0 --p  104 0 --p  104 0 --p  104 0 --p }
7287: 0130 { 104 0 --p  104 0 --p  104 0 --p  104 0 --p }
7288: 0025 { 2CF 6 ---  2DF 6 ---  0F8 4 x--  0F8 4 x-- }
7289: 0025 { 20A 3 ---  21A 3 ---  20B 3 ---  21B 3 --- }
728A: 0025 { 20C 3 ---  21C 3 ---  20D 3 ---  21D 3 --- }
728B: 0025 { 20D 3 ---  24A 3 ---  20D 3 ---  24B 3 --- }
728C: 0025 { 20D 3 ---  24C 3 ---  20D 3 ---  24D 3 --- }
728D: 0025 { 246 3 ---  256 3 ---  247 3 ---  257 3 --- }
728E: 0025 { 248 3 ---  258 3 ---  249 3 ---  259 3 --- }
728F: 0130 { 0AE 6 ---  0CE 6 ---  0AF 6 ---  0CF 6 --- }
7290: 0130 { 104 0 --p  104 0 --p  104 0 --p  104 0 --p }
7291: 0130 { 104 0 --p  104 0 --p  104 0 --p  104 0 --p }
7292: 0130 { 104 0 --p  104 0 --p  104 0 --p  104 0 --p }
7293: 0130 { 104 0 --p  104 0 --p  104 0 --p  104 0 --p }
7294: 0130 { 104 0 --p  104 0 --p  104 0 --p  104 0 --p }
7295: 0130 { 104 0 --p  104 0 --p  104 0 --p  104 0 --p }
7296: 0130 { 104 0 --p  104 0 --p  104 0 --p  104 0 --p }
7297: 0130 { 104 0 --p  104 0 --p  104 0 --p  104 0 --p }
7298: 0025 { 0DF 6 ---  0FF 6 ---  0F8 4 x--  0F8 4 x-- }
7299: 0025 { 22A 3 ---  23A 3 ---  22B 3 ---  23B 3 --- }
729A: 0025 { 22C 3 ---  23C 3 ---  22D 3 ---  23D 3 --- }
729B: 0025 { 25A 3 ---  26A 3 ---  25B 3 ---  26B 3 --- }
729C: 0025 { 25C 3 ---  26C 3 ---  25D 3 ---  26D 3 --- }
729D: 0025 { 266 3 ---  276 3 ---  267 3 ---  277 3 --- }
729E: 0025 { 268 3 ---  278 3 ---  269 3 ---  279 3 --- }
729F: 0130 { 0AE 6 ---  0BC 6 ---  0AF 6 ---  0BD 6 --- }
72A0: 0130 { 1C6 7 x--  1D6 7 x--  1C5 7 x--  1D5 7 x-- }
72A1: 0130 { 1C1 7 ---  180 2 ---  1E4 7 ---  183 2 --- }
72A2: 0025 { 248 5 ---  258 5 ---  249 5 ---  259 5 --- }
72A3: 0025 { 24A 5 ---  25A 5 ---  0F8 5 x--  0F8 5 x-- }
72A4: 0025 { 248 4 ---  258 4 ---  249 4 ---  259 4 --- }
72A5: 0025 { 24A 4 ---  25A 4 ---  0F8 5 x--  0F8 5 x-- }
72A6: 0025 { 0F8 5 x--  0F8 5 x--  0F8 5 x--  255 5 --- }
72A7: 0025 { 246 5 ---  256 5 ---  247 5 ---  257 5 --- }
72A8: 0025 { 248 5 ---  258 5 ---  249 5 ---  259 5 --- }
72A9: 0025 { 24A 5 ---  25A 5 ---  0F8 5 x--  0F8 5 x-- }
72AA: 0130 { 208 3 ---  218 3 ---  209 3 ---  219 3 --- }
72AB: 0130 { 20A 3 ---  21A 3 ---  20B 3 ---  21B 3 --- }
72AC: 0130 { 22C 2 ---  23C 2 ---  22D 2 ---  23D 2 --- }
72AD: 0130 { 22D 2 x--  23D 2 x--  22C 2 x--  23C 2 x-- }
72AE: 0130 { 193 2 ---  193 2 ---  192 2 ---  0CB 2 x-- }
72AF: 0130 { 0CA 2 x--  195 2 ---  193 2 ---  193 2 --- }
72B0: 0130 { 1E6 7 x--  183 2 x--  1E5 7 x--  182 2 x-- }
72B1: 0130 { 1EB 7 ---  182 2 ---  1C2 7 ---  180 2 x-- }
72B2: 0025 { 0F8 5 x--  0F8 5 x--  0F8 5 x--  255 5 --- }
72B3: 0025 { 246 5 ---  256 5 ---  247 5 ---  257 5 --- }
72B4: 0025 { 0F8 5 x--  0F8 5 x--  0F8 5 ---  255 4 --- }
72B5: 0025 { 246 4 ---  256 4 ---  247 4 ---  257 4 --- }
72B6: 0025 { 0F8 5 x--  0F8 5 x--  2FE 5 -y-  2EE 5 -y- }
72B7: 0025 { 2FF 5 -y-  2EF 5 -y-  0F8 5 x--  0F8 5 x-- }
72B8: 003F { 194 2 ---  192 2 ---  195 2 ---  193 2 --- }
72B9: 0025 { 19A 2 xy-  1BF 2 ---  19A 2 xy-  19A 2 xy- }
72BA: 0130 { 228 3 ---  238 3 ---  26A 3 ---  239 3 --- }
72BB: 0130 { 22A 3 ---  23A 3 ---  22B 3 ---  23B 3 --- }
72BC: 0130 { 22E 2 ---  194 2 ---  22F 2 ---  194 2 --- }
72BD: 0130 { 22F 2 x--  194 2 ---  22E 2 x--  194 2 --- }
72BE: 0130 { 192 2 -y-  182 2 -y-  193 2 -y-  183 2 -y- }
72BF: 0130 { 204 3 ---  214 3 ---  207 3 ---  217 3 --- }
72C0: 0025 { 0F8 5 x--  0F8 5 x--  0F8 5 ---  0F8 5 --- }
72C1: 0025 { 0F8 5 ---  295 4 ---  0E3 4 ---  296 4 --- }
72C2: 0025 { 0F8 5 ---  297 4 ---  0F8 5 x--  0F8 5 x-- }
72C3: 0025 { 0F8 5 x--  0F8 5 x--  2E8 4 x--  2F8 4 x-- }
72C4: 0025 { 2E7 4 x--  2F7 4 x--  0F8 5 ---  2F1 4 x-- }
72C5: 0025 { 0F8 5 ---  2F0 4 x--  0F8 5 x--  0F8 5 x-- }
72C6: 0025 { 247 5 x--  257 5 x--  246 5 x--  256 5 x-- }
72C7: 0025 { 0F8 5 ---  255 5 x--  0F8 5 ---  0F8 5 --- }
72C8: 0025 { 1AC 2 ---  1BC 2 ---  1A1 2 ---  1B1 2 --- }
72C9: 0025 { 19A 2 xy-  19A 2 xy-  1BF 2 ---  19A 2 xy- }
72CA: 0025 { 19A 2 xy-  189 2 ---  1BF 2 ---  19A 2 xy- }
72CB: 0025 { 0F8 5 ---  0F8 5 ---  0F8 5 x--  2F0 4 --- }
72CC: 0025 { 0F8 5 x--  2F1 4 ---  2E7 4 ---  2F7 4 --- }
72CD: 0025 { 2E8 4 ---  2F8 4 ---  0F8 5 ---  0F8 5 --- }
72CE: 0130 { 2C7 3 ---  182 2 ---  2FB 3 ---  180 2 x-- }
72CF: 0130 { 234 3 ---  180 2 ---  237 3 ---  183 2 --- }
72D0: 0025 { 0F8 5 x--  0F8 5 x--  0F8 5 ---  0F8 5 --- }
72D1: 0025 { 2A5 4 ---  0E1 4 ---  2A6 4 ---  0E2 4 --- }
72D2: 0025 { 2A7 4 ---  0F8 5 ---  0F8 5 x--  0F8 5 x-- }
72D3: 0025 { 0F8 5 x--  0F8 5 x--  2B1 4 xy-  2A1 4 xy- }
72D4: 0025 { 2B0 4 xy-  2A0 4 xy-  0F8 5 x--  0F8 5 x-- }
72D5: 0130 { 194 2 ---  192 2 ---  24C 2 ---  25C 2 --- }
72D6: 0130 { 24D 2 ---  25D 2 ---  195 2 ---  193 2 --- }
72D7: 0130 { 194 2 ---  192 2 ---  22C 2 ---  23C 2 --- }
72D8: 0130 { 22D 2 ---  23D 2 ---  195 2 ---  193 2 --- }
72D9: 0130 { 192 2 ---  0CA 2 ---  193 2 ---  193 2 --- }
72DA: 0130 { 194 2 ---  24C 2 ---  194 2 ---  24D 2 --- }
72DB: 0130 { 194 2 ---  24D 2 x--  194 2 ---  24C 2 x-- }
72DC: 0130 { 194 2 ---  22C 2 ---  194 2 ---  22D 2 --- }
72DD: 0130 { 194 2 ---  22D 2 x--  194 2 ---  22C 2 x-- }
72DE: 0130 { 194 2 ---  192 2 ---  22D 2 x--  23D 2 x-- }
72DF: 0130 { 22C 2 x--  23C 2 x--  195 2 ---  193 2 --- }
72E0: 0025 { 0F8 5 x--  0F8 5 x--  2D9 4 ---  2D6 4 --- }
72E1: 0025 { 2DA 4 ---  2D7 4 ---  2DB 4 ---  2D8 4 --- }
72E2: 0025 { 0F8 5 ---  2F0 4 x--  0F8 5 x--  0F8 5 x-- }
72E3: 0025 { 0F8 5 x--  0F8 5 x--  291 4 xy-  085 4 xy- }
72E4: 0025 { 290 4 xy-  084 4 xy-  0F8 5 x--  0F8 5 x-- }
72E5: 0130 { 194 2 ---  192 2 ---  24D 2 x--  25D 2 x-- }
72E6: 0130 { 24C 2 x--  25C 2 x--  195 2 ---  193 2 --- }
72E7: 0130 { 194 2 ---  192 2 ---  22E 2 ---  194 2 --- }
72E8: 0130 { 22F 2 ---  194 2 ---  195 2 ---  193 2 --- }
72E9: 0130 { 192 2 ---  0CB 2 ---  193 2 ---  193 2 --- }
72EA: 0130 { 25C 2 ---  192 2 ---  25D 2 ---  192 2 --- }
72EB: 0130 { 25D 2 x--  192 2 ---  25C 2 x--  192 2 --- }
72EC: 0130 { 23C 2 ---  22E 2 ---  23D 2 ---  22F 2 --- }
72ED: 0130 { 23D 2 x--  22F 2 x--  23C 2 x--  22E 2 x-- }
72EE: 0130 { 194 2 ---  192 2 ---  22F 2 x--  194 2 --- }
72EF: 0130 { 22E 2 x--  194 2 ---  195 2 ---  193 2 --- }
72F0: 0130 { 234 3 ---  182 2 ---  237 3 ---  180 2 x-- }
72F1: 0130 { 1C1 7 ---  183 2 x--  1E4 7 ---  182 2 x-- }
72F2: 0130 { 1EB 7 ---  183 2 x--  1C2 7 ---  182 2 x-- }
72F3: 0130 { 22E 2 ---  194 2 ---  22F 2 ---  0CA 2 --- }
72F4: 0130 { 2C7 3 ---  180 2 ---  2FB 3 ---  183 2 --- }
72F5: 0025 { 2EE 5 ---  2FE 5 ---  2EF 5 ---  2FF 5 --- }
72F6: 0025 { 0F8 5 ---  0F8 5 ---  0EE 6 ---  0FE 6 --- }
72F7: 0025 { 0EF 6 ---  0FF 6 ---  0F8 5 ---  0F8 5 --- }
72F8: 0025 { 0F8 5 x--  0F8 5 ---  2BF 6 x--  0DE 6 --- }
72F9: 0025 { 2BE 6 x--  0DF 6 ---  0F8 5 x--  0F8 5 --- }
72FA: 0025 { 0F8 5 ---  0F8 5 ---  0F8 5 ---  1F7 2 --- }
72FB: 0025 { 1FA 3 ---  1F8 2 ---  1F6 2 ---  1F9 2 --- }
72FC: 0130 { 0AC 6 ---  0BC 6 ---  08F 6 ---  0EF 6 --- }
72FD: 0130 { 0DE 6 ---  0EE 6 ---  08F 6 ---  0EF 6 --- }
72FE: 0130 { 0DE 6 ---  0EE 6 ---  0AD 6 ---  0BD 6 --- }
72FF: ~
