1900: 0020 { 0D3 2 x--  0E3 2 x--  0D2 2 x--  0E2 2 x-- }
1901: 0020 { 0D2 2 ---  0E2 2 ---  0D3 2 ---  0E3 2 --- }
1902: 0020 { 0D3 2 x--  0E3 2 x--  0D2 2 x--  0E2 2 x-- }
1903: 0020 { 0D2 2 ---  0E2 2 ---  0D3 2 ---  0E3 2 --- }
1904: 0020 { 0D3 2 x--  0E3 2 x--  0D2 2 x--  0E2 2 x-- }
1905: 0020 { 0D2 2 ---  0E2 2 ---  0D3 2 ---  0E3 2 --- }
1906: 0020 { 0D3 2 x--  0E3 2 x--  0D2 2 x--  0E2 2 x-- }
1907: 0020 { 0D2 2 ---  0E2 2 ---  0D3 2 ---  0E3 2 --- }
1908: 0020 { 0D3 2 x--  0E3 2 x--  0D2 2 x--  0E2 2 x-- }
1909: 0020 { 0D2 2 ---  0E2 2 ---  0D3 2 ---  0E3 2 --- }
190A: 0020 { 0D3 2 x--  0E3 2 x--  0D2 2 x--  0E2 2 x-- }
190B: 0020 { 0D2 2 ---  0E2 2 ---  0D3 2 ---  0E3 2 --- }
190C: 0020 { 0D3 2 x--  0E3 2 x--  0D2 2 x--  0E2 2 x-- }
190D: 0020 { 0D2 2 ---  0E2 2 ---  0D3 2 ---  0E3 2 --- }
190E: 0020 { 0D3 2 x--  0E3 2 x--  0D2 2 x--  0E2 2 x-- }
190F: 0020 { 0D2 2 ---  0E2 2 ---  0D3 2 ---  0E3 2 --- }
1910: 0020 { 0F3 2 x--  0F3 2 xy-  0F2 2 x--  0F2 2 xy- }
1911: 0020 { 0F2 2 ---  0F2 2 -y-  0F3 2 ---  0F3 2 -y- }
1912: 0020 { 0F3 2 x--  0F3 2 xy-  0F2 2 x--  0F2 2 xy- }
1913: 0020 { 0F2 2 ---  0F2 2 -y-  0F3 2 ---  0F3 2 -y- }
1914: 0020 { 0F3 2 x--  0F3 2 xy-  0F2 2 x--  0F2 2 xy- }
1915: 0020 { 0F2 2 ---  0F2 2 -y-  0F3 2 ---  0F3 2 -y- }
1916: 0020 { 0F3 2 x--  0F3 2 xy-  0F2 2 x--  0F2 2 xy- }
1917: 0020 { 0F2 2 ---  0F2 2 -y-  0F3 2 ---  0F3 2 -y- }
1918: 0020 { 0F3 2 x--  0F3 2 xy-  0F2 2 x--  0F2 2 xy- }
1919: 0020 { 0F2 2 ---  0F2 2 -y-  0F3 2 ---  0F3 2 -y- }
191A: 0020 { 0F3 2 x--  0F3 2 xy-  0F2 2 x--  0F2 2 xy- }
191B: 0020 { 0F2 2 ---  0F2 2 -y-  0F3 2 ---  0F3 2 -y- }
191C: 0020 { 0F3 2 x--  0F3 2 xy-  0F2 2 x--  0F2 2 xy- }
191D: 0020 { 0F2 2 ---  0F2 2 -y-  0F3 2 ---  0F3 2 -y- }
191E: 0020 { 0F3 2 x--  0F3 2 xy-  0F2 2 x--  0F2 2 xy- }
191F: 0020 { 0F2 2 ---  0F2 2 -y-  0F3 2 ---  0F3 2 -y- }
1920: 0020 { 0E3 2 xy-  0D3 2 xy-  0E2 2 xy-  0D2 2 xy- }
1921: 0020 { 0E2 2 -y-  0D2 2 -y-  0E3 2 -y-  0D3 2 -y- }
1922: 0020 { 0E3 2 xy-  0D3 2 xy-  0E2 2 xy-  0D2 2 xy- }
1923: 0020 { 0E2 2 -y-  0D2 2 -y-  0E3 2 -y-  0D3 2 -y- }
1924: 0020 { 0E3 2 xy-  0D3 2 xy-  0E2 2 xy-  0D2 2 xy- }
1925: 0020 { 0E2 2 -y-  0D2 2 -y-  0E3 2 -y-  0D3 2 -y- }
1926: 0020 { 0E3 2 xy-  0D3 2 xy-  0E2 2 xy-  0D2 2 xy- }
1927: 0020 { 0E2 2 -y-  0D2 2 -y-  0E3 2 -y-  0D3 2 -y- }
1928: 0020 { 0E3 2 xy-  0D3 2 xy-  0E2 2 xy-  0D2 2 xy- }
1929: 0020 { 0E2 2 -y-  0D2 2 -y-  0E3 2 -y-  0D3 2 -y- }
192A: 0020 { 0E3 2 xy-  0D3 2 xy-  0E2 2 xy-  0D2 2 xy- }
192B: 0020 { 0E2 2 -y-  0D2 2 -y-  0E3 2 -y-  0D3 2 -y- }
192C: 0020 { 0E3 2 xy-  0D3 2 xy-  0E2 2 xy-  0D2 2 xy- }
192D: 0020 { 0E2 2 -y-  0D2 2 -y-  0E3 2 -y-  0D3 2 -y- }
192E: 0020 { 0E3 2 xy-  0D3 2 xy-  0E2 2 xy-  0D2 2 xy- }
192F: 0020 { 0E2 2 -y-  0D2 2 -y-  0E3 2 -y-  0D3 2 -y- }
1930: 0020 { 0D3 2 x--  0E3 2 x--  0D2 2 x--  0E2 2 x-- }
1931: 0020 { 0D2 2 ---  0E2 2 ---  0D3 2 ---  0E3 2 --- }
1932: 0020 { 0D3 2 x--  0E3 2 x--  0D2 2 x--  0E2 2 x-- }
1933: 0020 { 0D2 2 ---  0E2 2 ---  0D3 2 ---  0E3 2 --- }
1934: 0020 { 0D3 2 x--  0E3 2 x--  0D2 2 x--  0E2 2 x-- }
1935: 0020 { 0D2 2 ---  0E2 2 ---  0D3 2 ---  0E3 2 --- }
1936: 0020 { 0D3 2 x--  0E3 2 x--  0D2 2 x--  0E2 2 x-- }
1937: 0020 { 0D2 2 ---  0E2 2 ---  0D3 2 ---  0E3 2 --- }
1938: 0020 { 0D3 2 x--  0E3 2 x--  0D2 2 x--  0E2 2 x-- }
1939: 0020 { 0D2 2 ---  0E2 2 ---  0D3 2 ---  0E3 2 --- }
193A: 0020 { 0D3 2 x--  0E3 2 x--  0D2 2 x--  0E2 2 x-- }
193B: 0020 { 0D2 2 ---  0E2 2 ---  0D3 2 ---  0E3 2 --- }
193C: 0020 { 0D3 2 x--  0E3 2 x--  0D2 2 x--  0E2 2 x-- }
193D: 0020 { 0D2 2 ---  0E2 2 ---  0D3 2 ---  0E3 2 --- }
193E: ~
193F: ~
1940: 0020 { 0F3 2 x--  0F3 2 xy-  0F2 2 x--  0F2 2 xy- }
1941: 0020 { 0F2 2 ---  0F2 2 -y-  0F3 2 ---  0F3 2 -y- }
1942: 0020 { 0F3 2 x--  0F3 2 xy-  0F2 2 x--  0F2 2 xy- }
1943: 0020 { 0F2 2 ---  0F2 2 -y-  0F3 2 ---  0F3 2 -y- }
1944: 0020 { 0F3 2 x--  0F3 2 xy-  0F2 2 x--  0F2 2 xy- }
1945: 0020 { 0F2 2 ---  0F2 2 -y-  0F3 2 ---  0F3 2 -y- }
1946: 0020 { 0F3 2 x--  0F3 2 xy-  0F2 2 x--  0F2 2 xy- }
1947: 0020 { 0F2 2 ---  0F2 2 -y-  0F3 2 ---  0F3 2 -y- }
1948: 0020 { 0F3 2 x--  0F3 2 xy-  0F2 2 x--  0F2 2 xy- }
1949: 0020 { 0F2 2 ---  0F2 2 -y-  0F3 2 ---  0F3 2 -y- }
194A: 0020 { 0F3 2 x--  0F3 2 xy-  0F2 2 x--  0F2 2 xy- }
194B: 0020 { 0F2 2 ---  0F2 2 -y-  0F3 2 ---  0F3 2 -y- }
194C: 0020 { 0F3 2 x--  0F3 2 xy-  0F2 2 x--  0F2 2 xy- }
194D: 0020 { 0F2 2 ---  0F2 2 -y-  0F3 2 ---  0F3 2 -y- }
194E: ~
194F: ~
1950: 0020 { 0E3 2 xy-  0D3 2 xy-  0E2 2 xy-  0D2 2 xy- }
1951: 0020 { 0E2 2 -y-  0D2 2 -y-  0E3 2 -y-  0D3 2 -y- }
1952: 0020 { 0E3 2 xy-  0D3 2 xy-  0E2 2 xy-  0D2 2 xy- }
1953: 0020 { 0E2 2 -y-  0D2 2 -y-  0E3 2 -y-  0D3 2 -y- }
1954: 0020 { 0E3 2 xy-  0D3 2 xy-  0E2 2 xy-  0D2 2 xy- }
1955: 0020 { 0E2 2 -y-  0D2 2 -y-  0E3 2 -y-  0D3 2 -y- }
1956: 0020 { 0E3 2 xy-  0D3 2 xy-  0E2 2 xy-  0D2 2 xy- }
1957: 0020 { 0E2 2 -y-  0D2 2 -y-  0E3 2 -y-  0D3 2 -y- }
1958: 0020 { 0E3 2 xy-  0D3 2 xy-  0E2 2 xy-  0D2 2 xy- }
1959: 0020 { 0E2 2 -y-  0D2 2 -y-  0E3 2 -y-  0D3 2 -y- }
195A: 0020 { 0E3 2 xy-  0D3 2 xy-  0E2 2 xy-  0D2 2 xy- }
195B: 0020 { 0E2 2 -y-  0D2 2 -y-  0E3 2 -y-  0D3 2 -y- }
195C: 0020 { 0E3 2 xy-  0D3 2 xy-  0E2 2 xy-  0D2 2 xy- }
195D: 0020 { 0E2 2 -y-  0D2 2 -y-  0E3 2 -y-  0D3 2 -y- }
195E: ~
195F: ~
1960: ~
1961: ~
1962: ~
1963: ~
1964: ~
1965: ~
1966: ~
1967: ~
1968: ~
1969: ~
196A: ~
196B: ~
196C: ~
196D: ~
196E: ~
196F: ~
1970: ~
1971: ~
1972: ~
1973: ~
1974: ~
1975: ~
1976: ~
1977: ~
1978: ~
1979: ~
197A: ~
197B: ~
197C: ~
197D: ~
197E: ~
197F: ~
1980: ~
1981: ~
1982: ~
1983: ~
1984: ~
1985: ~
1986: ~
1987: ~
1988: ~
1989: ~
198A: ~
198B: ~
198C: ~
198D: ~
198E: ~
198F: ~
1990: ~
1991: ~
1992: ~
1993: ~
1994: ~
1995: ~
1996: ~
1997: ~
1998: ~
1999: ~
199A: ~
199B: ~
199C: ~
199D: ~
199E: ~
199F: ~
19A0: ~
19A1: ~
19A2: ~
19A3: ~
19A4: ~
19A5: ~
19A6: ~
19A7: ~
19A8: ~
19A9: ~
19AA: ~
19AB: ~
19AC: ~
19AD: ~
19AE: ~
19AF: ~
19B0: ~
19B1: ~
19B2: ~
19B3: ~
19B4: ~
19B5: ~
19B6: ~
19B7: ~
19B8: ~
19B9: ~
19BA: ~
19BB: ~
19BC: ~
19BD: ~
19BE: ~
19BF: ~
19C0: ~
19C1: ~
19C2: ~
19C3: ~
19C4: ~
19C5: ~
19C6: ~
19C7: ~
19C8: ~
19C9: ~
19CA: ~
19CB: ~
19CC: ~
19CD: ~
19CE: ~
19CF: ~
19D0: ~
19D1: ~
19D2: ~
19D3: ~
19D4: ~
19D5: ~
19D6: ~
19D7: ~
19D8: ~
19D9: ~
19DA: ~
19DB: ~
19DC: ~
19DD: ~
19DE: ~
19DF: ~
19E0: ~
19E1: ~
19E2: ~
19E3: ~
19E4: ~
19E5: ~
19E6: ~
19E7: ~
19E8: ~
19E9: ~
19EA: ~
19EB: ~
19EC: ~
19ED: ~
19EE: ~
19EF: ~
19F0: ~
19F1: ~
19F2: ~
19F3: ~
19F4: ~
19F5: ~
19F6: ~
19F7: ~
19F8: ~
19F9: ~
19FA: ~
19FB: ~
19FC: ~
19FD: ~
19FE: ~
19FF: 0025 { 0F8 4 ---  0F8 4 ---  0F8 4 ---  0F8 4 --- }
