7300: 0130 { 288 3 ---  290 3 ---  289 3 ---  291 3 --- }
7301: 0130 { 28A 3 ---  292 3 ---  28D 3 ---  293 3 --- }
7302: 0130 { 2C0 3 ---  2D0 3 ---  2C1 3 ---  2D1 3 --- }
7303: 0130 { 2C2 3 ---  2D2 3 ---  2C3 3 ---  2D3 3 --- }
7304: 0130 { 28E 3 ---  29E 3 ---  28F 3 ---  29F 3 --- }
7305: 0130 { 28E 3 ---  29E 3 ---  28F 3 ---  29F 3 --- }
7306: 0130 { 0F0 3 --p  0F0 3 -yp  0F0 3 x-p  0F0 3 xyp }
7307: 0130 { 0F1 3 --p  0F1 3 -yp  0F1 3 x-p  0F1 3 xyp }
7308: 0130 { 0F2 3 ---  0F2 3 -y-  0F2 3 x--  0F2 3 xy- }
7309: 0130 { 0F3 3 ---  0F8 4 ---  0F8 4 ---  0F4 3 --- }
730A: 0130 { 0F8 4 ---  0F5 3 ---  0F4 3 ---  0F8 4 --- }
730B: 0130 { 0F8 4 ---  0F3 3 ---  0F8 4 ---  0F8 4 --- }
730C: 0130 { 0F4 3 x--  0F8 4 ---  0F8 4 ---  0F5 3 x-- }
730D: 0130 { 0F7 2 ---  0F7 2 -y-  0F7 2 x--  0F7 2 xy- }
730E: 0130 { 0E7 2 ---  0E7 2 -y-  0E7 2 x--  0E7 2 xy- }
730F: 0130 { 1A0 4 ---  1B0 4 ---  1A1 4 ---  1B1 4 --- }
7310: 0130 { 2A0 3 ---  2B0 3 ---  2A1 3 ---  2B1 3 --- }
7311: 0130 { 2A2 3 ---  2B2 3 ---  2A3 3 ---  2B3 3 --- }
7312: 0130 { 2E0 3 ---  2F0 3 ---  2E1 3 ---  2F1 3 --- }
7313: 0130 { 2E2 3 ---  2F2 3 ---  2E3 3 ---  2F3 3 --- }
7314: 0130 { 2AE 3 ---  2BE 3 ---  2AF 3 ---  2BF 3 --- }
7315: 0130 { 2AE 3 ---  2BE 3 ---  2AF 3 ---  2BF 3 --- }
7316: 0130 { 0C8 3 ---  0D8 3 ---  0C9 3 ---  0D9 3 --- }
7317: 0130 { 0C9 3 x--  0D9 3 x--  0C8 3 x--  0D8 3 x-- }
7318: 0130 { 0D8 3 -y-  0C8 3 -y-  0D9 3 -y-  0C9 3 -y- }
7319: 0130 { 0D9 3 xy-  0C9 3 xy-  0D8 3 xy-  0C8 3 xy- }
731A: 0130 { 0C7 3 ---  0C7 3 -y-  0C7 3 x--  0C7 3 xy- }
731B: 0130 { 0D7 3 ---  0D7 3 -y-  0D7 3 x--  0D7 3 xy- }
731C: 0130 { 0F6 3 ---  0F6 3 -y-  0F6 3 x--  0F6 3 xy- }
731D: 0130 { 188 3 ---  198 3 ---  189 3 ---  199 3 --- }
731E: 0130 { 18A 3 ---  194 3 ---  193 3 ---  195 3 --- }
731F: 0130 { 192 3 ---  194 3 ---  193 3 ---  18A 3 --- }
7320: 0130 { 288 3 --p  298 3 --p  289 3 --p  299 3 --p }
7321: 0130 { 28A 3 --p  29A 3 --p  28B 3 --p  29B 3 --p }
7322: 0130 { 28C 3 --p  29C 3 --p  28D 3 --p  29D 3 --p }
7323: 0130 { 0A2 3 ---  0B2 3 ---  0A3 3 ---  0B3 3 --- }
7324: 0130 { 289 3 ---  291 3 ---  28A 3 ---  292 3 --- }
7325: 0130 { 289 3 ---  292 3 x--  28A 3 ---  291 3 x-- }
7326: 0130 { 289 3 ---  291 3 ---  28A 3 ---  292 3 --- }
7327: 0130 { 291 3 ---  2A1 3 ---  292 3 ---  2A2 3 --- }
7328: 0130 { 290 3 ---  2A0 3 ---  291 3 ---  2A1 3 --- }
7329: 0130 { 292 3 ---  2A2 3 ---  293 3 ---  2A3 3 --- }
732A: 0130 { 2A1 3 ---  2B1 3 x--  2A2 3 ---  2B2 3 x-- }
732B: 0130 { 2C0 3 ---  2F0 3 ---  2C1 3 ---  2F1 3 --- }
732C: 0130 { 2C2 3 ---  2D1 3 x--  2C3 3 ---  2D3 3 --- }
732D: 0130 { 2C3 3 x--  2D3 3 x--  2C2 3 x--  2D1 3 --- }
732E: 0130 { 2C1 3 x--  2F1 3 x--  2C0 3 x--  2F0 3 x-- }
732F: 0130 { 000 5 ---  010 5 ---  001 5 ---  011 5 --- }
7330: 0130 { 2A8 3 --p  2B8 3 --p  2A9 3 --p  2B9 3 --p }
7331: 0130 { 2AA 3 --p  2BA 3 --p  2AB 3 --p  2BB 3 --p }
7332: 0130 { 2AC 3 --p  2BC 3 --p  2AD 3 --p  2BD 3 --p }
7333: 0130 { 0C2 3 ---  0D2 3 ---  0C3 3 ---  0D3 3 --- }
7334: 0130 { 288 3 ---  290 3 ---  28D 3 ---  293 3 --- }
7335: 0130 { 288 3 ---  2B0 3 ---  28A 3 ---  2B2 3 --- }
7336: 0130 { 289 3 ---  292 3 ---  28D 3 ---  293 3 --- }
7337: 0130 { 288 3 ---  2B0 3 ---  28D 3 ---  2B3 3 --- }
7338: 0130 { 288 3 ---  2B0 3 ---  289 3 ---  2B1 3 --- }
7339: 0130 { 28A 3 ---  2B2 3 ---  28D 3 ---  2B3 3 --- }
733A: 0130 { 0F8 4 ---  2DE 3 ---  2CF 3 ---  2DF 3 --- }
733B: 0130 { 2CF 3 x--  2DF 3 x--  0F8 4 ---  2DE 3 x-- }
733C: 0130 { 2E0 3 ---  2F0 3 ---  2E3 3 ---  2F3 3 --- }
733D: 0130 { 2E0 3 ---  2F0 3 ---  2E3 3 ---  2F3 3 --- }
733E: 0130 { 2F0 3 -y-  2E0 3 -y-  2F3 3 -y-  2E3 3 -y- }
733F: 0130 { 002 5 ---  012 5 ---  003 5 ---  013 5 --- }
7340: 0130 { 2C8 3 --p  2D8 3 --p  2C9 3 --p  2D9 3 --p }
7341: 0130 { 2CA 3 --p  0F8 4 --p  2CB 3 --p  0F8 4 --p }
7342: 0130 { 2CC 3 --p  2DC 3 --p  2CD 3 --p  2DD 3 --p }
7343: 0130 { 24E 4 ---  25E 4 ---  24F 4 ---  25F 4 --- }
7344: 0130 { 2A0 3 ---  2B0 3 ---  2A2 3 ---  2B1 3 --- }
7345: 0130 { 28A 3 ---  2B2 3 ---  28D 3 ---  2B3 3 --- }
7346: 0130 { 2A0 3 ---  2B0 3 ---  2A3 3 ---  2B3 3 --- }
7347: 0130 { 288 3 ---  290 3 ---  28D 3 ---  293 3 --- }
7348: 0130 { 2C0 3 ---  2F0 3 ---  2C1 3 ---  2F1 3 --- }
7349: 0130 { 2C2 3 ---  2F2 3 ---  2C3 3 ---  2F3 3 --- }
734A: 0130 { 2EE 3 ---  2FE 3 ---  2EF 3 ---  2FF 3 --- }
734B: 0130 { 2EF 3 x--  2FF 3 x--  2EE 3 x--  2FE 3 x-- }
734C: 0130 { 2C0 3 ---  2D0 3 ---  2C3 3 ---  2D3 3 --- }
734D: 0130 { 2C0 3 ---  2F0 3 ---  2C1 3 ---  2F1 3 --- }
734E: 0130 { 2D1 3 xy-  2F1 3 ---  2E3 3 ---  2F3 3 --- }
734F: 0130 { 08F 3 ---  08F 3 -y-  09F 3 -y-  09F 3 --- }
7350: 0130 { 200 3 --p  210 3 --p  201 3 --p  211 3 --p }
7351: 0130 { 202 3 ---  212 3 ---  203 3 ---  213 3 --- }
7352: 0130 { 204 3 ---  214 3 ---  205 3 ---  215 3 --- }
7353: 0130 { 27E 4 ---  0F8 4 ---  27F 4 ---  0F8 4 --- }
7354: 0130 { 288 3 ---  290 3 ---  289 3 ---  2A1 3 --- }
7355: 0130 { 28A 3 ---  2B2 3 ---  28D 3 ---  2B3 3 --- }
7356: 0130 { 288 3 ---  290 3 ---  28D 3 ---  293 3 --- }
7357: 0130 { 2A0 3 ---  2B0 3 ---  2A3 3 ---  2B3 3 --- }
7358: 0130 { 2C0 3 ---  2F0 3 ---  2C3 3 ---  2F3 3 --- }
7359: 0130 { 2C0 3 ---  2D0 3 ---  2C3 3 ---  2D3 3 --- }
735A: 0130 { 2FE 3 -y-  2EE 3 -y-  2FF 3 -y-  2EF 3 -y- }
735B: 0130 { 2FF 3 xy-  2EF 3 xy-  2FE 3 xy-  2EE 3 xy- }
735C: 0130 { 2E0 3 -y-  2F0 3 ---  2D1 3 -y-  2F1 3 --- }
735D: 0130 { 2C1 3 x--  2F1 3 x--  2C0 3 x--  2F0 3 x-- }
735E: 0130 { 2C1 3 ---  2F1 3 ---  2C2 3 ---  2F2 3 --- }
735F: 0130 { 09F 3 xy-  09F 3 x--  08F 3 x--  08F 3 xy- }
7360: 0130 { 220 3 --p  230 3 --p  221 3 --p  231 3 --p }
7361: 0130 { 222 3 ---  232 3 ---  223 3 ---  233 3 --- }
7362: 0130 { 224 3 ---  234 3 ---  225 3 ---  235 3 --- }
7363: 0130 { 289 3 ---  2B1 3 ---  28A 3 ---  2B2 3 --- }
7364: 0130 { 2A0 3 ---  2B0 3 ---  2A3 3 ---  2B3 3 --- }
7365: 0130 { 288 3 ---  2B0 3 ---  289 3 ---  2B1 3 --- }
7366: 0130 { 2A0 3 ---  2B2 3 ---  2A3 3 ---  2B3 3 --- }
7367: 0130 { 2A2 3 x--  2B2 3 x--  2A1 3 xy-  2B1 3 x-- }
7368: 0130 { 2A1 3 xy-  2B1 3 ---  2A2 3 -y-  2B2 3 --- }
7369: 0130 { 2E0 3 ---  2F0 3 ---  2E3 3 ---  2F3 3 --- }
736A: 0130 { 2DE 3 -y-  0F8 4 ---  2DF 3 -y-  2CF 3 -y- }
736B: 0130 { 2DF 3 xy-  2CF 3 xy-  2DE 3 xy-  0F8 4 --- }
736C: 0130 { 0F8 4 ---  27C 3 ---  0F8 4 ---  27D 3 x-- }
736D: 0130 { 0F8 4 ---  27D 3 ---  0F8 4 ---  27C 3 x-- }
736E: 0130 { 290 3 ---  2A0 3 ---  293 3 ---  2A3 3 --- }
736F: 0130 { 0F8 4 ---  0F4 3 ---  0F8 4 ---  0F8 4 --- }
7370: 0130 { 0F8 4 ---  0F8 4 ---  0F8 4 ---  217 3 --- }
7371: 0130 { 208 3 ---  218 3 ---  0F8 4 ---  219 3 --- }
7372: 0130 { 260 3 ---  270 3 ---  261 3 ---  271 3 --- }
7373: 0130 { 0F8 4 ---  0F8 4 ---  0F8 4 ---  21F 3 --- }
7374: 0130 { 0F8 4 ---  250 3 ---  0F8 4 ---  251 3 --- }
7375: 0130 { 271 3 xy-  261 3 xy-  270 3 xy-  260 3 xy- }
7376: 0130 { 244 3 ---  254 3 ---  245 3 ---  255 3 --- }
7377: 0130 { 245 3 x--  255 3 x--  244 3 x--  254 3 x-- }
7378: 0130 { 275 3 xy-  265 3 xy-  274 3 xy-  264 3 xy- }
7379: 0130 { 274 3 -y-  264 3 -y-  275 3 -y-  265 3 -y- }
737A: 0130 { 0F8 4 ---  240 3 ---  0F8 4 ---  241 3 --- }
737B: 0130 { 0F8 4 ---  241 3 x--  0F8 4 ---  240 3 x-- }
737C: 0130 { 277 3 xy-  267 3 xy-  276 3 xy-  266 3 xy- }
737D: 0130 { 276 3 -y-  266 3 -y-  277 3 -y-  267 3 -y- }
737E: 0130 { 207 3 x--  25B 3 x--  206 3 x--  216 3 x-- }
737F: 0130 { 206 3 ---  216 3 ---  207 3 ---  25B 3 --- }
7380: 0130 { 0F8 4 ---  0F8 4 ---  227 3 ---  237 3 --- }
7381: 0130 { 228 3 ---  238 3 ---  229 3 ---  0F8 4 --- }
7382: 0130 { 261 3 x--  271 3 x--  260 3 x--  270 3 x-- }
7383: 0130 { 22E 3 ---  23E 3 ---  22F 3 ---  23F 3 --- }
7384: 0130 { 242 3 ---  252 3 ---  243 3 ---  253 3 --- }
7385: 0130 { 270 3 -y-  260 3 -y-  271 3 -y-  261 3 -y- }
7386: 0130 { 264 3 ---  274 3 ---  265 3 ---  275 3 --- }
7387: 0130 { 265 3 x--  275 3 x--  264 3 x--  274 3 x-- }
7388: 0130 { 255 3 xy-  245 3 xy-  254 3 xy-  244 3 xy- }
7389: 0130 { 254 3 -y-  244 3 -y-  255 3 -y-  245 3 -y- }
738A: 0130 { 246 3 ---  256 3 ---  247 3 ---  257 3 --- }
738B: 0130 { 247 3 x--  257 3 x--  246 3 x--  256 3 x-- }
738C: 0130 { 257 3 xy-  247 3 xy-  256 3 xy-  246 3 xy- }
738D: 0130 { 256 3 -y-  246 3 -y-  257 3 -y-  247 3 -y- }
738E: 0130 { 25C 3 x--  26C 3 x--  226 3 x--  209 3 x-- }
738F: 0130 { 226 3 ---  209 3 ---  25C 3 ---  26C 3 --- }
7390: 0130 { 20A 3 ---  21A 3 ---  20B 3 ---  21B 3 --- }
7391: 0130 { 20C 3 ---  21C 3 ---  0F8 4 ---  0F8 4 --- }
7392: 0130 { 0F8 4 ---  22A 3 ---  0F8 4 ---  22B 3 --- }
7393: 0130 { 20D 3 ---  21D 3 ---  20E 3 ---  21E 3 --- }
7394: 0130 { 22C 3 ---  23C 3 ---  22D 3 ---  23D 3 --- }
7395: 0130 { 20F 3 ---  24C 3 ---  0F8 4 ---  24D 3 --- }
7396: 0130 { 262 3 ---  272 3 ---  263 3 ---  273 3 --- }
7397: 0130 { 263 3 x--  273 3 x--  262 3 x--  272 3 x-- }
7398: 0130 { 272 3 -y-  262 3 -y-  273 3 -y-  263 3 -y- }
7399: 0130 { 273 3 xy-  263 3 xy-  272 3 xy-  262 3 xy- }
739A: 0130 { 266 3 ---  276 3 ---  267 3 ---  277 3 --- }
739B: 0130 { 267 3 x--  277 3 x--  266 3 x--  276 3 x-- }
739C: 0130 { 241 3 xy-  0F8 4 ---  240 3 xy-  0F8 4 --- }
739D: 0130 { 240 3 -y-  0F8 4 ---  241 3 -y-  0F8 4 --- }
739E: 0130 { 0F8 4 ---  27D 3 x--  0F8 4 ---  0F8 4 --- }
739F: 0130 { 0F8 4 ---  0F8 4 ---  0F8 4 ---  27D 3 --- }
73A0: 0130 { 0F8 4 ---  236 3 ---  0F8 4 ---  239 3 --- }
73A1: 0130 { 0F8 4 ---  23A 3 ---  0F8 4 ---  23B 3 --- }
73A2: 0130 { 0F8 4 ---  23B 3 x--  0F8 4 ---  23A 3 x-- }
73A3: 0130 { 0F8 4 ---  239 3 x--  0F8 4 ---  236 3 x-- }
73A4: 0130 { 26D 3 ---  26D 3 ---  26D 3 ---  26D 3 --- }
73A5: 0130 { 0F8 4 ---  26D 3 ---  26D 3 ---  26D 3 --- }
73A6: 0130 { 26D 3 ---  26D 3 ---  0F8 4 ---  26D 3 --- }
73A7: 0130 { 26D 3 ---  0F8 4 ---  0F8 4 ---  26D 3 --- }
73A8: 0130 { 291 3 ---  2A1 3 x--  1C0 3 ---  1D0 3 --- }
73A9: 0130 { 1C1 3 ---  1D1 3 ---  1C2 3 ---  1D2 3 --- }
73AA: 0130 { 1C2 3 x--  1D2 3 x--  1C1 3 x--  1D1 3 x-- }
73AB: 0130 { 1C0 3 x--  1D0 3 x--  291 3 x--  2A1 3 --- }
73AC: 0130 { 292 3 ---  2E4 3 ---  2D5 3 ---  2E5 3 --- }
73AD: 0130 { 2D6 3 ---  2E6 3 ---  2D7 3 ---  2E7 3 --- }
73AE: 0130 { 2DA 3 ---  2EA 3 ---  2DB 3 ---  2EB 3 --- }
73AF: 0130 { 2A2 3 -y-  2EC 3 ---  2A1 3 x--  2D4 3 --- }
73B0: 0130 { 248 3 ---  258 3 ---  249 3 ---  259 3 --- }
73B1: 0130 { 24A 3 ---  25A 3 ---  24B 3 ---  0F8 4 --- }
73B2: 0130 { 24B 3 x--  0F8 4 ---  24A 3 x--  25A 3 x-- }
73B3: 0130 { 249 3 x--  259 3 x--  248 3 x--  258 3 x-- }
73B4: 0130 { 26D 3 ---  0F8 4 ---  26D 3 ---  26D 3 --- }
73B5: 0130 { 26D 3 ---  26D 3 ---  26D 3 ---  0F8 4 --- }
73B6: 0130 { 0F8 4 ---  26D 3 ---  0F8 4 ---  0F8 4 --- }
73B7: 0130 { 0F8 4 ---  26D 3 ---  26D 3 ---  0F8 4 --- }
73B8: 0130 { 2A1 3 -y-  291 3 xy-  2A1 3 ---  2A1 3 xy- }
73B9: 0130 { 1E1 3 ---  1F1 3 ---  1E2 3 ---  1F2 3 --- }
73BA: 0130 { 1E2 3 x--  1F2 3 x--  1E1 3 x--  1F1 3 x-- }
73BB: 0130 { 2A1 3 x--  2A1 3 -y-  2A1 3 xy-  291 3 -y- }
73BC: 0130 { 2F4 3 ---  2A2 3 ---  2F5 3 ---  2D4 3 --- }
73BD: 0130 { 2F6 3 ---  2ED 3 ---  2F7 3 ---  2FD 3 --- }
73BE: 0130 { 2FA 3 ---  2D4 3 ---  2FB 3 ---  2A1 3 -y- }
73BF: 0130 { 2FC 3 ---  2A1 3 ---  291 3 ---  2D4 3 --- }
73C0: 0130 { 268 3 ---  278 3 ---  269 3 ---  279 3 --- }
73C1: 0130 { 26A 3 ---  27A 3 ---  26B 3 ---  27B 3 --- }
73C2: 0130 { 26B 3 x--  27B 3 x--  26A 3 x--  27A 3 x-- }
73C3: 0130 { 269 3 x--  279 3 x--  268 3 x--  278 3 x-- }
73C4: 0130 { 0F8 4 ---  0F8 4 ---  0F8 4 ---  26D 3 --- }
73C5: 0130 { 27C 3 -y-  0F8 4 ---  27D 3 xy-  0F8 4 --- }
73C6: 0130 { 27D 3 -y-  0F8 4 ---  27C 3 xy-  0F8 4 --- }
73C7: 0130 { 0F8 4 ---  27C 3 ---  0F8 4 ---  0F8 4 --- }
73C8: 0130 { 0F8 4 ---  0F8 4 ---  0F8 4 ---  27C 3 x-- }
73C9: 0130 { 27C 3 -y-  0F8 4 ---  0F8 4 ---  0F8 4 --- }
73CA: 0130 { 0F8 4 ---  0F8 4 ---  27C 3 xy-  0F8 4 --- }
73CB: 0130 { 2A1 3 ---  1DE 3 ---  2A2 3 x--  2D4 3 x-- }
73CC: 0130 { 2A1 3 ---  2D4 3 x--  2A2 3 xy-  2EC 3 x-- }
73CD: 0130 { 2DB 3 x--  2EB 3 x--  2DA 3 x--  2EA 3 x-- }
73CE: 0130 { 2D7 3 x--  2E7 3 x--  2D6 3 x--  2E6 3 x-- }
73CF: 0130 { 2D5 3 x--  2E5 3 x--  292 3 x--  2E4 3 x-- }
73D0: 0130 { 2A4 3 ---  0F8 4 ---  2A5 3 ---  0F8 4 --- }
73D1: 0130 { 2A5 3 x--  0F8 4 ---  2A4 3 x--  0F8 4 --- }
73D2: 0130 { 2A4 3 ---  0F8 4 ---  2A6 3 ---  2B6 3 --- }
73D3: 0130 { 2A5 3 ---  0F8 4 ---  2A5 3 x--  0F8 4 --- }
73D4: 0130 { 2A6 3 ---  2B6 3 x--  2A4 3 x--  0F8 4 --- }
73D5: 0130 { 0F8 4 ---  2A7 3 ---  2A7 3 ---  2B7 3 --- }
73D6: 0130 { 2A7 3 x--  2B7 3 x--  0F8 4 ---  2A7 3 x-- }
73D7: 0130 { 0F8 4 ---  2E8 3 ---  0F8 4 ---  2E9 3 --- }
73D8: 0130 { 2E8 3 ---  2F8 3 ---  2E9 3 ---  2F9 3 --- }
73D9: 0130 { 2E9 3 x--  2F9 3 x--  2E8 3 x--  2F8 3 x-- }
73DA: 0130 { 0F8 4 ---  2E9 3 x--  0F8 4 ---  2E8 3 x-- }
73DB: 0130 { 1EE 3 ---  2A1 3 -y-  291 3 -y-  2A1 3 x-- }
73DC: 0130 { 291 3 x--  2D4 3 x--  2FC 3 x--  2A1 3 x-- }
73DD: 0130 { 2FB 3 x--  2A1 3 xy-  2FA 3 x--  2D4 3 x-- }
73DE: 0130 { 2F7 3 x--  2FD 3 x--  2F6 3 x--  2ED 3 x-- }
73DF: 0130 { 2F5 3 x--  2A1 3 ---  2F4 3 x--  2A2 3 x-- }
73E0: 0130 { 2A5 3 ---  0F8 4 ---  2A6 3 ---  2B6 3 --- }
73E1: 0130 { 2A6 3 ---  2B6 3 x--  2A5 3 ---  0F8 4 --- }
73E2: 0130 { 0F8 4 ---  0F8 4 ---  2C6 3 ---  2B6 3 --- }
73E3: 0130 { 0F8 4 ---  0F8 4 ---  0F8 4 ---  0F8 4 --- }
73E4: 0130 { 2C6 3 x--  2B6 3 x--  0F8 4 ---  0F8 4 --- }
73E5: 0130 { 2B7 3 ---  2C7 3 ---  2C7 3 ---  0F8 4 --- }
73E6: 0130 { 2C7 3 x--  0F8 4 ---  2B7 3 x--  2C7 3 x-- }
73E7: 0130 { 2F8 3 ---  0F8 4 ---  2F9 3 ---  0F8 4 --- }
73E8: 0130 { 0F8 4 ---  0F8 4 ---  0F8 4 ---  0F8 4 --- }
73E9: 0130 { 0F8 4 ---  0F8 4 ---  0F8 4 ---  0F8 4 --- }
73EA: 0130 { 2F9 3 x--  0F8 4 ---  2F8 3 x--  0F8 4 --- }
73EB: 0130 { 2A2 3 x--  1D8 3 ---  1C9 3 ---  1D9 3 --- }
73EC: 0130 { 1CA 3 ---  1DA 3 ---  1CB 3 ---  1DB 3 --- }
73ED: 0130 { 1CC 3 ---  1DC 3 ---  1CD 3 ---  1DD 3 --- }
73EE: 0130 { 1C6 2 ---  1D6 2 ---  1C7 2 ---  1D7 2 --- }
73EF: 0130 { 1C7 2 x--  1D7 2 x--  1C6 2 x--  1D6 2 x-- }
73F0: 0130 { 2A4 3 ---  0F8 4 ---  2A4 3 x--  0F8 4 --- }
73F1: 0130 { 0F8 4 ---  0F8 4 ---  0F8 4 ---  2B4 3 --- }
73F2: 0130 { 0F8 4 ---  2B5 3 ---  2C6 3 ---  2C4 3 --- }
73F3: 0130 { 0F8 4 ---  0F8 4 ---  0F8 4 ---  0F8 4 --- }
73F4: 0130 { 2C6 3 x--  2C4 3 x--  0F8 4 ---  2B5 3 x-- }
73F5: 0130 { 0F8 4 ---  2B4 3 x--  0F8 4 ---  0F8 4 --- }
73F6: 0130 { 2C5 3 ---  0F8 4 ---  2C7 3 ---  0F8 4 --- }
73F7: 0130 { 2C7 3 x--  0F8 4 ---  2C5 3 x--  0F8 4 --- }
73F8: 0130 { 2A5 3 ---  2C7 3 ---  2A5 3 x--  0F8 4 --- }
73F9: 0130 { 2A5 3 ---  0F8 4 ---  2A5 3 x--  2C7 3 x-- }
73FA: 0130 { 2A5 3 ---  2C7 3 ---  2A5 3 x--  2C7 3 x-- }
73FB: 0130 { 1E8 3 ---  2A2 3 ---  1E9 3 ---  2A1 3 x-- }
73FC: 0130 { 1EA 3 ---  1FA 3 ---  1EB 3 ---  1FB 3 --- }
73FD: 0130 { 1EC 3 ---  2D4 3 ---  1ED 3 ---  291 3 -y- }
73FE: 0130 { 289 3 ---  291 3 ---  28A 3 ---  292 3 --- }
73FF: 0130 { 288 3 ---  290 3 ---  28B 3 ---  291 3 x-- }
