5400: 0025 { 1C0 5 ---  190 5 ---  181 5 ---  191 5 --- }
5401: 0130 { 182 5 ---  192 5 ---  183 5 ---  193 5 --- }
5402: 0025 { 184 5 ---  194 5 ---  185 5 ---  195 5 --- }
5403: 0025 { 086 5 ---  086 5 ---  086 5 ---  096 5 --- }
5404: 0025 { 087 5 ---  097 5 ---  088 5 ---  098 5 --- }
5405: 0025 { 089 5 ---  099 5 ---  08A 5 ---  09A 5 --- }
5406: 0025 { 08B 5 ---  09B 5 ---  08C 5 ---  09C 5 --- }
5407: 0025 { 08D 5 ---  09D 5 ---  086 5 ---  096 5 --- }
5408: 0025 { 087 5 ---  097 5 ---  086 5 ---  086 5 --- }
5409: 0100 { 20B 2 ---  200 2 ---  20B 2 ---  200 2 --- }
540A: 0100 { 18D 3 ---  19B 3 ---  18E 3 ---  19C 3 --- }
540B: 0100 { 18F 3 ---  2A2 2 ---  18F 3 ---  2A3 2 --- }
540C: 0100 { 1AD 3 ---  19B 3 ---  1AE 3 ---  19C 3 --- }
540D: 0130 { 20B 2 --p  288 2 --p  289 2 --p  298 2 --p }
540E: 0130 { 200 2 --p  288 2 --p  288 2 --p  297 2 --p }
540F: 0130 { 297 2 --p  2A7 2 --p  299 2 --p  299 2 --p }
5410: 0025 { 1A0 5 ---  1B0 5 ---  1A1 5 ---  1B1 5 --- }
5411: 0130 { 1A2 5 ---  1B2 5 ---  1A3 5 ---  1B3 5 --- }
5412: 0025 { 1A4 5 ---  1B4 5 ---  1A5 5 ---  1B5 5 --- }
5413: 0025 { 086 5 ---  086 5 ---  0A6 5 ---  0B6 5 --- }
5414: 0025 { 0A7 5 ---  0B7 5 ---  0A8 5 ---  0B8 5 --- }
5415: 0025 { 0A9 5 ---  0B9 5 ---  0AA 5 ---  0BA 5 --- }
5416: 0025 { 0AB 5 ---  0BB 5 ---  0AC 5 ---  0BC 5 --- }
5417: 0025 { 0AD 5 ---  0BD 5 ---  086 5 ---  0BE 5 --- }
5418: 0025 { 086 5 ---  0BF 5 ---  086 5 ---  086 5 --- }
5419: 0025 { 201 2 ---  0F8 2 ---  201 2 ---  0F8 2 --- }
541A: 0130 { 2B1 5 --p  2C1 5 --p  2B2 5 --p  2C2 5 --p }
541B: 0025 { 200 2 ---  200 2 ---  200 2 ---  200 2 --- }
541C: 0025 { 201 2 ---  1F7 3 ---  201 2 ---  1F8 3 --- }
541D: 0100 { 2A3 2 ---  2A4 2 ---  2A4 2 ---  2A3 2 --- }
541E: ~
541F: ~
5420: 0025 { 1C0 5 ---  1D0 5 ---  1C1 5 ---  1D1 5 --- }
5421: 0130 { 1C2 5 ---  1D2 5 ---  1C3 5 ---  1D3 5 --- }
5422: 0025 { 1C4 5 ---  1D4 5 ---  1C5 5 ---  1D5 5 --- }
5423: 0025 { 086 5 ---  086 5 ---  0C6 5 ---  0D6 5 --- }
5424: 0025 { 0C7 5 ---  0D7 5 ---  0C8 5 ---  0D8 5 --- }
5425: 0025 { 0C9 5 ---  0D9 5 ---  0CA 5 ---  08E 5 --- }
5426: 0025 { 0CB 5 ---  08F 5 ---  0CC 5 ---  09E 5 --- }
5427: 0025 { 0CD 5 ---  09F 5 ---  0CE 5 ---  0DE 5 --- }
5428: 0025 { 0CF 5 ---  0DF 5 ---  086 5 ---  086 5 --- }
5429: 0130 { 0A0 7 ---  0A2 7 ---  0A1 7 ---  0A3 7 --- }
542A: ~
542B: ~
542C: ~
542D: ~
542E: ~
542F: ~
5430: 0025 { 1D0 5 --p  27A 2 --p  1D1 5 --p  201 2 --p }
5431: 0130 { 1C1 5 ---  1D1 5 ---  1C1 5 ---  1D1 5 --- }
5432: 0025 { 1C0 5 --p  1D0 5 --p  1C1 5 --p  1D1 5 --p }
5433: 0025 { 086 5 ---  096 5 ---  087 5 ---  097 5 --- }
5434: 0025 { 088 5 ---  098 5 ---  089 5 ---  099 5 --- }
5435: 0025 { 08A 5 ---  09A 5 ---  08B 5 ---  09B 5 --- }
5436: 0025 { 08C 5 ---  09C 5 ---  08D 5 ---  09D 5 --- }
5437: 0025 { 086 5 ---  096 5 ---  087 5 ---  097 5 --- }
5438: 0130 { 0D1 5 ---  2B7 2 ---  0D1 5 ---  2B8 2 --- }
5439: 0130 { 0A4 7 ---  200 2 ---  0A5 7 ---  200 2 --- }
543A: ~
543B: ~
543C: ~
543D: ~
543E: ~
543F: ~
5440: 0025 { 1C1 5 --p  1D1 5 --p  1C1 5 --p  1D1 5 --p }
5441: 0130 { 1C1 5 --p  1D1 5 --p  1C1 5 --p  1D1 5 --p }
5442: 0130 { 1C0 5 --p  1D0 5 --p  1C1 5 --p  1D1 5 --p }
5443: 0025 { 0A6 5 ---  0B6 5 ---  0A7 5 ---  0B7 5 --- }
5444: 0025 { 0A8 5 ---  0B8 5 ---  0A9 5 ---  0B9 5 --- }
5445: 0025 { 0AA 5 ---  0BA 5 ---  0AB 5 ---  0BB 5 --- }
5446: 0025 { 0AC 5 ---  0BC 5 ---  0AD 5 ---  0BD 5 --- }
5447: 0025 { 086 5 ---  0BE 5 ---  086 5 ---  0BF 5 --- }
5448: 0025 { 2C7 2 ---  2D7 2 ---  2C8 2 ---  2D8 2 --- }
5449: ~
544A: ~
544B: ~
544C: ~
544D: ~
544E: ~
544F: ~
5450: 0025 { 2E9 5 ---  2C1 5 ---  1D1 5 ---  2EA 5 --- }
5451: 0130 { 2DD 5 ---  2C1 5 ---  2BE 5 ---  2ED 5 --- }
5452: 0025 { 2BF 5 ---  2C1 5 ---  1D1 5 ---  2EA 5 --- }
5453: 0025 { 0C6 5 ---  0D6 5 ---  0C7 5 ---  0D7 5 --- }
5454: 0025 { 0C8 5 ---  0D8 5 ---  0C9 5 ---  0D9 5 --- }
5455: 0025 { 0CA 5 ---  08E 5 ---  0CB 5 ---  08F 5 --- }
5456: 0025 { 0CC 5 ---  09E 5 ---  0CD 5 ---  09F 5 --- }
5457: 0025 { 0CE 5 ---  0DE 5 ---  0CF 5 ---  0DF 5 --- }
5458: 0204 { 2C7 2 ---  2B9 2 ---  2D8 2 ---  2BA 2 --- }
5459: ~
545A: ~
545B: ~
545C: ~
545D: ~
545E: ~
545F: ~
5460: 0025 { 0D0 5 ---  0D0 5 ---  0D1 5 ---  0D1 5 --- }
5461: 0025 { 0D0 5 --p  0D0 5 --p  0D0 5 x-p  0D0 5 x-p }
5462: 0130 { 0D0 5 --p  0D0 5 --p  0D0 5 x-p  0D0 5 x-p }
5463: 0025 { 0D0 5 --p  27A 2 --p  0D0 5 x-p  27A 2 x-p }
5464: 0025 { 0D1 5 --p  0D1 5 --p  0D1 5 --p  0D1 5 --p }
5465: 0130 { 0D1 5 --p  0D1 5 --p  0D1 5 --p  0D1 5 --p }
5466: 0130 { 0D1 5 ---  0D1 5 ---  0D1 5 ---  0D1 5 --- }
5467: 0130 { 0D1 5 ---  2B7 2 ---  0D1 5 ---  2B8 2 --- }
5468: 0130 { 2B8 2 ---  2B7 2 ---  181 5 ---  2B8 2 --- }
5469: ~
546A: ~
546B: ~
546C: ~
546D: ~
546E: ~
546F: ~
5470: 0025 { 282 2 ---  200 2 ---  0D1 5 ---  283 2 --- }
5471: 0130 { 284 2 ---  200 2 ---  2BE 5 ---  285 2 --- }
5472: 0025 { 283 2 ---  200 2 ---  0D1 5 ---  283 2 --- }
5473: 0025 { 2A3 2 ---  2A4 2 ---  2A2 2 ---  2A3 2 --- }
5474: 0130 { 2A3 2 ---  2A4 2 ---  2A4 2 ---  2A3 2 --- }
5475: 0025 { 208 2 x--  1B8 4 x--  208 2 x--  208 2 x-- }
5476: 0025 { 208 2 x--  208 2 x--  208 2 x--  1B8 4 --- }
5477: 0025 { 24C 2 ---  20B 2 ---  0D0 5 ---  282 2 --- }
5478: ~
5479: 0025 { 0F8 2 ---  0F8 2 ---  0F8 2 ---  0F8 2 --- }
547A: 0025 { 240 2 ---  250 2 ---  241 2 ---  0FF 2 --- }
547B: 0025 { 241 2 x--  0FF 2 x--  240 2 x--  250 2 x-- }
547C: 0025 { 0F8 2 ---  0F8 2 ---  0F8 2 ---  0F8 2 --- }
547D: ~
547E: ~
547F: ~
5480: 0025 { 2A5 2 ---  2A4 2 ---  0D1 5 ---  2A5 2 --- }
5481: 0130 { 295 2 ---  2A4 2 ---  2BE 5 ---  286 2 --- }
5482: 0025 { 2A5 2 ---  2A4 2 ---  0D1 5 ---  2A5 2 --- }
5483: 0025 { 201 2 ---  2A2 2 ---  201 2 ---  2A3 2 --- }
5484: 0025 { 2A3 2 ---  2A4 2 ---  2A4 2 ---  2A3 2 --- }
5485: 0025 { 24C 2 ---  2A2 2 ---  0D0 5 ---  2A5 2 --- }
5486: 0025 { 24C 2 ---  24C 2 ---  0D0 5 ---  0D0 5 --- }
5487: 0025 { 148 1 ---  145 1 ---  142 1 ---  0D1 5 x-- }
5488: ~
5489: 0025 { 0F8 2 ---  0F8 2 ---  0F8 2 ---  0F8 2 --- }
548A: 0025 { 243 2 ---  253 2 ---  244 2 ---  0FF 2 --- }
548B: 0025 { 0FF 2 ---  0FF 2 ---  0FF 2 ---  0FF 2 --- }
548C: 0025 { 241 2 x--  0FF 2 x--  240 2 x--  250 2 x-- }
548D: 0025 { 0FD 2 ---  0FD 2 ---  0FD 2 ---  0FD 2 --- }
548E: 0025 { 211 2 xy-  0FB 2 xy-  0FB 2 xy-  0FB 2 xy- }
548F: 0025 { 0FB 2 -y-  0FB 2 -y-  211 2 -y-  0FB 2 -y- }
5490: 0025 { 0F8 7 ---  0F8 7 ---  24E 7 ---  25E 7 --- }
5491: 0025 { 24F 7 ---  25F 7 ---  0F8 7 ---  25B 7 --- }
5492: 0025 { 2B1 5 --p  2C1 5 --p  2B2 5 --p  2C2 5 --p }
5493: 01CE { 2B1 5 --p  2C1 5 --p  2B2 5 --p  2C2 5 --p }
5494: 01F3 { 2B1 5 --p  2C1 5 --p  2B2 5 --p  2C2 5 --p }
5495: 01CE { 2C2 5 -yp  2C1 5 --p  2C1 5 -yp  2C2 5 --p }
5496: 01F3 { 2C2 5 -yp  2C1 5 --p  2C1 5 -yp  2C2 5 --p }
5497: ~
5498: ~
5499: 0025 { 240 2 ---  251 2 ---  241 2 ---  252 2 --- }
549A: 0025 { 0FF 2 ---  0FF 2 ---  0FF 2 ---  0FF 2 --- }
549B: 0025 { 0FF 2 ---  242 2 ---  245 2 ---  255 2 --- }
549C: 0025 { 246 2 ---  256 2 ---  247 2 ---  257 2 --- }
549D: 0025 { 0FC 2 ---  0FC 2 ---  0FC 2 ---  0FC 2 --- }
549E: 0025 { 0FB 2 x--  211 2 x--  0FB 2 x--  0FB 2 x-- }
549F: 0025 { 0FB 2 ---  0FB 2 ---  0FB 2 ---  211 2 --- }
54A0: 0025 { 0F8 7 ---  0F8 7 ---  254 7 ---  25A 7 --- }
54A1: 0025 { 255 7 ---  0F8 7 ---  0F8 7 ---  0F8 7 --- }
54A2: 0025 { 287 2 --p  200 2 --p  287 2 --p  200 2 --p }
54A3: 01CE { 287 2 --p  200 2 --p  287 2 --p  200 2 --p }
54A4: 01F3 { 287 2 --p  200 2 --p  287 2 --p  200 2 --p }
54A5: 0196 { 0F8 2 ---  20C 2 ---  0F8 2 ---  20D 2 --- }
54A6: 019B { 20C 2 ---  0FB 2 ---  20D 2 ---  0FB 2 --- }
54A7: 01A0 { 20D 2 x--  0FB 2 x--  20C 2 x--  0FB 2 x-- }
54A8: 01A5 { 0F8 2 x--  20D 2 x--  0F8 2 x--  20C 2 x-- }
54A9: 01EE { 0FB 2 ---  0FB 2 ---  0FB 2 ---  0FB 2 --- }
54AA: 01F0 { 0FB 2 ---  0FB 2 ---  0FB 2 ---  0FB 2 --- }
54AB: 01F0 { 0FB 2 ---  0FB 2 ---  0FB 2 ---  0FB 2 --- }
54AC: 01EF { 0FB 2 ---  0FB 2 ---  0FB 2 ---  0FB 2 --- }
54AD: 0025 { 200 2 ---  210 2 ---  201 2 ---  0FB 2 --- }
54AE: 0025 { 201 2 ---  0FB 2 ---  201 2 ---  0FB 2 --- }
54AF: 0025 { 201 2 x--  0FB 2 x--  200 2 x--  210 2 x-- }
54B0: 0025 { 010 7 ---  013 7 ---  011 7 ---  014 7 --- }
54B1: 0025 { 012 7 ---  015 7 ---  086 5 ---  086 5 --- }
54B2: 0025 { 086 5 ---  086 5 ---  086 5 ---  009 2 --- }
54B3: 0025 { 24C 2 ---  24C 2 ---  0D0 5 ---  0D0 5 --- }
54B4: ~
54B5: 01DE { 0FB 2 ---  0FB 2 ---  0FB 2 ---  0FB 2 --- }
54B6: 01E6 { 0FB 2 ---  0FB 2 ---  0FB 2 ---  0FB 2 --- }
54B7: 01E6 { 0FB 2 ---  0FB 2 ---  0FB 2 ---  0FB 2 --- }
54B8: 01E0 { 0FB 2 ---  0FB 2 ---  0FB 2 ---  0FB 2 --- }
54B9: 01C6 { 20C 2 -y-  0F8 2 -y-  20D 2 -y-  0F8 2 -y- }
54BA: 01C7 { 0FB 2 -y-  20C 2 -y-  0FB 2 -y-  20D 2 -y- }
54BB: 01C8 { 0FB 2 xy-  20D 2 xy-  0FB 2 xy-  20C 2 xy- }
54BC: 01C9 { 20D 2 xy-  0F8 2 xy-  20C 2 xy-  0F8 2 xy- }
54BD: 0025 { 210 2 ---  210 2 ---  0FB 2 ---  0FB 2 --- }
54BE: 0025 { 21B 2 ---  21B 2 ---  21B 2 x--  21B 2 x-- }
54BF: 0025 { 0FB 2 x--  0FB 2 x--  210 2 x--  210 2 x-- }
54C0: 0025 { 016 7 ---  019 7 ---  017 7 ---  01A 7 --- }
54C1: 0025 { 018 7 ---  0F8 7 ---  201 2 ---  0F8 2 --- }
54C2: 0025 { 006 2 ---  086 5 ---  007 2 ---  086 5 --- }
54C3: 0025 { 008 2 ---  24C 2 ---  0D0 5 ---  0D0 5 --- }
54C4: ~
54C5: 0025 { 0FD 2 ---  0FD 2 ---  0FD 2 ---  22E 2 --- }
54C6: 0025 { 0FD 2 ---  22F 2 ---  0FD 2 ---  0FD 2 --- }
54C7: 0025 { 0FC 2 ---  0FC 2 ---  224 2 ---  234 2 --- }
54C8: 0025 { 225 2 ---  235 2 ---  0FC 2 ---  0FC 2 --- }
54C9: 0025 { 0FD 2 ---  0FD 2 ---  0FD 2 ---  223 2 --- }
54CA: 0025 { 0FD 2 ---  223 2 x--  0FD 2 ---  0FD 2 --- }
54CB: 0025 { 0FC 2 ---  0FC 2 ---  0FC 2 ---  222 2 --- }
54CC: 0025 { 0FC 2 ---  222 2 x--  0FC 2 ---  0FC 2 --- }
54CD: 0025 { 210 2 -y-  200 2 -y-  0FB 2 -y-  201 2 -y- }
54CE: 0025 { 0FB 2 -y-  201 2 -y-  0FB 2 -y-  201 2 -y- }
54CF: 0025 { 0FB 2 xy-  201 2 xy-  210 2 xy-  200 2 xy- }
54D0: ~
54D1: ~
54D2: ~
54D3: ~
54D4: 0100 { 216 2 ---  0FB 2 ---  217 2 ---  0FB 2 --- }
54D5: 0025 { 0FD 2 ---  0FD 2 ---  23E 2 ---  0FD 2 --- }
54D6: 0025 { 23F 2 ---  0FD 2 ---  0FD 2 ---  0FD 2 --- }
54D7: 0025 { 0FC 2 ---  0FC 2 ---  226 2 ---  236 2 --- }
54D8: 0025 { 227 2 ---  237 2 ---  0FC 2 ---  0FC 2 --- }
54D9: 0025 { 0FD 2 ---  0FD 2 ---  233 2 ---  0FD 2 --- }
54DA: 0025 { 233 2 x--  0FD 2 ---  0FD 2 ---  0FD 2 --- }
54DB: 0025 { 0FC 2 ---  0FC 2 ---  232 2 ---  0FC 2 --- }
54DC: 0025 { 232 2 x--  0FC 2 ---  0FC 2 ---  0FC 2 --- }
54DD: 0145 { 202 2 ---  212 2 ---  203 2 ---  0FB 2 --- }
54DE: 0100 { 206 2 ---  0FB 2 ---  207 2 ---  0FB 2 --- }
54DF: 0148 { 204 2 ---  0FB 2 ---  205 2 ---  215 2 --- }
54E0: ~
54E1: 01AA { 0F8 2 ---  21A 2 ---  20B 2 ---  0FB 2 --- }
54E2: 01AF { 20B 2 x--  0FB 2 x--  0F8 2 x--  21A 2 x-- }
54E3: 01EC { 0FB 2 ---  0FB 2 ---  0FB 2 ---  0FB 2 --- }
54E4: 01ED { 0FB 2 ---  0FB 2 ---  0FB 2 ---  0FB 2 --- }
54E5: 0025 { 0FC 2 ---  0FC 2 ---  0FC 2 ---  22C 2 --- }
54E6: 0025 { 0FC 2 ---  22D 2 ---  0FC 2 ---  0FC 2 --- }
54E7: 0025 { 0FD 2 ---  0FD 2 ---  228 2 ---  238 2 --- }
54E8: 0025 { 229 2 ---  239 2 ---  0FD 2 ---  0FD 2 --- }
54E9: 0025 { 0FC 2 ---  0FC 2 ---  0FC 2 ---  220 2 --- }
54EA: 0025 { 0FC 2 ---  220 2 x--  0FC 2 ---  0FC 2 --- }
54EB: 0025 { 0FD 2 ---  0FD 2 ---  0FD 2 ---  221 2 --- }
54EC: 0025 { 0FD 2 ---  221 2 x--  0FD 2 ---  0FD 2 --- }
54ED: 014B { 208 2 ---  218 2 ---  0FB 2 ---  0FB 2 --- }
54EE: 0025 { 0FB 2 ---  0FB 2 ---  0FB 2 ---  0FB 2 --- }
54EF: 014C { 0FB 2 ---  0FB 2 ---  209 2 ---  219 2 --- }
54F0: 002B { 20E 1 ---  21E 1 ---  20F 1 ---  21F 1 --- }
54F1: 01E2 { 0FB 2 ---  0FB 2 ---  0FB 2 ---  0FB 2 --- }
54F2: 01E4 { 0FB 2 ---  0FB 2 ---  0FB 2 ---  0FB 2 --- }
54F3: 01C4 { 21A 2 -y-  0F8 2 -y-  0FB 2 -y-  20B 2 -y- }
54F4: 01C5 { 0FB 2 xy-  20B 2 xy-  21A 2 xy-  0F8 2 xy- }
54F5: 0025 { 0FC 2 ---  0FC 2 ---  23C 2 ---  0FC 2 --- }
54F6: 0025 { 23D 2 ---  0FC 2 ---  0FC 2 ---  0FC 2 --- }
54F7: 0025 { 0FD 2 ---  0FD 2 ---  22A 2 ---  23A 2 --- }
54F8: 0025 { 22B 2 ---  23B 2 ---  0FD 2 ---  0FD 2 --- }
54F9: 0025 { 0FC 2 ---  0FC 2 ---  230 2 ---  0FC 2 --- }
54FA: 0025 { 230 2 x--  0FC 2 ---  0FC 2 ---  0FC 2 --- }
54FB: 0025 { 0FD 2 ---  0FD 2 ---  231 2 ---  0FD 2 --- }
54FC: 0025 { 231 2 x--  0FD 2 ---  0FD 2 ---  0FD 2 --- }
54FD: 014D { 215 2 xy-  205 2 xy-  0FB 2 xy-  204 2 xy- }
54FE: 014E { 0FB 2 xy-  207 2 xy-  0FB 2 xy-  206 2 xy- }
54FF: 014F { 0FB 2 xy-  203 2 xy-  212 2 xy-  202 2 xy- }
