1200: 0145 { 180 2 ---  190 2 ---  181 2 ---  191 2 --- }
1201: 0145 { 182 2 ---  192 2 ---  183 2 ---  193 2 --- }
1202: 0145 { 184 2 ---  194 2 ---  185 2 ---  195 2 --- }
1203: 0150 { 186 2 ---  196 2 ---  187 2 ---  197 2 --- }
1204: 0150 { 188 2 ---  198 2 ---  189 2 ---  199 2 --- }
1205: 01AA { 0F8 2 ---  1D4 2 ---  1C5 2 ---  1D5 2 --- }
1206: 01AF { 1C5 2 x--  1D5 2 x--  0F8 2 x--  1D4 2 x-- }
1207: 0145 { 1C0 2 ---  1D0 2 ---  1C1 2 ---  1D1 2 --- }
1208: 0145 { 1C2 2 ---  1D2 2 ---  1C3 2 ---  1D3 2 --- }
1209: 0025 { 1F6 2 ---  0F8 2 ---  1F6 2 ---  0F8 2 --- }
120A: 0150 { 240 2 ---  242 2 ---  241 2 ---  243 2 --- }
120B: 0150 { 242 2 ---  242 2 ---  243 2 ---  243 2 --- }
120C: 0145 { 244 2 ---  246 2 ---  245 2 ---  247 2 --- }
120D: 0025 { 0F8 3 ---  206 3 ---  200 3 ---  207 3 --- }
120E: 0025 { 201 3 ---  208 3 ---  202 3 ---  209 3 --- }
120F: 0025 { 203 3 ---  20A 3 ---  204 3 ---  20B 3 --- }
1210: 0150 { 1A0 2 ---  1B0 2 ---  1A1 2 ---  1B1 2 --- }
1211: 0150 { 1A2 2 ---  1B2 2 ---  1A3 2 ---  1B3 2 --- }
1212: 0150 { 1A4 2 ---  1B4 2 ---  1A5 2 ---  1B5 2 --- }
1213: 0130 { 1A6 2 ---  1B6 2 ---  1A7 2 ---  1B7 2 --- }
1214: 0130 { 1EA 2 ---  1FA 2 ---  1EB 2 ---  1FB 2 --- }
1215: 01E2 { 1E4 2 ---  1F4 2 ---  1E5 2 ---  1F5 2 --- }
1216: 01E4 { 1E5 2 x--  1F5 2 x--  1E4 2 x--  1F4 2 x-- }
1217: 0150 { 1E0 2 ---  1F0 2 ---  1E1 2 ---  1F1 2 --- }
1218: 0150 { 1E2 2 ---  1F2 2 ---  1E3 2 ---  1F3 2 --- }
1219: 0025 { 1F7 2 ---  1F7 2 ---  0F8 2 ---  0F8 2 --- }
121A: 0150 { 242 2 -y-  240 2 -y-  243 2 -y-  241 2 -y- }
121B: 0145 { 23C 2 ---  23E 2 ---  23D 2 ---  23F 2 --- }
121C: 0025 { 0F8 2 ---  0F8 2 ---  236 2 ---  236 2 --- }
121D: 0025 { 237 2 ---  237 2 ---  0F8 2 ---  0F8 2 --- }
121E: 0025 { 0F8 2 ---  0F8 2 ---  238 2 ---  23A 2 --- }
121F: 0025 { 239 2 ---  23B 2 ---  0F8 2 ---  0F8 2 --- }
1220: 0025 { 205 3 ---  20C 3 ---  0F8 3 ---  20D 3 --- }
1221: 0025 { 20E 3 ---  215 3 ---  216 3 ---  216 3 --- }
1222: 0025 { 20F 3 ---  217 3 ---  210 3 ---  218 3 --- }
1223: 0025 { 211 3 ---  219 3 ---  212 3 ---  21A 3 --- }
1224: 0025 { 213 3 ---  21B 3 ---  214 3 ---  21C 3 --- }
1225: 0025 { 21D 3 ---  223 3 ---  216 3 ---  216 3 --- }
1226: 0025 { 21E 3 ---  216 3 ---  21F 3 ---  224 3 --- }
1227: 0025 { 220 3 ---  225 3 ---  221 3 ---  226 3 --- }
1228: 0025 { 222 3 ---  216 3 ---  216 3 ---  227 3 --- }
1229: 0025 { 228 3 ---  22A 3 ---  216 3 ---  22B 3 --- }
122A: 0025 { 216 3 ---  216 3 ---  216 3 ---  216 3 --- }
122B: 0025 { 216 3 ---  22C 3 ---  229 3 ---  22D 3 --- }
122C: 0025 { 0F8 3 ---  0F8 3 ---  22E 3 ---  0F8 3 --- }
122D: 0025 { 22F 3 ---  0F8 3 ---  230 3 ---  234 3 --- }
122E: 0025 { 231 3 ---  235 3 ---  232 3 ---  0F8 3 --- }
122F: 0025 { 233 3 ---  0F8 3 ---  0F8 3 ---  0F8 3 --- }
1230: 0145 { 1A8 2 ---  1B8 2 ---  1A9 2 ---  1B9 2 --- }
1231: 0145 { 1AA 2 ---  1BA 2 ---  1AB 2 ---  1BB 2 --- }
1232: 0145 { 1AC 2 ---  1BC 2 ---  1AD 2 ---  1BD 2 --- }
1233: 0025 { 18A 3 ---  19A 3 ---  18B 3 ---  19B 3 --- }
1234: 0025 { 18C 3 ---  19C 3 ---  18D 3 ---  0F8 3 --- }
1235: 0025 { 19C 3 ---  19C 3 ---  0F8 3 ---  0F8 3 --- }
1236: 0145 { 18E 2 ---  19E 2 ---  18F 2 ---  19F 2 --- }
1237: 0145 { 18F 2 ---  19F 2 ---  18F 2 ---  19F 2 --- }
1238: 0145 { 18F 2 ---  19F 2 ---  18E 2 ---  19E 2 --- }
1239: 0150 { 1C6 2 ---  1D6 2 ---  1C7 2 ---  1D7 2 --- }
123A: 0150 { 1C8 2 ---  1D8 2 ---  1C9 2 ---  1D9 2 --- }
123B: 0150 { 1CA 2 ---  1DA 2 ---  1CB 2 ---  1DB 2 --- }
123C: 0100 { 1AE 1 ---  1BE 1 ---  1AF 1 ---  1BF 1 --- }
123D: 0025 { 1CE 1 ---  1DE 1 ---  1CF 1 ---  1DF 1 --- }
123E: 0025 { 0FA 1 ---  0FA 1 ---  0FA 1 ---  0FA 1 --- }
123F: 0150 { 246 2 -y-  244 2 -y-  247 2 -y-  245 2 -y- }
1240: 0145 { 1E8 2 ---  1F8 2 ---  1E9 2 ---  1F9 2 --- }
1241: 0145 { 1EC 2 ---  1FC 2 ---  1ED 2 ---  1FD 2 --- }
1242: 0025 { 1CC 2 --p  1DC 2 --p  1CD 2 --p  1DD 2 --p }
1243: 0145 { 1AD 2 x--  1BD 2 x--  1AC 2 x--  1BC 2 x-- }
1244: 0145 { 1AB 2 x--  1BB 2 x--  1AA 2 x--  1BA 2 x-- }
1245: ~
1246: ~
1247: ~
1248: ~
1249: ~
124A: ~
124B: ~
124C: ~
124D: ~
124E: ~
124F: ~
1250: ~
1251: ~
1252: ~
1253: ~
1254: ~
1255: ~
1256: ~
1257: ~
1258: ~
1259: ~
125A: ~
125B: ~
125C: ~
125D: ~
125E: ~
125F: ~
1260: ~
1261: ~
1262: ~
1263: ~
1264: ~
1265: ~
1266: ~
1267: ~
1268: ~
1269: ~
126A: ~
126B: ~
126C: ~
126D: ~
126E: ~
126F: ~
1270: ~
1271: ~
1272: ~
1273: ~
1274: ~
1275: ~
1276: ~
1277: ~
1278: ~
1279: ~
127A: ~
127B: ~
127C: ~
127D: ~
127E: ~
127F: ~
1280: ~
1281: ~
1282: ~
1283: ~
1284: ~
1285: ~
1286: ~
1287: ~
1288: ~
1289: ~
128A: ~
128B: ~
128C: ~
128D: ~
128E: ~
128F: ~
1290: ~
1291: ~
1292: ~
1293: ~
1294: ~
1295: ~
1296: ~
1297: ~
1298: ~
1299: ~
129A: ~
129B: ~
129C: ~
129D: ~
129E: ~
129F: ~
12A0: ~
12A1: ~
12A2: ~
12A3: ~
12A4: ~
12A5: ~
12A6: ~
12A7: ~
12A8: ~
12A9: ~
12AA: ~
12AB: ~
12AC: ~
12AD: ~
12AE: ~
12AF: ~
12B0: ~
12B1: ~
12B2: ~
12B3: ~
12B4: ~
12B5: ~
12B6: ~
12B7: ~
12B8: ~
12B9: ~
12BA: ~
12BB: ~
12BC: ~
12BD: ~
12BE: ~
12BF: ~
12C0: ~
12C1: ~
12C2: ~
12C3: ~
12C4: ~
12C5: ~
12C6: ~
12C7: ~
12C8: ~
12C9: ~
12CA: ~
12CB: ~
12CC: ~
12CD: ~
12CE: ~
12CF: ~
12D0: ~
12D1: ~
12D2: ~
12D3: ~
12D4: ~
12D5: ~
12D6: ~
12D7: ~
12D8: ~
12D9: ~
12DA: ~
12DB: ~
12DC: ~
12DD: ~
12DE: ~
12DF: ~
12E0: ~
12E1: ~
12E2: ~
12E3: ~
12E4: ~
12E5: ~
12E6: ~
12E7: ~
12E8: ~
12E9: ~
12EA: ~
12EB: ~
12EC: ~
12ED: ~
12EE: ~
12EF: ~
12F0: ~
12F1: ~
12F2: ~
12F3: ~
12F4: ~
12F5: ~
12F6: ~
12F7: ~
12F8: ~
12F9: ~
12FA: ~
12FB: ~
12FC: ~
12FD: ~
12FE: ~
12FF: ~
