4500: 0025 { 080 4 ---  090 4 ---  081 4 ---  091 4 --- }
4501: 0025 { 080 4 ---  090 4 ---  081 4 ---  091 4 --- }
4502: 0025 { 080 4 ---  090 4 ---  081 4 ---  091 4 --- }
4503: 0025 { 080 4 ---  090 4 ---  081 4 ---  091 4 --- }
4504: 0025 { 080 4 ---  090 4 ---  081 4 ---  091 4 --- }
4505: 0025 { 080 4 ---  090 4 ---  081 4 ---  091 4 --- }
4506: 0025 { 080 4 ---  090 4 ---  081 4 ---  091 4 --- }
4507: 0025 { 080 4 ---  090 4 ---  081 4 ---  091 4 --- }
4508: 0025 { 080 4 ---  090 4 ---  081 4 ---  091 4 --- }
4509: 0025 { 080 4 ---  090 4 ---  081 4 ---  091 4 --- }
450A: 0025 { 080 4 ---  090 4 ---  081 4 ---  091 4 --- }
450B: 0025 { 080 4 ---  090 4 ---  081 4 ---  091 4 --- }
450C: ~
450D: ~
450E: 0025 { 0FA 6 --p  0FA 6 --p  0FA 6 --p  0FA 6 --p }
450F: 020C { 0FA 6 --p  0FA 6 --p  0FA 6 --p  0FA 6 --p }
4510: 0025 { 0FA 6 --p  2E2 6 --p  0FA 6 --p  2F1 6 --p }
4511: 0025 { 0FA 6 --p  2E5 6 --p  0FA 6 --p  2E5 6 --p }
4512: 0025 { 0FA 6 --p  2E4 6 --p  0FA 6 --p  2E4 6 --p }
4513: 0025 { 0FA 6 --p  0FA 6 --p  0FA 6 --p  2E1 6 --p }
4514: 0025 { 0FA 6 --p  2F4 6 --p  0FA 6 --p  2E4 6 --p }
4515: 0025 { 0FA 6 --p  2E0 6 --p  0FA 6 --p  2EA 6 --p }
4516: 0025 { 0FA 6 --p  2E8 6 --p  0FA 6 --p  2F6 6 --p }
4517: 0025 { 0FA 6 --p  2FD 6 --p  0FA 6 --p  2F5 6 --p }
4518: 0025 { 0FA 6 --p  2ED 6 --p  0FA 6 --p  0FA 6 --p }
4519: 0025 { 0FA 6 --p  2F8 6 --p  0FA 6 --p  2E0 6 --p }
451A: 0025 { 0FA 6 --p  2F0 6 --p  0FA 6 --p  2E8 6 --p }
451B: 0025 { 0FA 6 --p  2EB 6 --p  0FA 6 --p  2EB 6 --p }
451C: 0025 { 0FA 6 --p  2E0 6 --p  0FA 6 --p  0FA 6 --p }
451D: 0025 { 0FA 6 --p  2F4 6 --p  0FA 6 --p  2E0 6 --p }
451E: 0025 { 0FA 6 --p  2E8 6 --p  0FA 6 --p  2F0 6 --p }
451F: 0025 { 0FA 6 --p  002 6 --p  0FA 6 --p  002 6 --p }
4520: 0025 { 2F5 6 --p  0FA 6 --p  2F7 6 --p  0FA 6 --p }
4521: 0025 { 2F2 6 --p  2F5 6 --p  2E4 6 --p  2F6 6 --p }
4522: 0025 { 2F4 6 --p  2E0 6 --p  0FA 6 --p  2F4 6 --p }
4523: 0025 { 2F5 6 --p  2E1 6 --p  2F3 6 --p  2E0 6 --p }
4524: 0025 { 2F7 6 --p  2F5 6 --p  2E0 6 --p  2E4 6 --p }
4525: 0025 { 2E3 6 --p  0FA 6 --p  0FA 6 --p  0FA 6 --p }
4526: 0025 { 0FA 6 --p  2F2 6 --p  0FA 6 --p  2E0 6 --p }
4527: 0025 { 0FA 6 --p  2F4 6 --p  0FA 6 --p  2F4 6 --p }
4528: 0025 { 0FA 6 --p  2F1 6 --p  0FA 6 --p  2F6 6 --p }
4529: 0025 { 0FA 6 --p  0FA 6 --p  0FA 6 --p  2F2 6 --p }
452A: 0025 { 0FA 6 --p  2E0 6 --p  0FA 6 --p  2E3 6 --p }
452B: 0025 { 0FA 6 --p  0FA 6 --p  0FA 6 --p  2F0 6 --p }
452C: 0025 { 0FA 6 --p  2E0 6 --p  0FA 6 --p  2F1 6 --p }
452D: 0025 { 0FA 6 --p  003 6 --p  0FA 6 --p  002 6 --p }
452E: 0025 { 0FA 6 --p  003 6 --p  0FA 6 --p  002 6 --p }
452F: 0025 { 0FA 6 --p  003 6 --p  0FA 6 --p  002 6 --p }
4530: 0025 { 0FA 6 --p  2E8 6 --p  0FA 6 --p  2F6 6 --p }
4531: 0025 { 0FA 6 --p  0FA 6 --p  0FA 6 --p  2E2 6 --p }
4532: 0025 { 0FA 6 --p  2F1 6 --p  0FA 6 --p  2F0 6 --p }
4533: 0025 { 0FA 6 --p  2F6 6 --p  0FA 6 --p  2E8 6 --p }
4534: 0025 { 0FA 6 --p  2F0 6 --p  0FA 6 --p  2F7 6 --p }
4535: 0025 { 0FA 6 --p  2E4 6 --p  0FA 6 --p  2F5 6 --p }
4536: 0025 { 0FA 6 --p  2DF 6 --p  0FA 6 --p  2DF 6 --p }
4537: 0025 { 0FA 6 --p  2DF 6 --p  0FA 6 --p  0FA 6 --p }
4538: 0025 { 0FA 6 --p  2FF 6 --p  0FA 6 --p  2FF 6 --p }
4539: 0025 { 0FA 6 --p  2FF 6 --p  0FA 6 --p  0FA 6 --p }
453A: 0025 { 0FA 6 --p  2E1 6 --p  0FA 6 --p  2E8 6 --p }
453B: 0025 { 0FA 6 --p  2E6 6 --p  0FA 6 --p  0FA 6 --p }
453C: 0025 { 0FA 6 --p  2E1 6 --p  0FA 6 --p  2F4 6 --p }
453D: 0025 { 0FA 6 --p  2E0 6 --p  0FA 6 --p  2F9 6 --p }
453E: 0025 { 0FA 6 --p  2EB 6 --p  0FA 6 --p  2E4 6 --p }
453F: 0025 { 0FA 6 --p  2F4 6 --p  0FA 6 --p  0FA 6 --p }
4540: 0025 { 0FA 6 --p  2F6 6 --p  0FA 6 --p  2E7 6 --p }
4541: 0025 { 0FA 6 --p  2E4 6 --p  0FA 6 --p  0FA 6 --p }
4542: 0025 { 0FA 6 --p  2E5 6 --p  0FA 6 --p  2E8 6 --p }
4543: 0025 { 0FA 6 --p  2F0 6 --p  0FA 6 --p  2E0 6 --p }
4544: 0025 { 0FA 6 --p  2EB 6 --p  0FA 6 --p  0FA 6 --p }
4545: 0025 { 0FA 6 --p  2E5 6 --p  0FA 6 --p  2F4 6 --p }
4546: 0025 { 0FA 6 --p  2E0 6 --p  0FA 6 --p  2E2 6 --p }
4547: 0025 { 0FA 6 --p  2E0 6 --p  0FA 6 --p  2F5 6 --p }
4548: 0025 { 0FA 6 --p  2F5 6 --p  0FA 6 --p  2E0 6 --p }
4549: 0025 { 0FA 6 --p  2E9 6 --p  0FA 6 --p  2E4 6 --p }
454A: 0025 { 0FA 6 --p  2F9 6 --p  0FA 6 --p  2E4 6 --p }
454B: 0025 { 0FA 6 --p  2F4 6 --p  0FA 6 --p  2F5 6 --p }
454C: 0025 { 0FA 6 --p  2E1 6 --p  0FA 6 --p  2F7 6 --p }
454D: 0025 { 0FA 6 --p  2EC 6 --p  0FA 6 --p  2F2 6 --p }
454E: 0025 { 0FA 6 --p  2F6 6 --p  0FA 6 --p  2FB 6 --p }
454F: 0025 { 0FA 6 --p  002 6 --p  0FA 6 --p  002 6 --p }
4550: 0025 { 0FA 6 --p  2F2 6 --p  0FA 6 --p  2F5 6 --p }
4551: 0025 { 0FA 6 --p  2E8 6 --p  0FA 6 --p  0FA 6 --p }
4552: 0025 { 0FA 6 --p  2F0 6 --p  0FA 6 --p  2E8 6 --p }
4553: 0025 { 0FA 6 --p  2F0 6 --p  0FA 6 --p  2E9 6 --p }
4554: 0025 { 0FA 6 --p  2E0 6 --p  0FA 6 --p  0FA 6 --p }
4555: 0025 { 0FA 6 --p  2CB 6 --p  0FA 6 --p  2F5 6 --p }
4556: 0025 { 0FA 6 --p  2E4 6 --p  0FA 6 --p  2E0 6 --p }
4557: 0025 { 0FA 6 --p  2F5 6 --p  0FA 6 --p  2F1 6 --p }
4558: 0025 { 0FA 6 --p  2F0 6 --p  0FA 6 --p  0FA 6 --p }
4559: 0025 { 0FA 6 --p  0FA 6 --p  0FA 6 --p  2E9 6 --p }
455A: 0025 { 0FA 6 --p  2F1 6 --p  0FA 6 --p  2EB 6 --p }
455B: 0025 { 0FA 6 --p  2F2 6 --p  0FA 6 --p  2E4 6 --p }
455C: 0025 { 0FA 6 --p  2F0 6 --p  0FA 6 --p  2E6 6 --p }
455D: 0025 { 0FA 6 --p  2E0 6 --p  0FA 6 --p  2EC 6 --p }
455E: 0025 { 0FA 6 --p  2EC 6 --p  0FA 6 --p  2EB 6 --p }
455F: 0025 { 0FA 6 --p  2E4 6 --p  0FA 6 --p  2F4 6 --p }
4560: 0025 { 0FA 6 --p  2E6 6 --p  0FA 6 --p  2F0 6 --p }
4561: 0025 { 0FA 6 --p  2E0 6 --p  0FA 6 --p  2F4 6 --p }
4562: 0025 { 0FA 6 --p  2EB 6 --p  0FA 6 --p  2FB 6 --p }
4563: 0025 { 0FA 6 --p  2F6 6 --p  0FA 6 --p  2F7 6 --p }
4564: 0025 { 0FA 6 --p  2E1 6 --p  0FA 6 --p  2EB 6 --p }
4565: 0025 { 0FA 6 --p  2E0 6 --p  0FA 6 --p  2F4 6 --p }
4566: 0025 { 0FA 6 --p  2F9 6 --p  0FA 6 --p  2E0 6 --p }
4567: 0025 { 0FA 6 --p  2FB 6 --p  0FA 6 --p  0FA 6 --p }
4568: 0025 { 0FA 6 --p  2E2 6 --p  0FA 6 --p  2F1 6 --p }
4569: 0025 { 0FA 6 --p  2F1 6 --p  0FA 6 --p  2EB 6 --p }
456A: 0025 { 0FA 6 --p  2F1 6 --p  0FA 6 --p  2F7 6 --p }
456B: 0025 { 0FA 6 --p  2F6 6 --p  0FA 6 --p  2F4 6 --p }
456C: 0025 { 0FA 6 --p  2E0 6 --p  0FA 6 --p  2E6 6 --p }
456D: 0025 { 0FA 6 --p  2E4 6 --p  0FA 6 --p  2F1 6 --p }
456E: 0025 { 0FA 6 --p  2F7 6 --p  0FA 6 --p  2F5 6 --p }
456F: 0025 { 0FA 6 --p  003 6 --p  0FA 6 --p  002 6 --p }
4570: 0025 { 2E3 6 --p  2E1 6 --p  2F1 6 --p  2E4 6 --p }
4571: 0025 { 2E3 6 --p  2E4 6 --p  2E6 6 --p  2E5 6 --p }
4572: 0025 { 2E4 6 --p  2F5 6 --p  0FA 6 --p  2F6 6 --p }
4573: 0025 { 2F6 6 --p  2E4 6 --p  2E7 6 --p  2E0 6 --p }
4574: 0025 { 2E4 6 --p  2EA 6 --p  0FA 6 --p  2ED 6 --p }
4575: 0025 { 0FA 6 --p  2F6 6 --p  0FA 6 --p  2E7 6 --p }
4576: 0025 { 0FA 6 --p  2E4 6 --p  0FA 6 --p  0FA 6 --p }
4577: 0025 { 0FA 6 --p  2EC 6 --p  0FA 6 --p  2E0 6 --p }
4578: 0025 { 0FA 6 --p  2F0 6 --p  0FA 6 --p  2F5 6 --p }
4579: 0025 { 0FA 6 --p  2E8 6 --p  0FA 6 --p  2F1 6 --p }
457A: 0025 { 0FA 6 --p  2F0 6 --p  0FA 6 --p  0FA 6 --p }
457B: 0025 { 0FA 6 --p  2F5 6 --p  0FA 6 --p  2F1 6 --p }
457C: 0025 { 0FA 6 --p  2E3 6 --p  0FA 6 --p  2E0 6 --p }
457D: 0025 { 0FA 6 --p  0FA 6 --p  0FA 6 --p  2EB 6 --p }
457E: 0025 { 0FA 6 --p  2E0 6 --p  0FA 6 --p  2EA 6 --p }
457F: 0025 { 0FA 6 --p  2E4 6 --p  0FA 6 --p  0FA 6 --p }
4580: 0025 { 0FA 6 --p  2E7 6 --p  0FA 6 --p  2F1 6 --p }
4581: 0025 { 0FA 6 --p  2EC 6 --p  0FA 6 --p  2E4 6 --p }
4582: 0025 { 0FA 6 --p  0FA 6 --p  0FA 6 --p  2F4 6 --p }
4583: 0025 { 0FA 6 --p  2F7 6 --p  0FA 6 --p  2F0 6 --p }
4584: 0025 { 0FA 6 --p  0FA 6 --p  0FA 6 --p  2E3 6 --p }
4585: 0025 { 0FA 6 --p  2E4 6 --p  0FA 6 --p  2F4 6 --p }
4586: 0025 { 0FA 6 --p  2E1 6 --p  0FA 6 --p  2FB 6 --p }
4587: 0025 { 2F1 6 --p  2F6 6 --p  2F8 6 --p  2F1 6 --p }
4588: 0025 { 2E4 6 --p  0FA 6 --p  2F4 6 --p  2E4 6 --p }
4589: 0025 { 2F2 6 --p  2EC 6 --p  2E0 6 --p  2F2 6 --p }
458A: 0025 { 2F5 6 --p  2E8 6 --p  2F5 6 --p  2F4 6 --p }
458B: 0025 { 0FA 6 --p  2E4 6 --p  0FA 6 --p  0FA 6 --p }
458C: 0025 { 0FA 6 --p  003 6 --p  0FA 6 --p  002 6 --p }
458D: 0025 { 0FA 6 --p  003 6 --p  0FA 6 --p  002 6 --p }
458E: 0025 { 0FA 6 --p  003 6 --p  0FA 6 --p  002 6 --p }
458F: 0025 { 0FA 6 --p  003 6 --p  0FA 6 --p  002 6 --p }
4590: 0025 { 2F4 6 --p  2F5 6 --p  2E0 6 --p  2F6 6 --p }
4591: 0025 { 2F0 6 --p  2E0 6 --p  2E3 6 --p  2F6 6 --p }
4592: 0025 { 2F1 6 --p  2F7 6 --p  2EC 6 --p  2E4 6 --p }
4593: 0025 { 0FA 6 --p  2F5 6 --p  2E1 6 --p  2CF 6 --p }
4594: 0025 { 2F1 6 --p  0FA 6 --p  2F9 6 --p  2E8 6 --p }
4595: 0025 { 2F5 6 --p  2F0 6 --p  2E4 6 --p  2E2 6 --p }
4596: 0025 { 2F4 6 --p  2DF 6 --p  0FA 6 --p  0FA 6 --p }
4597: 0025 { 2E7 6 --p  0FA 6 --p  2E0 6 --p  0FA 6 --p }
4598: 0025 { 2EA 6 --p  2EF 6 --p  2F7 6 --p  2CD 6 --p }
4599: 0025 { 2F4 6 --p  0FA 6 --p  2E4 6 --p  2CE 6 --p }
459A: 0025 { 2E8 6 --p  2E4 6 --p  0FA 6 --p  2E0 6 --p }
459B: 0025 { 2F5 6 --p  2F5 6 --p  2E7 6 --p  2FB 6 --p }
459C: 0025 { 2F4 6 --p  2DE 6 --p  2E8 6 --p  0FA 6 --p }
459D: 0025 { 2F0 6 --p  0FA 6 --p  2E4 6 --p  0FA 6 --p }
459E: 0025 { 0FA 6 --p  003 6 --p  0FA 6 --p  002 6 --p }
459F: 0025 { 0FA 6 --p  003 6 --p  0FA 6 --p  002 6 --p }
45A0: 0025 { 0FA 6 --p  0FA 6 --p  2E6 6 --p  2CE 6 --p }
45A1: 0025 { 2F4 6 --p  2E5 6 --p  2E4 6 --p  2E0 6 --p }
45A2: 0025 { 2E0 6 --p  2EC 6 --p  2F6 6 --p  2F1 6 --p }
45A3: 0025 { 0FA 6 --p  2F7 6 --p  2E1 6 --p  2F5 6 --p }
45A4: 0025 { 2F7 6 --p  0FA 6 --p  2E3 6 --p  2EB 6 --p }
45A5: 0025 { 2E3 6 --p  2E0 6 --p  2E7 6 --p  2F0 6 --p }
45A6: 0025 { 2E0 6 --p  2E3 6 --p  0FA 6 --p  2EC 6 --p }
45A7: 0025 { 2E7 6 --p  2E0 6 --p  2E0 6 --p  2F4 6 --p }
45A8: 0025 { 2EB 6 --p  2EA 6 --p  2EB 6 --p  2DE 6 --p }
45A9: 0025 { 0FA 6 --p  2E7 6 --p  0FA 6 --p  2F1 6 --p }
45AA: 0025 { 0FA 6 --p  2F4 6 --p  0FA 6 --p  2F0 6 --p }
45AB: 0025 { 0FA 6 --p  2E4 6 --p  0FA 6 --p  2F6 6 --p }
45AC: 0025 { 0FA 6 --p  0FA 6 --p  0FA 6 --p  2E7 6 --p }
45AD: 0025 { 0FA 6 --p  2F1 6 --p  0FA 6 --p  2EB 6 --p }
45AE: 0025 { 0FA 6 --p  2E4 6 --p  0FA 6 --p  0FA 6 --p }
45AF: 0025 { 0FA 6 --p  003 6 --p  0FA 6 --p  002 6 --p }
45B0: 0025 { 0FA 6 --p  2E7 6 --p  0FA 6 --p  2E0 6 --p }
45B1: 0025 { 0FA 6 --p  2E8 6 --p  0FA 6 --p  2EC 6 --p }
45B2: 0025 { 0FA 6 --p  2E0 6 --p  0FA 6 --p  2F4 6 --p }
45B3: 0025 { 0FA 6 --p  2E8 6 --p  0FA 6 --p  0FA 6 --p }
45B4: 0025 { 0FA 6 --p  2E2 6 --p  0FA 6 --p  2E7 6 --p }
45B5: 0025 { 0FA 6 --p  2E0 6 --p  0FA 6 --p  2EB 6 --p }
45B6: 0025 { 0FA 6 --p  2EB 6 --p  0FA 6 --p  2E4 6 --p }
45B7: 0025 { 0FA 6 --p  2F0 6 --p  0FA 6 --p  2E6 6 --p }
45B8: 0025 { 0FA 6 --p  2E4 6 --p  0FA 6 --p  0FA 6 --p }
45B9: 0025 { 0FA 6 --p  2E3 6 --p  0FA 6 --p  2E0 6 --p }
45BA: 0025 { 0FA 6 --p  2E8 6 --p  0FA 6 --p  2F4 6 --p }
45BB: 0025 { 0FA 6 --p  2FB 6 --p  0FA 6 --p  0FA 6 --p }
45BC: 0025 { 0FA 6 --p  2E3 6 --p  0FA 6 --p  2E8 6 --p }
45BD: 0025 { 0FA 6 --p  2F5 6 --p  0FA 6 --p  2E0 6 --p }
45BE: 0025 { 0FA 6 --p  2F5 6 --p  0FA 6 --p  2F6 6 --p }
45BF: 0025 { 0FA 6 --p  2E4 6 --p  0FA 6 --p  2F4 6 --p }
45C0: 0025 { 0FA 6 --p  2E0 6 --p  0FA 6 --p  0FA 6 --p }
45C1: 0025 { 0FA 6 --p  2E7 6 --p  0FA 6 --p  2F1 6 --p }
45C2: 0025 { 0FA 6 --p  2F0 6 --p  0FA 6 --p  2E4 6 --p }
45C3: 0025 { 0FA 6 --p  2FB 6 --p  0FA 6 --p  2F2 6 --p }
45C4: 0025 { 0FA 6 --p  2F1 6 --p  0FA 6 --p  2F6 6 --p }
45C5: 0025 { 0FA 6 --p  0FA 6 --p  0FA 6 --p  2F6 6 --p }
45C6: 0025 { 0FA 6 --p  2F4 6 --p  0FA 6 --p  2E0 6 --p }
45C7: 0025 { 0FA 6 --p  2F2 6 --p  0FA 6 --p  0FA 6 --p }
45C8: 0025 { 0FA 6 --p  2E2 6 --p  0FA 6 --p  2E7 6 --p }
45C9: 0025 { 0FA 6 --p  2F1 6 --p  0FA 6 --p  2E2 6 --p }
45CA: 0025 { 0FA 6 --p  2F1 6 --p  0FA 6 --p  2EB 6 --p }
45CB: 0025 { 0FA 6 --p  2E0 6 --p  0FA 6 --p  2F6 6 --p }
45CC: 0025 { 0FA 6 --p  2E4 6 --p  0FA 6 --p  0FA 6 --p }
45CD: 0025 { 0FA 6 --p  2E2 6 --p  0FA 6 --p  2E0 6 --p }
45CE: 0025 { 0FA 6 --p  2F5 6 --p  0FA 6 --p  2F6 6 --p }
45CF: 0025 { 0FA 6 --p  2EB 6 --p  0FA 6 --p  2E4 6 --p }
45D0: 0025 { 0FA 6 --p  2F1 6 --p  0FA 6 --p  2F8 6 --p }
45D1: 0025 { 0FA 6 --p  2E4 6 --p  0FA 6 --p  2F4 6 --p }
45D2: 0025 { 0FA 6 --p  0FA 6 --p  0FA 6 --p  2F6 6 --p }
45D3: 0025 { 0FA 6 --p  2E7 6 --p  0FA 6 --p  2E4 6 --p }
45D4: 0025 { 0FA 6 --p  2F4 6 --p  0FA 6 --p  2E4 6 --p }
45D5: 0025 { 0FA 6 --p  2DF 6 --p  0FA 6 --p  2DF 6 --p }
45D6: 0025 { 0FA 6 --p  2DF 6 --p  0FA 6 --p  0FA 6 --p }
45D7: 0025 { 0FA 6 --p  2EC 6 --p  0FA 6 --p  2F1 6 --p }
45D8: 0025 { 0FA 6 --p  2F0 6 --p  0FA 6 --p  2E3 6 --p }
45D9: 0025 { 0FA 6 --p  2F4 6 --p  0FA 6 --p  2E8 6 --p }
45DA: 0025 { 0FA 6 --p  2E0 6 --p  0FA 6 --p  2F0 6 --p }
45DB: 0025 { 0FA 6 --p  0FA 6 --p  0FA 6 --p  2F2 6 --p }
45DC: 0025 { 0FA 6 --p  2E0 6 --p  0FA 6 --p  2EB 6 --p }
45DD: 0025 { 0FA 6 --p  2E0 6 --p  0FA 6 --p  2E2 6 --p }
45DE: 0025 { 0FA 6 --p  2E4 6 --p  0FA 6 --p  0FA 6 --p }
45DF: 0025 { 0FA 6 --p  002 6 --p  0FA 6 --p  002 6 --p }
45E0: 0025 { 2F6 6 --p  0FA 6 --p  2E7 6 --p  0FA 6 --p }
45E1: 0025 { 2E4 6 --p  2F1 6 --p  0FA 6 --p  2E5 6 --p }
45E2: 0025 { 2EC 6 --p  0FA 6 --p  2E4 6 --p  2F5 6 --p }
45E3: 0025 { 2E0 6 --p  2E7 6 --p  2F0 6 --p  2E0 6 --p }
45E4: 0025 { 2E8 6 --p  2F4 6 --p  2F0 6 --p  2F2 6 --p }
45E5: 0025 { 2E6 6 --p  0FA 6 --p  0FA 6 --p  0FA 6 --p }
45E6: 0025 { 0FA 6 --p  2F6 6 --p  0FA 6 --p  2E7 6 --p }
45E7: 0025 { 0FA 6 --p  2E4 6 --p  0FA 6 --p  0FA 6 --p }
45E8: 0025 { 0FA 6 --p  2E6 6 --p  0FA 6 --p  2F4 6 --p }
45E9: 0025 { 0FA 6 --p  2E4 6 --p  0FA 6 --p  2E0 6 --p }
45EA: 0025 { 0FA 6 --p  2F6 6 --p  0FA 6 --p  0FA 6 --p }
45EB: 0025 { 0FA 6 --p  2F2 6 --p  0FA 6 --p  2E8 6 --p }
45EC: 0025 { 0FA 6 --p  2F6 6 --p  0FA 6 --p  0FA 6 --p }
45ED: 0025 { 0FA 6 --p  2E5 6 --p  0FA 6 --p  2F7 6 --p }
45EE: 0025 { 0FA 6 --p  2F0 6 --p  0FA 6 --p  2EA 6 --p }
45EF: 0025 { 0FA 6 --p  2FB 6 --p  0FA 6 --p  0FA 6 --p }
45F0: 0025 { 0FA 6 --p  2EC 6 --p  0FA 6 --p  2E8 6 --p }
45F1: 0025 { 0FA 6 --p  2F5 6 --p  0FA 6 --p  2F1 6 --p }
45F2: 0025 { 0FA 6 --p  0FA 6 --p  0FA 6 --p  2F5 6 --p }
45F3: 0025 { 0FA 6 --p  2F1 6 --p  0FA 6 --p  2F7 6 --p }
45F4: 0025 { 0FA 6 --p  2F2 6 --p  0FA 6 --p  0FA 6 --p }
45F5: 0025 { 0FA 6 --p  2E3 6 --p  0FA 6 --p  2E4 6 --p }
45F6: 0025 { 0FA 6 --p  2EB 6 --p  0FA 6 --p  2F6 6 --p }
45F7: 0025 { 0FA 6 --p  2E8 6 --p  0FA 6 --p  2F0 6 --p }
45F8: 0025 { 0FA 6 --p  2F7 6 --p  0FA 6 --p  2F5 6 --p }
45F9: 0025 { 0FA 6 --p  0FA 6 --p  0FA 6 --p  2E2 6 --p }
45FA: 0025 { 0FA 6 --p  2E0 6 --p  0FA 6 --p  2F5 6 --p }
45FB: 0025 { 0FA 6 --p  2F6 6 --p  0FA 6 --p  2EB 6 --p }
45FC: 0025 { 0FA 6 --p  2E4 6 --p  0FA 6 --p  0FA 6 --p }
45FD: 0025 { 0FA 6 --p  003 6 --p  0FA 6 --p  002 6 --p }
45FE: 0025 { 0FA 6 --p  003 6 --p  0FA 6 --p  002 6 --p }
45FF: 0025 { 0FA 6 --p  003 6 --p  0FA 6 --p  002 6 --p }
