6800: 0025 { 100 7 ---  103 7 ---  101 7 ---  2F1 7 --- }
6801: 0025 { 101 7 ---  2F1 7 ---  101 7 ---  2F1 7 --- }
6802: 0025 { 101 7 ---  2F1 7 ---  102 7 ---  104 7 --- }
6803: 0025 { 15B 5 ---  15E 5 ---  15C 5 ---  0FC 4 --- }
6804: 0025 { 15C 5 ---  0FC 4 ---  15C 5 ---  0FC 4 --- }
6805: 0025 { 15C 5 ---  0FC 4 ---  15D 5 ---  15F 4 --- }
6806: 0025 { 1AE 5 ---  1B1 5 ---  1AF 5 ---  0FD 4 --- }
6807: 0025 { 1AF 5 ---  0FD 4 ---  1AF 5 ---  0FD 4 --- }
6808: 0025 { 1AF 5 ---  0FD 4 ---  1B0 5 ---  1B2 4 --- }
6809: 0025 { 0FE 1 ---  0FE 1 ---  0FE 1 ---  0FE 1 --- }
680A: 0025 { 0FE 1 ---  0FE 1 ---  0FE 1 ---  0FE 1 --- }
680B: 0025 { 0FE 1 ---  0FE 1 ---  0FE 1 ---  0FE 1 --- }
680C: 0025 { 0FE 1 ---  0FE 1 ---  0FE 1 ---  0FE 1 --- }
680D: 0025 { 0FE 1 ---  0FE 1 ---  106 4 ---  10D 4 --- }
680E: 0025 { 107 4 ---  10E 4 ---  108 4 ---  108 4 --- }
680F: 0025 { 0FE 1 ---  0FE 1 ---  0FE 1 ---  0FE 1 --- }
6810: 0025 { 105 7 ---  108 7 ---  106 7 ---  109 7 --- }
6811: 0025 { 106 7 ---  109 7 ---  106 7 ---  109 7 --- }
6812: 0025 { 106 7 ---  109 7 ---  107 7 ---  108 7 x-- }
6813: 0025 { 15E 5 ---  160 4 ---  0FC 4 ---  161 4 --- }
6814: 0025 { 0FC 4 ---  161 4 ---  0FC 4 ---  161 4 --- }
6815: 0025 { 0FC 4 ---  161 4 ---  15F 4 ---  160 4 x-- }
6816: 0025 { 1B1 5 ---  1B3 7 ---  0FD 4 ---  1B4 7 --- }
6817: 0025 { 0FD 4 ---  1B4 7 ---  0FD 4 ---  1B4 7 --- }
6818: 0025 { 0FD 4 ---  1B4 7 ---  1B2 4 ---  1B3 7 x-- }
6819: 0025 { 121 5 ---  14C 5 ---  122 5 ---  14D 5 --- }
681A: 0025 { 123 5 ---  14E 5 ---  124 5 ---  14F 1 --- }
681B: 0025 { 125 5 ---  150 5 ---  126 5 ---  151 5 --- }
681C: 0025 { 127 5 ---  152 5 ---  128 5 ---  153 5 --- }
681D: 0025 { 129 5 ---  154 5 ---  12A 5 ---  155 5 --- }
681E: 0025 { 10E 4 ---  10E 4 ---  12B 4 ---  156 1 --- }
681F: 0025 { 12C 5 ---  157 5 ---  12D 5 ---  158 5 --- }
6820: 0025 { 100 5 ---  103 5 ---  101 5 ---  286 4 --- }
6821: 0025 { 101 5 ---  286 4 ---  101 5 ---  286 4 --- }
6822: 0025 { 101 5 ---  286 4 ---  102 5 ---  104 4 --- }
6823: 0025 { 169 7 ---  16C 7 ---  16A 7 ---  0FC 7 --- }
6824: 0025 { 16A 7 ---  0FC 7 ---  16A 7 ---  0FC 7 --- }
6825: 0025 { 16A 7 ---  0FC 7 ---  16B 7 ---  16D 7 --- }
6826: 0025 { 1C1 5 ---  1C4 5 ---  1C2 5 ---  08E 4 --- }
6827: 0025 { 1C2 5 ---  08E 4 ---  1C2 5 ---  08E 4 --- }
6828: 0025 { 1C2 5 ---  08E 4 ---  1C3 5 ---  1C5 4 --- }
6829: 0025 { 177 4 ---  1A2 4 ---  178 4 ---  1A3 4 --- }
682A: 0025 { 179 4 ---  1A4 4 ---  17A 4 ---  1A5 4 --- }
682B: 0025 { 17B 4 ---  1A6 1 ---  17C 4 ---  1A7 1 --- }
682C: 0025 { 17D 4 ---  1A8 5 ---  17E 4 ---  1A9 4 --- }
682D: 0025 { 17F 4 ---  1AA 4 ---  180 4 ---  1AB 4 --- }
682E: 0025 { 10E 4 ---  10E 4 ---  181 4 ---  1AC 4 --- }
682F: 0025 { 182 4 ---  1AD 4 ---  183 4 ---  1AE 4 --- }
6830: 0025 { 103 5 ---  105 5 ---  286 4 ---  106 4 --- }
6831: 0025 { 286 4 ---  106 4 ---  286 4 ---  106 4 --- }
6832: 0025 { 286 4 ---  106 4 ---  104 4 ---  107 4 --- }
6833: 0025 { 16C 7 ---  16E 5 ---  0FC 7 ---  16F 7 --- }
6834: 0025 { 0FC 7 ---  16F 7 ---  0FC 7 ---  16F 7 --- }
6835: 0025 { 0FC 7 ---  16F 7 ---  16D 7 ---  170 7 --- }
6836: 0025 { 1C4 5 ---  1C6 5 ---  08E 4 ---  1C7 4 --- }
6837: 0025 { 08E 4 ---  1C7 4 ---  08E 4 ---  1C7 4 --- }
6838: 0025 { 08E 4 ---  1C7 4 ---  1C5 4 ---  1C8 4 --- }
6839: 0025 { 1CF 4 ---  1FC 5 ---  1D0 4 ---  1FD 5 --- }
683A: 0025 { 1D1 4 ---  1FE 5 ---  1D2 4 ---  1FF 4 --- }
683B: 0025 { 1D3 4 ---  200 4 ---  1D4 4 ---  201 4 --- }
683C: 0025 { 1D5 4 ---  202 4 ---  1D6 4 ---  203 4 --- }
683D: 0025 { 1D7 4 ---  204 5 ---  1D8 4 ---  205 4 --- }
683E: 0025 { 10E 4 ---  107 4 -y-  1D9 4 ---  206 4 --- }
683F: 0025 { 1DA 4 ---  207 4 ---  1DB 4 ---  208 4 --- }
6840: 0025 { 21B 7 ---  21D 7 ---  21C 7 ---  21E 7 --- }
6841: 0025 { 21C 7 ---  21F 7 ---  21C 7 ---  220 7 --- }
6842: 0025 { 21C 7 ---  221 7 ---  21C 7 ---  222 7 --- }
6843: 0025 { 21C 7 ---  223 7 ---  21C 7 ---  224 7 --- }
6844: 0025 { 21C 7 ---  225 7 ---  21C 7 ---  226 7 --- }
6845: 0025 { 21C 7 ---  21E 7 ---  21C 7 ---  21F 7 --- }
6846: 0025 { 21C 7 ---  220 7 ---  21C 7 ---  221 7 --- }
6847: 0025 { 21C 7 ---  227 7 ---  21B 7 x--  21D 7 x-- }
6848: ~
6849: 0025 { 0FE 1 ---  0FE 1 ---  0FE 1 ---  0FE 1 --- }
684A: 0025 { 0FE 1 ---  0FE 1 ---  0FE 1 ---  0FE 1 --- }
684B: 0025 { 0FE 1 ---  0FE 1 ---  0FE 1 ---  0FE 1 --- }
684C: 0025 { 109 4 ---  10C 4 x--  10A 4 ---  10B 4 x-- }
684D: 0025 { 101 1 ---  103 1 ---  102 1 ---  0FA 1 --- }
684E: 0025 { 102 1 ---  0FA 1 ---  102 1 ---  0FA 1 --- }
684F: 0025 { 102 1 ---  0FA 1 ---  101 1 x--  103 1 x-- }
6850: 0025 { 21D 7 ---  21D 7 ---  21E 7 ---  21E 7 --- }
6851: 0025 { 21F 7 -y-  22B 7 ---  228 7 ---  22C 7 --- }
6852: 0025 { 221 7 -y-  22D 7 ---  222 7 ---  222 7 --- }
6853: 0025 { 223 7 ---  22E 7 ---  229 7 ---  22F 7 --- }
6854: 0025 { 22A 7 ---  230 7 ---  226 7 ---  231 7 --- }
6855: 0025 { 21E 7 ---  21E 7 ---  21F 7 -y-  22B 7 --- }
6856: 0025 { 228 7 ---  22C 7 ---  221 7 -y-  22D 7 --- }
6857: 0025 { 227 7 ---  227 7 ---  21D 7 x--  21D 7 x-- }
6858: ~
6859: 0025 { 12E 5 ---  159 5 ---  12F 5 ---  15A 5 --- }
685A: 0025 { 130 5 ---  15B 5 ---  131 5 ---  15C 5 --- }
685B: 0025 { 132 4 ---  15D 1 ---  133 5 ---  15E 1 --- }
685C: 0025 { 134 4 ---  15F 4 ---  10B 4 x--  10B 4 x-- }
685D: 0025 { 103 1 ---  101 1 -y-  0FA 1 ---  102 1 -y- }
685E: 0025 { 0FA 1 ---  102 1 -y-  0FA 1 ---  102 1 -y- }
685F: 0025 { 0FA 1 ---  102 1 -y-  103 1 x--  101 1 xy- }
6860: 0025 { 21D 7 ---  21D 7 ---  21E 7 ---  238 7 --- }
6861: 0025 { 232 7 ---  239 7 ---  233 7 ---  239 7 --- }
6862: 0025 { 233 7 ---  239 7 ---  222 7 ---  23A 7 --- }
6863: 0025 { 234 7 ---  239 7 ---  235 7 ---  23B 7 --- }
6864: 0025 { 236 7 ---  23C 7 ---  237 7 ---  23D 7 --- }
6865: 0025 { 21E 7 ---  238 7 ---  232 7 ---  239 7 --- }
6866: 0025 { 233 7 ---  239 7 ---  233 7 ---  239 7 --- }
6867: 0025 { 227 7 ---  23E 7 ---  21D 7 x--  21D 7 x-- }
6868: ~
6869: 0025 { 184 5 ---  1AF 1 ---  185 4 ---  1B0 1 --- }
686A: 0025 { 186 4 ---  1B1 4 ---  187 4 ---  1B2 4 --- }
686B: 0025 { 188 4 ---  1B3 1 ---  189 1 ---  1B4 1 --- }
686C: 0025 { 15F 4 ---  1B5 4 ---  10B 4 x--  10B 4 x-- }
686D: 0025 { 210 7 ---  213 7 ---  211 7 ---  214 7 --- }
686E: 0025 { 211 7 ---  214 7 ---  211 7 ---  214 7 --- }
686F: 0025 { 211 7 ---  214 7 ---  212 7 ---  215 7 --- }
6870: 0025 { 23F 7 ---  243 7 ---  240 7 ---  244 7 --- }
6871: 0025 { 241 7 ---  245 7 ---  241 7 ---  245 7 --- }
6872: 0025 { 241 7 ---  245 7 ---  241 7 ---  245 7 --- }
6873: 0025 { 241 7 ---  245 7 ---  241 7 ---  245 7 --- }
6874: 0025 { 242 7 ---  246 7 ---  214 7 ---  245 7 --- }
6875: 0025 { 214 7 ---  245 7 ---  214 7 ---  245 7 --- }
6876: 0025 { 214 7 ---  245 7 ---  214 7 ---  245 7 --- }
6877: 0025 { 214 7 ---  245 7 ---  21D 7 x--  247 7 --- }
6878: ~
6879: 0025 { 1DC 4 ---  209 4 ---  1DD 4 ---  20A 4 --- }
687A: 0025 { 1DE 5 ---  20B 4 ---  1DF 4 ---  20C 4 --- }
687B: 0025 { 1E0 4 ---  20D 4 ---  1E1 4 ---  20E 5 --- }
687C: 0025 { 1E2 4 ---  20F 4 ---  10B 4 x--  10A 4 -y- }
687D: 0025 { 216 7 ---  219 7 ---  217 7 ---  21A 7 --- }
687E: 0025 { 217 7 ---  21A 7 ---  217 7 ---  21A 7 --- }
687F: 0025 { 217 7 ---  21A 7 ---  218 7 ---  219 7 x-- }
6880: ~
6881: ~
6882: ~
6883: ~
6884: ~
6885: ~
6886: ~
6887: ~
6888: ~
6889: ~
688A: ~
688B: ~
688C: ~
688D: ~
688E: ~
688F: ~
6890: ~
6891: ~
6892: ~
6893: ~
6894: ~
6895: ~
6896: ~
6897: ~
6898: ~
6899: ~
689A: ~
689B: ~
689C: ~
689D: ~
689E: ~
689F: ~
68A0: ~
68A1: ~
68A2: ~
68A3: ~
68A4: ~
68A5: ~
68A6: ~
68A7: ~
68A8: ~
68A9: ~
68AA: ~
68AB: ~
68AC: ~
68AD: ~
68AE: ~
68AF: ~
68B0: ~
68B1: ~
68B2: ~
68B3: ~
68B4: ~
68B5: ~
68B6: ~
68B7: ~
68B8: ~
68B9: ~
68BA: ~
68BB: ~
68BC: ~
68BD: ~
68BE: ~
68BF: ~
68C0: ~
68C1: ~
68C2: ~
68C3: ~
68C4: ~
68C5: ~
68C6: ~
68C7: ~
68C8: ~
68C9: ~
68CA: ~
68CB: ~
68CC: ~
68CD: ~
68CE: ~
68CF: ~
68D0: ~
68D1: ~
68D2: ~
68D3: ~
68D4: ~
68D5: ~
68D6: ~
68D7: ~
68D8: ~
68D9: ~
68DA: ~
68DB: ~
68DC: ~
68DD: ~
68DE: ~
68DF: ~
68E0: ~
68E1: ~
68E2: ~
68E3: ~
68E4: ~
68E5: ~
68E6: ~
68E7: ~
68E8: ~
68E9: ~
68EA: ~
68EB: ~
68EC: ~
68ED: ~
68EE: ~
68EF: ~
68F0: ~
68F1: ~
68F2: ~
68F3: ~
68F4: ~
68F5: ~
68F6: ~
68F7: ~
68F8: ~
68F9: ~
68FA: ~
68FB: ~
68FC: ~
68FD: ~
68FE: ~
68FF: ~
