2000: 0130 { 180 6 ---  190 6 ---  181 6 ---  191 6 --- }
2001: 0130 { 182 6 ---  192 6 ---  183 6 ---  193 6 --- }
2002: 0130 { 184 6 ---  194 6 ---  185 6 ---  195 6 --- }
2003: 0025 { 0F8 4 ---  0F8 4 ---  0F8 4 ---  186 4 --- }
2004: 0025 { 0F8 4 ---  187 4 ---  0F8 4 ---  188 4 --- }
2005: 0025 { 0F8 4 ---  189 4 ---  0F8 4 ---  0F8 4 --- }
2006: 0025 { 0F8 4 x--  0F8 4 x--  0F8 4 x--  189 4 x-- }
2007: 0025 { 0F8 4 x--  188 4 x--  0F8 4 x--  187 4 x-- }
2008: 0025 { 0F8 4 x--  186 4 x--  0F8 4 x--  0F8 4 x-- }
2009: 0025 { 18A 4 ---  19A 4 ---  18B 4 ---  19B 4 --- }
200A: 0025 { 18C 4 ---  19C 4 ---  0F8 4 x--  0F8 4 x-- }
200B: 0130 { 0FA 4 ---  0FA 4 ---  0FA 4 ---  0FA 4 --- }
200C: 0100 { 18D 4 ---  19D 4 ---  18E 4 ---  19E 4 --- }
200D: 0100 { 18F 4 ---  0F8 4 x--  18F 4 ---  0F8 4 x-- }
200E: 0100 { 1AD 4 ---  19D 4 ---  1AE 4 ---  19E 4 --- }
200F: 0025 { 0F8 4 x--  1F7 4 ---  0F8 4 x--  1F8 4 --- }
2010: 0130 { 1A4 6 ---  1B4 6 ---  1A5 6 ---  1B5 6 --- }
2011: 0006 { 082 4 ---  082 4 ---  082 4 x--  082 4 x-- }
2012: 0130 { 1A4 6 ---  1B4 6 ---  1A5 6 ---  1B5 6 --- }
2013: 0025 { 0F8 4 ---  0F8 4 ---  196 4 ---  1A6 4 --- }
2014: 0020 { 197 4 ---  1A7 4 ---  198 4 ---  1A8 4 --- }
2015: 0025 { 199 4 ---  1A9 4 ---  0F8 4 ---  0F8 4 --- }
2016: 0025 { 0F8 4 x--  0F8 4 x--  199 4 x--  1A9 4 x-- }
2017: 0020 { 198 4 x--  1A8 4 x--  197 4 x--  1A7 4 x-- }
2018: 0025 { 196 4 x--  1A6 4 x--  0F8 4 x--  0F8 4 x-- }
2019: 0025 { 1AA 4 ---  1BA 4 ---  1AB 4 ---  1BB 4 --- }
201A: 0025 { 1AC 4 ---  1BC 4 ---  0F8 4 x--  0F8 4 x-- }
201B: 0025 { 0F8 4 x--  1FF 4 ---  0F8 4 x--  0F8 4 x-- }
201C: 0025 { 0F8 4 x--  0F8 4 x--  0F8 4 x--  1B8 4 --- }
201D: 0025 { 0F8 4 x--  0F8 4 x--  0F8 4 x--  1B9 4 --- }
201E: 0025 { 0F8 4 x--  1BE 4 ---  0F8 4 x--  1BF 4 --- }
201F: 0025 { 0F8 4 x--  1D0 4 ---  0F8 4 x--  1D1 4 --- }
2020: 0130 { 1A0 6 ---  1B0 6 ---  1A1 6 ---  1B1 6 --- }
2021: 0130 { 182 6 ---  192 6 ---  183 6 ---  193 6 --- }
2022: 0130 { 1A2 6 ---  1B2 6 ---  1A3 6 ---  1B3 6 --- }
2023: 0025 { 0F8 4 ---  0F8 4 ---  1B6 4 ---  1C6 4 --- }
2024: 0020 { 1B7 4 ---  1C7 4 ---  1C8 4 ---  1C8 4 --- }
2025: 0025 { 1C9 4 ---  1C9 4 ---  0F8 4 ---  0F8 4 --- }
2026: 0025 { 0F8 4 x--  0F8 4 x--  1C9 4 x--  1C9 4 x-- }
2027: 0020 { 1C8 4 x--  1C8 4 x--  1B7 4 x--  1C7 4 x-- }
2028: 0025 { 1B6 4 x--  1C6 4 x--  0F8 4 x--  0F8 4 x-- }
2029: 0025 { 0F8 4 x--  0F8 4 x--  0F8 4 x--  1AF 4 --- }
202A: 0025 { 0F8 4 x--  1F9 4 ---  0F8 4 x--  1FA 4 --- }
202B: 0025 { 0F8 4 x--  0F8 4 x--  0F8 4 x--  19F 3 --- }
202C: 0100 { 1CA 4 ---  19D 4 ---  1CB 4 ---  19E 4 --- }
202D: 0100 { 1CC 4 ---  0F8 4 x--  1CD 4 ---  0F8 4 x-- }
202E: 0100 { 1CE 4 ---  19D 4 ---  1CF 4 ---  19E 4 --- }
202F: 0025 { 1E0 4 ---  1F0 3 ---  1E1 4 ---  1F1 3 --- }
2030: 0025 { 0F8 4 ---  1C2 4 ---  0F8 4 ---  1C3 4 --- }
2031: 0025 { 0F8 4 ---  1C4 4 ---  0F8 4 ---  1C5 4 --- }
2032: 0025 { 0F8 4 x--  0F8 4 x--  0F8 4 x--  1BD 4 --- }
2033: 0100 { 1D2 4 ---  1F2 4 -y-  1D3 4 x--  1F3 4 xy- }
2034: 0100 { 1D3 4 ---  1F3 4 -y-  1D4 4 ---  1F4 4 -y- }
2035: 0100 { 1D5 4 ---  1F5 4 -y-  1D6 4 ---  1F6 4 -y- }
2036: 0100 { 1D7 4 ---  1E7 4 ---  1D8 4 ---  1E9 4 x-- }
2037: 0100 { 1D8 4 ---  1E9 4 ---  1DA 4 ---  1EA 4 --- }
2038: 0025 { 1D6 4 ---  1F6 4 -y-  0F8 4 x--  0F8 4 x-- }
2039: 0025 { 0F8 4 x--  1D9 4 ---  0F8 4 x--  1DF 4 --- }
203A: 0025 { 0F8 4 x--  1EC 4 ---  0F8 4 x--  0F8 4 x-- }
203B: 0100 { 1DB 4 ---  1EB 4 ---  1DC 4 ---  0F9 4 --- }
203C: 0100 { 1DC 4 ---  0F9 4 ---  1DD 4 ---  1ED 4 --- }
203D: 0025 { 1DE 4 ---  1EE 4 ---  0F8 4 x--  0F8 4 x-- }
203E: 0025 { 207 2 ---  217 2 ---  208 2 ---  218 2 --- }
203F: 0025 { 209 4 ---  219 4 ---  0F8 4 x--  0F8 4 x-- }
2040: 0100 { 1C0 4 ---  0F8 4 ---  1C1 4 ---  0F8 4 --- }
2041: 0100 { 1C1 4 ---  0F8 4 ---  1C1 4 ---  0F8 4 --- }
2042: 0100 { 1C1 4 x--  0F8 4 ---  1C0 4 x--  0F8 4 --- }
2043: 0025 { 1E2 4 ---  1F2 4 ---  1E3 4 x--  1F3 4 x-- }
2044: 0025 { 1E3 4 ---  1F3 4 ---  1E4 4 ---  1F4 4 --- }
2045: 0025 { 1E5 4 ---  1F5 4 ---  1E6 4 ---  1F6 4 --- }
2046: 0025 { 1E8 4 ---  1E8 4 -y-  0FA 4 ---  0FA 4 --- }
2047: 0025 { 0FA 4 ---  0FA 4 ---  278 4 ---  279 4 --- }
2048: 0025 { 1E6 4 ---  1F6 4 ---  0F8 4 x--  0F8 4 x-- }
2049: 0025 { 1EF 4 ---  0F8 4 x--  1FB 4 ---  200 4 --- }
204A: 0025 { 1FC 4 ---  201 4 ---  0F8 4 x--  0F8 4 x-- }
204B: 0025 { 1EB 4 ---  1DB 4 ---  0F9 4 ---  1DC 4 --- }
204C: 0025 { 0F9 4 ---  1DC 4 ---  1FD 4 ---  1DD 4 --- }
204D: 0025 { 1FE 4 ---  1DE 4 ---  0F8 4 x--  0F8 4 x-- }
204E: 0025 { 227 4 ---  1BA 4 ---  228 4 ---  229 4 --- }
204F: 0025 { 1AC 4 ---  1BC 4 ---  0F8 4 x--  0F8 4 x-- }
2050: 0100 { 20A 4 ---  21A 4 ---  20B 4 ---  21B 4 --- }
2051: 0100 { 20C 4 ---  21B 4 ---  20D 4 ---  21C 4 --- }
2052: 0025 { 1DE 4 ---  1EE 4 ---  0F8 4 x--  0F8 4 x-- }
2053: 0025 { 0F8 4 ---  20F 3 x--  0F8 4 ---  20E 3 x-- }
2054: 0025 { 18C 4 x--  19C 4 x--  18B 4 x--  19B 4 x-- }
2055: 0025 { 18A 4 x--  19A 4 x--  0F8 4 x--  0F8 4 x-- }
2056: 0025 { 0F8 4 x--  202 3 ---  0F8 4 x--  203 3 --- }
2057: 0025 { 0F8 4 x--  204 3 ---  0F8 4 x--  205 3 --- }
2058: 0025 { 0F8 4 x--  206 3 ---  0F8 4 x--  0F8 4 x-- }
2059: 0025 { 0F8 4 x--  0F8 4 x--  210 3 ---  220 3 --- }
205A: 0025 { 211 3 ---  221 3 ---  0F8 4 x--  0F8 4 x-- }
205B: 0025 { 1EB 4 ---  1EB 4 ---  0F9 4 ---  0F9 4 --- }
205C: 0025 { 0F9 4 ---  0F9 4 ---  1ED 4 ---  1FD 4 --- }
205D: 0025 { 1EE 4 ---  1EE 4 ---  0F8 4 x--  0F8 4 x-- }
205E: 0025 { 0F8 4 ---  0F8 4 ---  209 4 x--  219 4 x-- }
205F: 0025 { 208 2 x--  218 2 x--  207 2 x--  217 2 x-- }
2060: 0025 { 22A 4 ---  213 4 ---  22B 4 ---  214 4 --- }
2061: 0025 { 02B 4 ---  214 4 ---  22C 4 ---  21D 4 --- }
2062: 0025 { 1EE 4 ---  1FE 4 ---  0F8 4 x--  0F8 4 x-- }
2063: 0025 { 21F 3 x--  22F 3 x--  21E 3 x--  22E 3 x-- }
2064: 0025 { 1AC 4 x--  1BC 4 x--  1AB 4 x--  1BB 4 x-- }
2065: 0025 { 1AA 4 x--  1BA 4 x--  0F8 4 x--  0F8 4 x-- }
2066: 0025 { 212 3 ---  222 3 ---  0FA 3 ---  223 3 --- }
2067: 0025 { 0FA 3 ---  224 3 ---  215 3 ---  225 3 --- }
2068: 0025 { 216 3 ---  216 3 ---  0F8 4 x--  0F8 4 x-- }
2069: 0020 { 0D3 4 x--  0E3 4 x--  0D2 4 x--  0E2 4 x-- }
206A: 0020 { 0D2 4 ---  0E2 4 ---  0D3 4 ---  0E3 4 --- }
206B: 0025 { 1EB 4 ---  1EB 4 ---  0F9 4 ---  0F9 4 --- }
206C: 0025 { 0F9 4 ---  0F9 4 ---  1FD 4 ---  1FD 4 --- }
206D: 0025 { 1EE 4 ---  1FE 4 ---  0F8 4 x--  0F8 4 x-- }
206E: 0025 { 0F8 4 ---  0F8 4 ---  1AC 4 x--  1BC 4 x-- }
206F: 0025 { 228 4 x--  229 4 x--  227 4 x--  1BA 4 x-- }
2070: ~
2071: ~
2072: ~
2073: ~
2074: ~
2075: ~
2076: ~
2077: ~
2078: 0130 { 0B5 4 ---  0C5 4 ---  0D6 4 ---  0E6 4 --- }
2079: 0020 { 0F3 4 x--  0F3 4 xy-  0F2 4 x--  0F2 4 xy- }
207A: 0020 { 0F2 4 ---  0F2 4 -y-  0F3 4 ---  0F3 4 -y- }
207B: 0025 { 0D3 4 x--  0E3 4 x--  0D2 4 x--  0E2 4 x-- }
207C: 0025 { 0D2 4 ---  0E2 4 ---  0D3 4 ---  0E3 4 --- }
207D: 0025 { 202 3 ---  212 3 ---  203 3 ---  0FA 3 --- }
207E: 0025 { 204 3 ---  0FA 3 ---  205 3 ---  215 3 --- }
207F: 0025 { 206 3 ---  216 3 ---  0F8 4 x--  0F8 4 x-- }
2080: ~
2081: ~
2082: ~
2083: ~
2084: ~
2085: ~
2086: ~
2087: ~
2088: ~
2089: 0020 { 0E3 4 xy-  0D3 4 xy-  0E2 4 xy-  0D2 4 xy- }
208A: 0020 { 0E2 4 -y-  0D2 4 -y-  0E3 4 -y-  0D3 4 -y- }
208B: 0025 { 0F3 4 x--  0F3 4 xy-  0F2 4 x--  0F2 4 xy- }
208C: 0025 { 0F2 4 ---  0F2 4 -y-  0F3 4 ---  0F3 4 -y- }
208D: 0025 { 222 3 ---  18D 4 ---  223 3 ---  18E 4 --- }
208E: 0025 { 224 3 ---  18F 4 ---  225 3 ---  1AD 4 --- }
208F: 0025 { 216 3 ---  1AE 4 ---  0F8 4 x--  0F8 4 x-- }
2090: ~
2091: ~
2092: ~
2093: ~
2094: ~
2095: ~
2096: ~
2097: ~
2098: ~
2099: 015C { 0D1 2 x--  0D1 2 x--  0D0 2 x--  0D0 2 x-- }
209A: 015B { 0D0 2 ---  0D0 2 ---  0D1 2 ---  0D1 2 --- }
209B: 0025 { 0E3 4 xy-  0D3 4 xy-  0E2 4 xy-  0D2 4 xy- }
209C: 0025 { 0E2 4 -y-  0D2 4 -y-  0E3 4 -y-  0D3 4 -y- }
209D: 0130 { 0E4 4 ---  0F5 4 x--  0E5 4 ---  0F4 4 --- }
209E: 0130 { 0E4 4 ---  0F4 4 ---  0E5 4 ---  0F4 4 --- }
209F: 0130 { 0E4 4 ---  0F4 4 ---  0E5 4 ---  0F5 4 --- }
20A0: ~
20A1: ~
20A2: ~
20A3: ~
20A4: ~
20A5: ~
20A6: ~
20A7: ~
20A8: ~
20A9: ~
20AA: ~
20AB: ~
20AC: ~
20AD: ~
20AE: ~
20AF: ~
20B0: ~
20B1: ~
20B2: ~
20B3: ~
20B4: ~
20B5: ~
20B6: ~
20B7: ~
20B8: ~
20B9: ~
20BA: ~
20BB: ~
20BC: ~
20BD: ~
20BE: ~
20BF: ~
20C0: ~
20C1: ~
20C2: ~
20C3: ~
20C4: ~
20C5: ~
20C6: ~
20C7: ~
20C8: ~
20C9: ~
20CA: ~
20CB: ~
20CC: ~
20CD: ~
20CE: ~
20CF: ~
20D0: ~
20D1: ~
20D2: ~
20D3: ~
20D4: ~
20D5: ~
20D6: ~
20D7: ~
20D8: ~
20D9: ~
20DA: ~
20DB: ~
20DC: ~
20DD: ~
20DE: ~
20DF: ~
20E0: ~
20E1: ~
20E2: ~
20E3: ~
20E4: ~
20E5: ~
20E6: ~
20E7: ~
20E8: ~
20E9: ~
20EA: ~
20EB: ~
20EC: ~
20ED: ~
20EE: ~
20EF: ~
20F0: ~
20F1: ~
20F2: ~
20F3: ~
20F4: ~
20F5: ~
20F6: ~
20F7: ~
20F8: ~
20F9: ~
20FA: ~
20FB: ~
20FC: ~
20FD: ~
20FE: ~
20FF: ~
