4300: 0130 { 1AE 2 ---  1BE 2 ---  1AF 2 ---  1BF 2 --- }
4301: 0130 { 1AF 2 x--  1BF 2 x--  1AE 2 x--  1BE 2 x-- }
4302: 0130 { 1E8 2 ---  1F8 2 ---  1E9 2 ---  1F9 2 --- }
4303: 0130 { 1EA 2 ---  1FA 2 ---  1EB 2 ---  1FB 2 --- }
4304: 0130 { 1C8 2 ---  1D8 2 ---  1C9 2 ---  1D9 2 --- }
4305: 0130 { 1CA 2 ---  1DA 2 ---  1CB 2 ---  1DB 2 --- }
4306: 0130 { 1CC 2 ---  1DC 2 ---  1CD 2 ---  1DD 2 --- }
4307: 0130 { 189 5 ---  1C5 5 ---  18A 5 ---  1C6 5 --- }
4308: 0130 { 180 3 ---  190 3 ---  181 3 ---  191 3 --- }
4309: 0130 { 182 3 ---  191 3 ---  183 3 ---  193 3 --- }
430A: 0130 { 184 3 ---  194 3 ---  1A9 3 ---  1A9 3 --- }
430B: 0130 { 19A 2 ---  191 3 ---  19A 2 x--  191 3 --- }
430C: 0130 { 1A9 3 ---  1A9 3 ---  189 5 ---  1C5 5 --- }
430D: 0130 { 18A 5 ---  1C6 5 ---  1A9 3 ---  1A9 3 --- }
430E: 0130 { 2DB 2 x--  2EB 2 x--  2DA 2 x--  2EA 2 x-- }
430F: 0130 { 29A 2 xy-  28A 2 xy-  299 2 xy-  289 2 xy- }
4310: 0130 { 1CE 2 ---  1DE 2 ---  1CF 2 ---  1DF 2 --- }
4311: 0130 { 1CF 2 x--  1DF 2 x--  1CE 2 x--  1DE 2 x-- }
4312: 0130 { 1E8 2 ---  1F8 2 ---  1EB 2 ---  1FB 2 --- }
4313: 0130 { 1E7 2 ---  1F7 2 ---  1E9 2 ---  1F9 2 --- }
4314: 0130 { 1EA 2 ---  1FA 2 ---  1AB 2 ---  1BB 2 --- }
4315: 0130 { 1E7 2 ---  1F7 2 ---  1AB 2 ---  1BB 2 --- }
4316: 0130 { 1AC 4 ---  1BC 4 ---  1AD 4 ---  1BD 4 --- }
4317: 0130 { 1D5 5 ---  1E5 3 ---  1D6 5 ---  1E6 3 --- }
4318: 0130 { 1A0 3 ---  1D0 3 ---  1A1 3 ---  1D1 3 --- }
4319: 0130 { 1A2 3 ---  1D2 3 ---  1A3 3 ---  1D3 3 --- }
431A: 0130 { 194 3 ---  1D4 3 ---  1A9 3 ---  1A9 3 --- }
431B: 0130 { 191 3 ---  191 3 ---  191 3 ---  191 3 --- }
431C: 0130 { 1A9 3 ---  1A9 3 ---  1D5 5 ---  1E5 3 --- }
431D: 0130 { 1D6 5 ---  1E6 3 ---  1A9 3 ---  1A9 3 --- }
431E: 0130 { 192 2 x--  283 2 x--  193 2 x--  282 2 x-- }
431F: 0130 { 192 2 x--  281 2 x--  193 2 x--  280 2 x-- }
4320: 0130 { 1EE 2 ---  1FE 2 ---  1EF 2 ---  1FF 2 --- }
4321: 0130 { 1EF 2 x--  1FF 2 x--  1EE 2 x--  1FE 2 x-- }
4322: 0130 { 1B0 3 ---  1C0 3 ---  1B1 3 ---  1C1 3 --- }
4323: 0130 { 1B2 3 ---  1A9 3 ---  1B2 3 ---  1A9 3 --- }
4324: 0130 { 1B3 3 ---  1C0 3 ---  1B4 3 ---  1C1 3 --- }
4325: 0130 { 1A9 3 ---  1F5 3 ---  1A9 3 ---  1F6 3 --- }
4326: 0130 { 1AC 4 ---  1BC 4 ---  1AD 4 ---  1BD 4 --- }
4327: 0130 { 191 3 ---  191 3 ---  191 3 ---  191 3 --- }
4328: 0130 { 1E0 3 ---  1F0 3 ---  1E1 3 ---  1F1 3 --- }
4329: 0130 { 1E2 3 ---  1F2 3 ---  1E3 3 ---  1F3 3 --- }
432A: 0130 { 1E4 3 ---  1F4 3 ---  1A9 3 ---  1A9 3 --- }
432B: 0130 { 1A9 3 ---  1A9 3 ---  1A9 3 ---  189 5 --- }
432C: 0130 { 1A9 3 ---  18A 5 ---  1A9 3 ---  1A9 3 --- }
432D: 0130 { 033 0 ---  01F 4 xy-  02B 4 x--  01E 4 xy- }
432E: 0130 { 293 2 x--  2A3 2 x--  292 2 x--  2A2 2 x-- }
432F: 0130 { 291 2 x--  2A1 2 x--  290 2 x--  2A0 2 x-- }
4330: 0130 { 1AA 2 ---  1BA 2 ---  1ED 2 ---  1FD 2 --- }
4331: 0130 { 1AA 2 ---  1BA 2 ---  1AA 2 x--  1BA 2 x-- }
4332: 0130 { 1E7 2 ---  1F8 2 ---  1E9 2 ---  1F9 2 --- }
4333: 0130 { 1EA 2 ---  1FA 2 ---  1AB 2 ---  1FB 2 --- }
4334: 0130 { 1E7 2 ---  1F7 2 ---  1E9 2 ---  1F9 2 --- }
4335: 0130 { 1EA 2 ---  1FA 2 ---  1EB 2 ---  1FB 2 --- }
4336: 0130 { 1E8 2 ---  1F8 2 ---  1E9 2 ---  1F9 2 --- }
4337: 0130 { 1EA 2 ---  1FA 2 ---  1EB 2 ---  1D7 2 --- }
4338: 0130 { 1E8 2 ---  1F7 2 ---  1E9 2 ---  1F9 2 --- }
4339: 0130 { 1EA 2 ---  1FA 2 ---  1EB 2 ---  1BB 2 --- }
433A: 0130 { 1E8 2 ---  1F8 2 ---  1E9 2 ---  1F9 2 --- }
433B: 0130 { 1A9 3 ---  1A9 3 ---  1C5 5 ---  1D5 5 --- }
433C: 0130 { 1C6 5 ---  1D6 5 ---  1A9 3 ---  1A9 3 --- }
433D: 0130 { 0D5 2 ---  0F8 2 -y-  0F8 2 -y-  160 7 --- }
433E: 0130 { 2B6 1 -y-  2A6 1 -y-  2B7 1 -y-  2A7 1 -y- }
433F: 0130 { 2B7 1 xy-  2A7 1 xy-  2B6 1 xy-  2A6 1 xy- }
4340: 0130 { 1A9 3 ---  1A9 3 ---  1C2 3 ---  1A9 3 --- }
4341: 0130 { 1C3 3 ---  1A9 3 ---  1C3 3 x--  1A9 3 --- }
4342: 0130 { 1C2 3 x--  1A9 3 ---  1A9 3 ---  1A9 3 --- }
4343: 0130 { 1EC 2 ---  1FC 2 ---  1AA 2 x--  1BA 2 x-- }
4344: 0130 { 1E7 2 ---  1F7 2 ---  1E9 2 ---  1F9 2 --- }
4345: 0130 { 1EA 2 ---  1FA 2 ---  1EB 2 ---  1FB 2 --- }
4346: 0130 { 1C2 3 ---  1A9 3 ---  1C3 3 ---  1A9 3 --- }
4347: 0130 { 1C3 3 x--  1A9 3 ---  1C2 3 x--  1A9 3 --- }
4348: 0130 { 1A9 3 ---  1A9 3 ---  1A9 2 ---  1A5 2 --- }
4349: 0130 { 1A9 2 ---  1A6 2 ---  1A9 3 ---  1A9 3 --- }
434A: 0130 { 171 7 ---  108 7 ---  03B 7 ---  173 7 --- }
434B: 0130 { 1A9 3 ---  1C2 3 ---  1E5 3 ---  1C3 3 --- }
434C: 0130 { 1E6 3 ---  1C3 3 x--  1A9 3 ---  1C2 3 x-- }
434D: 0130 { 28C 2 x--  29C 2 x--  28B 2 x--  29B 2 x-- }
434E: 0130 { 195 2 ---  192 2 ---  2C7 2 ---  2D7 2 --- }
434F: 0130 { 2C8 2 ---  2D8 2 ---  2C9 2 ---  2D9 2 --- }
4350: 0130 { 185 6 ---  195 6 ---  186 6 ---  196 6 --- }
4351: 0130 { 186 6 ---  196 6 ---  186 6 ---  196 6 --- }
4352: 0130 { 0F8 2 -y-  0F8 2 -y-  0F8 2 -y-  0F8 2 -y- }
4353: 0130 { 186 6 x--  196 6 x--  185 6 x--  195 6 x-- }
4354: 0130 { 187 6 ---  197 6 ---  188 6 ---  198 6 --- }
4355: 0130 { 188 6 ---  198 6 ---  188 6 ---  198 6 --- }
4356: 0130 { 188 6 ---  198 6 ---  188 6 ---  198 6 --- }
4357: 0130 { 188 6 x--  198 6 x--  187 6 x--  197 6 x-- }
4358: 0130 { 02B 4 ---  01E 4 -y-  032 0 ---  01F 4 -y- }
4359: 0130 { 100 7 ---  110 7 ---  101 7 ---  111 7 --- }
435A: 0130 { 102 7 ---  112 7 ---  103 7 ---  113 7 --- }
435B: 0130 { 104 7 ---  114 7 ---  105 7 ---  115 7 --- }
435C: 0130 { 106 7 ---  116 7 ---  107 7 ---  117 7 --- }
435D: 0130 { 108 7 ---  118 7 ---  109 7 ---  119 7 --- }
435E: 0130 { 2A9 2 ---  2B9 2 ---  2AA 2 ---  2BA 2 --- }
435F: 0130 { 2AA 2 x--  2BA 2 x--  2A9 2 x--  2B9 2 x-- }
4360: 0130 { 195 6 ---  195 6 ---  196 6 ---  196 6 --- }
4361: 0130 { 18E 6 ---  19E 6 ---  18F 6 ---  19F 6 --- }
4362: 0130 { 18C 6 ---  19C 6 ---  18D 6 ---  19D 6 --- }
4363: 0130 { 196 6 x--  196 6 x--  195 6 x--  195 6 x-- }
4364: 0130 { 197 6 ---  197 6 ---  18F 6 x--  19F 6 x-- }
4365: 0130 { 18E 6 x--  19E 6 x--  18C 6 ---  19C 6 --- }
4366: 0130 { 18D 6 ---  19D 6 ---  18C 6 ---  19C 6 --- }
4367: 0130 { 18D 6 ---  19D 6 ---  197 6 x--  197 6 x-- }
4368: 0130 { 0F8 2 -y-  0F8 2 -y-  0F8 2 -y-  160 7 --- }
4369: 0130 { 120 7 ---  130 7 ---  121 7 ---  131 7 --- }
436A: 0130 { 122 7 ---  132 7 ---  123 7 ---  133 7 --- }
436B: 0130 { 124 7 ---  134 7 ---  125 7 ---  135 7 --- }
436C: 0130 { 126 7 ---  136 7 ---  127 7 ---  137 7 --- }
436D: 0130 { 128 7 ---  138 7 ---  129 7 ---  139 7 --- }
436E: 0130 { 2A8 2 ---  192 2 ---  195 2 ---  192 2 --- }
436F: 0130 { 193 2 ---  2A8 2 ---  193 2 ---  193 2 --- }
4370: 0130 { 195 6 -y-  185 6 -y-  196 6 -y-  186 6 -y- }
4371: 0130 { 196 6 -y-  004 4 ---  196 6 -y-  004 4 --- }
4372: 0130 { 0F8 2 -y-  0F8 2 -y-  0F8 2 -y-  0F8 2 -y- }
4373: 0130 { 196 6 xy-  186 6 xy-  195 6 xy-  185 6 xy- }
4374: 0130 { 197 6 -y-  187 6 -y-  198 6 -y-  188 6 -y- }
4375: 0130 { 198 6 xy-  188 6 xy-  198 6 xy-  188 6 xy- }
4376: 0130 { 198 6 -y-  188 6 -y-  198 6 -y-  188 6 -y- }
4377: 0130 { 198 6 xy-  188 6 xy-  197 6 xy-  187 6 xy- }
4378: 0130 { 0F8 2 -y-  0F8 2 -y-  170 7 ---  0F8 2 -y- }
4379: 0130 { 140 7 ---  150 7 ---  141 7 ---  151 7 --- }
437A: 0130 { 142 7 ---  152 7 ---  143 7 ---  153 7 --- }
437B: 0130 { 144 7 ---  154 7 ---  145 7 ---  155 7 --- }
437C: 0130 { 146 7 ---  156 7 ---  147 7 ---  157 7 --- }
437D: 0130 { 148 7 ---  158 7 ---  149 7 ---  159 7 --- }
437E: 0130 { 192 2 ---  193 2 ---  2A8 2 ---  195 2 --- }
437F: 0130 { 195 2 ---  2A8 2 ---  192 2 ---  193 2 --- }
4380: 0130 { 14E 6 ---  15E 6 ---  14F 6 ---  15F 6 --- }
4381: 0130 { 28E 1 ---  2BE 1 ---  28F 1 ---  2BF 1 --- }
4382: 0130 { 16A 6 ---  161 6 ---  16B 6 ---  171 6 --- }
4383: 0130 { 16C 6 ---  2CA 6 ---  17A 6 ---  2DC 6 --- }
4384: 0130 { 2B0 6 ---  2F0 6 ---  2B1 6 ---  2F1 6 --- }
4385: 0130 { 2B2 6 ---  2F6 6 ---  2B3 6 ---  2E8 6 --- }
4386: 0130 { 193 2 ---  280 2 ---  192 2 ---  281 2 --- }
4387: 0130 { 193 2 ---  282 2 ---  192 2 ---  283 2 --- }
4388: 0130 { 287 2 ---  297 2 ---  288 2 ---  298 2 --- }
4389: 0130 { 28B 2 ---  29B 2 ---  28C 2 ---  29C 2 --- }
438A: 0130 { 162 7 ---  172 7 ---  163 7 ---  173 7 --- }
438B: 0130 { 164 7 ---  174 7 ---  165 7 ---  175 7 --- }
438C: 0130 { 166 7 ---  176 7 ---  167 7 ---  177 7 --- }
438D: 0130 { 168 7 ---  178 7 ---  169 7 ---  179 7 --- }
438E: 0130 { 0F8 2 -y-  0F8 2 -y-  0F8 2 -y-  17B 7 --- }
438F: 0130 { 0F8 2 -y-  17C 7 ---  16D 7 ---  17D 7 --- }
4390: 0130 { 16E 6 ---  17E 6 ---  16F 6 ---  17F 6 --- }
4391: 0130 { 14C 6 ---  15C 6 ---  14D 6 ---  15D 6 --- }
4392: 0130 { 2C6 6 ---  15B 6 ---  2CA 6 ---  2F1 6 --- }
4393: 0130 { 171 6 xy-  2F6 6 ---  2EC 6 ---  2E8 6 --- }
4394: 0130 { 284 2 ---  294 2 ---  285 2 ---  295 2 --- }
4395: 0130 { 286 2 ---  296 2 ---  192 2 ---  194 2 --- }
4396: 0130 { 290 2 ---  2A0 2 ---  291 2 ---  2A1 2 --- }
4397: 0130 { 292 2 ---  2A2 2 ---  293 2 ---  2A3 2 --- }
4398: 0130 { 289 2 ---  299 2 ---  28A 2 ---  29A 2 --- }
4399: 0130 { 10A 7 ---  11A 7 ---  10B 7 ---  11B 7 --- }
439A: 0130 { 10C 7 ---  11C 7 ---  10D 7 ---  11D 7 --- }
439B: 0130 { 10E 7 ---  11E 7 ---  10F 7 ---  11F 7 --- }
439C: 0130 { 12A 7 ---  13A 7 ---  12B 7 ---  13B 7 --- }
439D: 0130 { 12C 7 ---  13C 7 ---  12D 7 ---  13D 7 --- }
439E: 0130 { 12E 7 ---  13E 7 ---  12F 7 ---  13F 7 --- }
439F: 0130 { 14A 7 ---  15A 7 ---  14B 7 ---  0F8 2 -y- }
43A0: 0130 { 0C6 3 --p  0F8 3 --p  0C7 3 --p  0F8 3 --p }
43A1: 0130 { 2C0 5 ---  2D0 5 ---  2ED 5 ---  2FD 5 --- }
43A2: 0130 { 2EE 5 ---  2FE 5 ---  2EF 5 ---  2FF 5 --- }
43A3: 0130 { 2D0 5 -y-  2C0 5 -y-  2FD 5 -y-  2ED 5 -y- }
43A4: 0130 { 2FE 5 -y-  2EE 5 -y-  2FF 5 -y-  2EF 5 -y- }
43A5: 0130 { 0F8 3 --p  0C7 5 x-p  0F8 3 --p  0C6 5 x-p }
43A6: 0130 { 0E0 4 ---  1DC 4 ---  0E1 4 ---  1DC 4 --- }
43A7: 0130 { 0E2 4 ---  18B 4 ---  0E3 4 ---  18C 4 --- }
43A8: 0130 { 0E4 4 ---  18D 4 ---  0E5 4 ---  18D 4 --- }
43A9: 0130 { 0E6 4 ---  18D 4 ---  0E7 4 ---  18F 4 --- }
43AA: 0130 { 0E8 4 ---  1AA 4 ---  0E9 4 ---  1DC 4 --- }
43AB: 0130 { 0E2 4 x--  18B 4 x--  0C3 4 ---  1DC 4 --- }
43AC: 0130 { 0E3 4 x--  18C 4 x--  0E2 4 x--  18B 4 x-- }
43AD: 0130 { 0E1 4 x--  1DC 4 x--  0E0 4 x--  1DC 4 x-- }
43AE: 0130 { 2AB 1 ---  2BB 1 ---  2AC 1 ---  2BC 1 --- }
43AF: 0130 { 28E 1 ---  29E 1 ---  28F 1 ---  29F 1 --- }
43B0: 0130 { 0C7 5 x-p  0F8 3 --p  0C6 5 x-p  0F8 3 --p }
43B1: 0130 { 0B2 1 ---  0C2 1 ---  0B3 1 ---  0C3 1 --- }
43B2: 0130 { 0B3 1 x--  0C3 1 x--  0B2 1 x--  0C2 1 x-- }
43B3: 0130 { 0C2 1 -y-  0C4 1 -y-  0C3 1 -y-  0C5 1 -y- }
43B4: 0130 { 0C3 1 xy-  0C5 1 xy-  0C2 1 xy-  0C4 1 xy- }
43B5: 0130 { 1F5 2 ---  192 2 ---  1F6 2 ---  193 2 --- }
43B6: 0130 { 192 2 -y-  194 2 -y-  193 2 -y-  195 2 -y- }
43B7: 0130 { 192 2 -y-  195 2 -y-  193 2 -y-  1A6 2 xy- }
43B8: 0130 { 0F8 2 ---  196 2 ---  187 2 ---  197 2 --- }
43B9: 0130 { 187 2 x--  197 2 x--  0F8 2 ---  196 2 x-- }
43BA: 0130 { 192 2 -y-  1A6 2 -y-  193 2 -y-  195 2 -y- }
43BB: 0130 { 193 2 -y-  192 2 -y-  195 2 -y-  1A6 2 xy- }
43BC: 0130 { 0F8 2 -y-  2EF 5 x--  0F8 2 -y-  2C0 5 x-- }
43BD: 0130 { 2A4 2 ---  2B4 2 ---  2A5 2 ---  2B5 2 --- }
43BE: 0130 { 2CB 1 ---  0F8 1 -y-  2CC 1 ---  0F8 1 -y- }
43BF: 0130 { 2AE 1 ---  2BE 1 ---  2AF 1 ---  2BF 1 --- }
43C0: 0130 { 0F8 3 --p  0C6 3 --p  0F8 3 --p  0C7 3 --p }
43C1: 0130 { 0C4 1 ---  0C2 1 ---  0C5 1 ---  0C3 1 --- }
43C2: 0130 { 0C5 1 x--  0C3 1 x--  0C4 1 x--  0C2 1 x-- }
43C3: 0130 { 0C2 1 -y-  0B2 1 -y-  0C3 1 -y-  0B3 1 -y- }
43C4: 0130 { 0C3 1 xy-  0B3 1 xy-  0C2 1 xy-  0B2 1 xy- }
43C5: 0130 { 193 2 ---  193 2 ---  1CF 2 ---  195 2 --- }
43C6: 0130 { 19E 2 xy-  18E 2 xy-  19D 2 xy-  19B 2 xy- }
43C7: 0130 { 19C 2 xy-  0F8 2 -y-  19B 2 xy-  0F8 2 -y- }
43C8: 0130 { 1A6 2 ---  192 2 ---  195 2 ---  193 2 --- }
43C9: 0130 { 192 2 ---  193 2 ---  1A6 2 x--  195 2 --- }
43CA: 0130 { 196 2 -y-  0F8 2 -y-  197 2 -y-  187 2 -y- }
43CB: 0130 { 197 2 xy-  187 2 xy-  196 2 xy-  0F8 2 -y- }
43CC: 0130 { 2FF 5 x--  2C5 1 x--  2D0 5 x--  2C4 1 x-- }
43CD: 0130 { 2E4 2 ---  2F4 2 ---  2E5 2 ---  2F5 2 --- }
43CE: 0130 { 28D 1 ---  29D 1 ---  2AD 1 ---  2BD 1 --- }
43CF: 0130 { 2CE 1 ---  2DE 1 ---  2CF 1 ---  2DF 1 --- }
43D0: 0130 { 0B0 5 ---  0C0 5 ---  0B1 5 ---  0C1 5 --- }
43D1: 0130 { 2D0 5 -y-  2C0 5 -y-  2FF 5 -y-  2EF 5 -y- }
43D2: 0130 { 10A 6 ---  11A 6 ---  10B 6 ---  11B 6 --- }
43D3: 0130 { 10C 6 ---  11C 6 ---  10D 6 ---  11D 6 --- }
43D4: 0130 { 10E 6 ---  11E 6 ---  10F 6 ---  11F 6 --- }
43D5: 0130 { 180 2 ---  190 2 ---  183 2 ---  193 2 --- }
43D6: 0130 { 182 2 ---  192 2 ---  183 2 ---  193 2 --- }
43D7: 0130 { 182 2 ---  192 2 ---  180 2 x--  190 2 x-- }
43D8: 0130 { 183 2 ---  182 2 -y-  180 2 x--  180 2 xy- }
43D9: 0130 { 182 2 ---  182 2 -y-  183 2 ---  183 2 -y- }
43DA: 0130 { 0F8 2 -y-  0F8 2 -y-  0F8 2 -y-  2D1 1 --- }
43DB: 0130 { 2C2 1 ---  2D2 1 ---  2C3 1 ---  2D3 1 --- }
43DC: 0130 { 2C4 1 ---  2D4 1 ---  2C5 1 ---  2D5 1 --- }
43DD: 0130 { 0F8 2 -y-  2D6 1 ---  0F8 2 -y-  0F8 2 -y- }
43DE: 0130 { 0F8 2 -y-  0F8 2 -y-  0F8 2 -y-  2C2 1 --- }
43DF: 0130 { 0F8 2 -y-  2E0 1 ---  2D1 1 ---  2E1 1 --- }
43E0: 0130 { 000 5 ---  010 5 ---  001 5 ---  011 5 --- }
43E1: 0130 { 002 5 ---  012 5 ---  003 5 ---  013 5 --- }
43E2: 0130 { 12A 6 ---  13A 6 ---  12B 6 ---  13B 6 --- }
43E3: 0130 { 174 6 ---  178 6 ---  175 6 ---  179 6 --- }
43E4: 0130 { 176 6 ---  17A 6 ---  177 6 ---  17B 6 --- }
43E5: 0130 { 184 2 ---  190 2 ---  195 2 ---  193 2 --- }
43E6: 0130 { 192 2 ---  193 2 ---  194 2 ---  195 2 --- }
43E7: 0130 { 194 2 ---  192 2 ---  184 2 x--  190 2 x-- }
43E8: 0130 { 180 2 ---  180 2 -y-  183 2 x--  182 2 xy- }
43E9: 0130 { 180 2 ---  190 2 ---  180 2 x--  190 2 x-- }
43EA: 0130 { 2E0 1 ---  2F2 1 ---  2E1 1 ---  2F3 1 --- }
43EB: 0130 { 2E1 1 ---  2F3 1 ---  2E2 1 ---  2F2 1 --- }
43EC: 0130 { 2E2 1 ---  2F2 1 ---  2E3 1 ---  2F3 1 --- }
43ED: 0130 { 2E6 1 ---  2F2 1 ---  2E7 1 ---  2F3 1 --- }
43EE: 0130 { 2FA 1 ---  2F2 1 ---  2FB 1 ---  2FC 1 --- }
43EF: 0130 { 0F8 2 -y-  2C4 1 ---  0F8 2 -y-  2C5 1 --- }
43F0: 0130 { 020 5 ---  020 5 ---  021 5 ---  021 5 --- }
43F1: 0130 { 022 5 ---  022 5 ---  023 5 ---  023 5 --- }
43F2: 0130 { 16E 6 ---  17E 6 ---  16F 6 ---  17F 6 --- }
43F3: 0130 { 17C 6 ---  12C 6 ---  17D 6 ---  12D 6 --- }
43F4: 0130 { 15E 6 ---  12E 6 ---  15F 6 ---  12F 6 --- }
43F5: 0130 { 190 2 -y-  180 2 -y-  193 2 -y-  183 2 -y- }
43F6: 0130 { 192 2 -y-  182 2 -y-  193 2 -y-  183 2 -y- }
43F7: 0130 { 192 2 -y-  182 2 -y-  190 2 xy-  180 2 xy- }
43F8: 0130 { 2DA 2 ---  2EA 2 ---  2DB 2 ---  2EB 2 --- }
43F9: 0130 { 184 2 ---  190 2 ---  184 2 x--  190 2 x-- }
43FA: 0130 { 0C2 4 ---  1DC 4 ---  0C3 4 ---  1DC 4 --- }
43FB: 0130 { 1DC 4 ---  1DC 4 ---  1DC 4 ---  1DC 4 --- }
43FC: 0130 { 0E4 4 ---  18D 4 ---  0E5 4 ---  18D 4 --- }
43FD: 0130 { 18D 4 ---  18D 4 ---  18D 4 ---  18D 4 --- }
43FE: 0130 { 0C0 4 ---  0D0 4 ---  0C1 4 ---  0D1 4 --- }
43FF: 0130 { 0C0 4 ---  0D0 4 ---  0C1 4 ---  0D1 4 --- }
