1400: 005A { 0C8 5 ---  0D8 5 ---  0C9 5 ---  0FE 5 --- }
1401: 0153 { 1F4 6 ---  1F6 6 ---  1F5 6 ---  1F7 6 --- }
1402: 0154 { 1F8 6 ---  1F8 6 ---  1F9 6 ---  1F9 6 --- }
1403: 0155 { 1F6 6 -y-  1F4 6 -y-  1F7 6 -y-  1F5 6 -y- }
1404: 0154 { 0A8 6 ---  1F8 6 ---  0A9 6 ---  1F9 6 --- }
1405: 0154 { 0B8 6 ---  1F8 6 ---  0B9 6 ---  1F9 6 --- }
1406: 0154 { 0AC 6 ---  1F8 6 ---  0AD 6 ---  1F9 6 --- }
1407: 0154 { 0BC 6 ---  1F8 6 ---  0BD 6 ---  1F9 6 --- }
1408: ~
1409: ~
140A: ~
140B: ~
140C: 0025 { 280 7 ---  290 7 ---  281 7 ---  291 7 --- }
140D: 0025 { 282 7 ---  292 7 ---  283 7 ---  293 7 --- }
140E: 0025 { 284 7 ---  294 7 ---  285 7 ---  295 7 --- }
140F: 0025 { 286 7 ---  296 7 ---  287 7 ---  297 7 --- }
1410: 0116 { 064 3 ---  066 3 ---  065 3 ---  067 3 --- }
1411: 0130 { 064 4 ---  066 4 ---  065 4 ---  067 4 --- }
1412: 0130 { 194 2 ---  192 2 ---  195 2 ---  193 2 --- }
1413: 015F { 1D7 4 -y-  1E2 4 -y-  0F9 7 ---  1E3 4 -y- }
1414: 0160 { 0F9 7 ---  1E4 4 -y-  1EA 4 -y-  1E5 4 -y- }
1415: ~
1416: ~
1417: ~
1418: ~
1419: ~
141A: ~
141B: ~
141C: 0025 { 2A0 7 ---  2B0 7 ---  2A1 7 ---  2B1 7 --- }
141D: 0025 { 2A2 7 ---  2B2 7 ---  2A3 7 ---  2B3 7 --- }
141E: 0025 { 2A4 7 ---  2B4 7 ---  2A5 7 ---  2B5 7 --- }
141F: 0025 { 2A6 7 ---  2B6 7 ---  2A7 7 ---  2B7 7 --- }
1420: 0130 { 184 2 ---  190 2 ---  195 2 ---  193 2 --- }
1421: 0130 { 194 2 ---  192 2 ---  184 2 x--  190 2 x-- }
1422: 0130 { 0F8 4 ---  0F8 4 ---  0F8 4 ---  0F8 4 --- }
1423: ~
1424: ~
1425: ~
1426: ~
1427: ~
1428: ~
1429: ~
142A: ~
142B: ~
142C: 0025 { 2C0 7 ---  2D0 7 ---  2C1 7 ---  2D1 7 --- }
142D: 0025 { 2C2 7 ---  2D2 7 ---  2C3 7 ---  2D3 7 --- }
142E: 0025 { 2C4 7 ---  2D4 7 ---  2C5 7 ---  2D5 7 --- }
142F: 0025 { 2C6 7 ---  2D6 7 ---  2C7 7 ---  2D7 7 --- }
1430: 0130 { 1F4 2 ---  1F9 2 ---  1F6 2 ---  1FB 2 --- }
1431: 0130 { 1F4 2 ---  1F9 2 ---  1F5 2 ---  1FA 2 --- }
1432: 0130 { 1F5 2 x--  1FA 2 ---  1F5 2 ---  1FA 2 x-- }
1433: 0130 { 1F5 2 x--  1FA 2 ---  1F6 2 ---  1FB 2 --- }
1434: ~
1435: ~
1436: ~
1437: ~
1438: ~
1439: ~
143A: ~
143B: ~
143C: 0025 { 2E0 7 ---  2F0 7 ---  2E1 7 ---  2F1 7 --- }
143D: 2300 { 2E2 7 ---  2F2 7 ---  2E3 7 ---  2F3 7 --- }
143E: 0025 { 2E4 7 ---  2F4 7 ---  2E5 7 ---  2F5 7 --- }
143F: 0025 { 2E6 7 ---  2F6 7 ---  2E7 7 ---  2F7 7 --- }
1440: 015D { 1F4 0 ---  1F7 0 ---  1F5 0 ---  1FC 0 --- }
1441: 015E { 1F5 0 x--  1FC 0 ---  1F5 0 ---  1FD 0 --- }
1442: 015F { 1F5 0 x--  1FD 0 ---  1F6 0 ---  1F8 0 --- }
1443: 0025 { 0F8 0 ---  0F8 0 ---  0F8 0 ---  19D 6 --- }
1444: 0025 { 0F8 0 ---  1BE 6 ---  0F8 0 ---  1BF 6 --- }
1445: 0025 { 0F8 0 ---  19C 6 ---  0F8 0 ---  0F8 0 --- }
1446: 0025 { 0F8 0 ---  1BC 6 ---  0F8 0 ---  1BF 6 --- }
1447: 0025 { 0F8 0 ---  1BE 6 ---  0F8 0 ---  1BD 6 --- }
1448: 0025 { 0F8 0 ---  0F8 0 ---  18F 6 ---  1A2 6 --- }
1449: 0025 { 18E 6 ---  1A1 6 ---  0F8 0 ---  0F8 0 --- }
144A: ~
144B: ~
144C: ~
144D: ~
144E: ~
144F: ~
1450: 0160 { 1F7 0 ---  1F7 0 -y-  1FE 0 x--  1FF 0 -y- }
1451: 0161 { 1FE 0 -y-  1FF 0 ---  1FF 0 -y-  1FE 0 x-- }
1452: 0162 { 1FE 0 ---  1FF 0 ---  1F8 0 ---  1F8 0 -y- }
1453: 0025 { 0F8 0 ---  0F8 0 ---  1A2 6 ---  1A2 6 --- }
1454: 0025 { 004 0 ---  004 0 ---  004 0 ---  004 0 --- }
1455: 0025 { 1A1 6 ---  1A1 6 ---  0F8 0 ---  0F8 0 --- }
1456: 0025 { 1AC 6 ---  0F8 0 ---  1AF 6 ---  0F8 0 --- }
1457: 0025 { 1AE 6 ---  0F8 0 ---  1AD 6 ---  0F8 0 --- }
1458: 0025 { 0F8 0 ---  0F8 0 ---  1B2 6 ---  19F 6 --- }
1459: 0025 { 1B1 6 ---  19E 6 ---  0F8 0 ---  0F8 0 --- }
145A: ~
145B: ~
145C: ~
145D: ~
145E: ~
145F: ~
1460: 0163 { 1F7 0 ---  1F9 0 ---  1FE 0 ---  1FA 0 --- }
1461: 0164 { 1FF 0 x--  1FA 0 ---  1FE 0 ---  1FA 0 x-- }
1462: 0165 { 1FE 0 xy-  1FA 0 ---  1F8 0 ---  1FB 0 --- }
1463: 0025 { 0F8 0 ---  0F8 0 ---  18D 6 ---  0F8 0 --- }
1464: 0025 { 1AE 6 ---  0F8 0 ---  1AF 6 ---  0F8 0 --- }
1465: 0025 { 18C 6 ---  0F8 0 ---  0F8 0 ---  0F8 0 --- }
1466: ~
1467: ~
1468: ~
1469: ~
146A: ~
146B: ~
146C: ~
146D: ~
146E: ~
146F: ~
1470: 005A { 0D8 5 -y-  0C8 5 -y-  0FE 5 -y-  0C9 5 -y- }
1471: 0049 { 0FE 5 -y-  0FE 5 -y-  0FE 5 -y-  0FE 5 -y- }
1472: 0049 { 0FE 5 -y-  0FE 5 -y-  0FE 5 -y-  0FE 5 -y- }
1473: 0049 { 0FE 5 -y-  0FE 5 -y-  0FE 5 -y-  0FE 5 -y- }
1474: 004F { 0B5 5 ---  0B5 5 -y-  0FD 5 -y-  0FD 5 -y- }
1475: 0060 { 0FD 5 -y-  0FD 5 -y-  0F5 5 -y-  0E6 5 -y- }
1476: 012F { 200 6 ---  202 6 ---  201 6 ---  203 6 --- }
1477: ~
1478: ~
1479: ~
147A: ~
147B: ~
147C: ~
147D: ~
147E: ~
147F: ~
1480: 0025 { 0F8 4 -y-  0F8 4 -y-  0F8 4 -y-  0F8 4 -y- }
1481: 0057 { 0D0 5 -y-  0C0 5 -y-  0FE 5 -y-  0FE 5 -y- }
1482: 0049 { 0FE 5 -y-  0FE 5 -y-  0FE 5 -y-  0FE 5 -y- }
1483: 0052 { 0FE 5 -y-  0FE 5 -y-  0D0 5 xy-  0E7 5 -y- }
1484: 004A { 0FD 5 -y-  0FD 5 -y-  0FD 5 -y-  0FD 5 -y- }
1485: 005D { 0F5 5 -y-  0E6 5 -y-  0F8 5 -y-  0F8 5 -y- }
1486: ~
1487: ~
1488: ~
1489: ~
148A: ~
148B: ~
148C: ~
148D: ~
148E: 020C { 169 0 x-p  179 0 x-p  168 0 x-p  178 0 x-p }
148F: 020C { 168 0 --p  178 0 --p  169 0 --p  179 0 --p }
1490: 0025 { 0F8 4 -y-  0F8 4 -y-  0F8 4 -y-  0F8 4 -y- }
1491: 0054 { 0F8 5 -y-  0F8 5 -y-  0D0 5 -y-  0C0 5 -y- }
1492: 0049 { 0FE 5 -y-  0FE 5 -y-  0FE 5 -y-  0FE 5 -y- }
1493: 005F { 0D0 5 xy-  0E7 5 -y-  0FD 5 -y-  0FD 5 -y- }
1494: 0063 { 0FD 5 -y-  0C3 5 -y-  0B7 5 -y-  0A7 5 -y- }
1495: 0025 { 0F8 4 -y-  0F8 4 -y-  0F8 4 -y-  0F8 4 -y- }
1496: ~
1497: ~
1498: ~
1499: ~
149A: ~
149B: ~
149C: ~
149D: 0025 { 180 0 ---  190 0 ---  181 0 ---  191 0 --- }
149E: 0025 { 182 0 ---  192 0 ---  183 0 ---  193 0 --- }
149F: 0025 { 181 0 x--  191 0 x--  180 0 x--  190 0 x-- }
14A0: 0025 { 0F8 4 -y-  0F8 4 -y-  0F8 4 -y-  0F8 4 -y- }
14A1: 0025 { 0F8 4 -y-  0F8 4 -y-  0F8 4 -y-  0F8 4 -y- }
14A2: 004B { 0B0 5 -y-  0F8 5 -y-  0B1 5 -y-  0F8 5 -y- }
14A3: 004C { 0C1 5 -y-  0F8 5 -y-  0C2 5 -y-  0F8 5 -y- }
14A4: 0025 { 0F8 4 -y-  0F8 4 -y-  0F8 4 -y-  0F8 4 -y- }
14A5: 0025 { 0F8 4 -y-  0F8 4 -y-  0F8 4 -y-  0F8 4 -y- }
14A6: ~
14A7: ~
14A8: ~
14A9: ~
14AA: ~
14AB: ~
14AC: ~
14AD: 0025 { 1A0 0 ---  1B0 0 ---  1A1 0 ---  1B1 0 --- }
14AE: 0025 { 1A2 0 ---  1B2 0 ---  1A3 0 ---  1B3 0 --- }
14AF: 0025 { 1A1 0 x--  1B1 0 x--  1A0 0 x--  1B0 0 x-- }
14B0: 0130 { 180 2 ---  190 2 ---  181 2 ---  191 2 --- }
14B1: 0130 { 182 2 ---  192 2 ---  183 2 ---  193 2 --- }
14B2: 0130 { 184 2 ---  194 2 ---  185 2 ---  195 2 --- }
14B3: 0130 { 18C 2 ---  19C 2 ---  18D 2 ---  19D 2 --- }
14B4: 0130 { 18E 2 ---  19E 2 ---  18F 2 ---  19F 2 --- }
14B5: 012F { 1A6 2 ---  1B6 2 ---  1A7 2 ---  1B7 2 --- }
14B6: 012F { 1B6 2 -y-  1A6 2 -y-  1B7 2 -y-  1A7 2 -y- }
14B7: ~
14B8: ~
14B9: ~
14BA: ~
14BB: ~
14BC: ~
14BD: 0025 { 1C0 0 ---  1D0 0 ---  1C1 0 ---  1D1 0 --- }
14BE: 0025 { 1C2 0 ---  1D2 0 ---  1C3 0 ---  1D3 0 --- }
14BF: 0025 { 1C1 0 x--  1D1 0 x--  1C0 0 x--  1D0 0 x-- }
14C0: 0130 { 1A0 2 ---  1B0 2 ---  1A1 2 ---  1B1 2 --- }
14C1: 0130 { 1A2 2 ---  1A2 2 ---  1A2 2 ---  1A2 2 --- }
14C2: 0130 { 1A4 2 ---  1B4 2 ---  1A5 2 ---  1B5 2 --- }
14C3: 0130 { 1AC 2 ---  1BC 2 ---  1AD 2 ---  1BD 2 --- }
14C4: 0130 { 1AE 2 ---  1BE 2 ---  1AF 2 ---  1BF 2 --- }
14C5: 012F { 1C7 2 x--  1D7 2 x--  1C6 2 x--  1D6 2 x-- }
14C6: 012F { 1C6 2 ---  1D6 2 ---  1C7 2 ---  1D7 2 --- }
14C7: ~
14C8: ~
14C9: ~
14CA: ~
14CB: ~
14CC: ~
14CD: 2300 { 1E0 0 ---  1F0 0 ---  1E1 0 ---  1F1 0 --- }
14CE: 0025 { 1E2 0 ---  1F2 0 ---  1E3 0 ---  1F3 0 --- }
14CF: 0025 { 1E1 0 x--  1F1 0 x--  1E0 0 x--  1F0 0 x-- }
14D0: 0130 { 1C0 2 ---  1D0 2 ---  1C1 2 ---  1D1 2 --- }
14D1: 0130 { 1C2 2 ---  1D2 2 ---  1C3 2 ---  1D3 2 --- }
14D2: 0130 { 1C4 2 ---  1D4 2 ---  1C5 2 ---  1D5 2 --- }
14D3: 0130 { 180 2 ---  1D0 2 ---  185 2 ---  1D5 2 --- }
14D4: ~
14D5: ~
14D6: ~
14D7: ~
14D8: ~
14D9: ~
14DA: ~
14DB: ~
14DC: ~
14DD: 0130 { 1F4 2 --p  1F7 2 --p  1F5 2 --p  1FC 2 --p }
14DE: 0130 { 1F5 2 x-p  1FC 2 --p  1F5 2 --p  1FD 2 --p }
14DF: 0130 { 1F5 2 x-p  1FD 2 --p  1F6 2 --p  1F8 2 --p }
14E0: 00B1 { 1E5 2 -y-  1E4 2 -y-  1E6 2 -y-  0FF 2 -y- }
14E1: 00B3 { 184 2 -y-  0FF 2 -y-  0FF 2 -y-  0FF 2 -y- }
14E2: 00B4 { 0FF 2 -y-  0FF 2 -y-  0FF 2 -y-  0FF 2 -y- }
14E3: 00B5 { 0FF 2 -y-  0FF 2 -y-  184 2 xy-  0FF 2 -y- }
14E4: 00B6 { 1E6 2 xy-  0FF 2 -y-  1E5 2 xy-  1E4 2 xy- }
14E5: ~
14E6: ~
14E7: ~
14E8: ~
14E9: ~
14EA: ~
14EB: ~
14EC: ~
14ED: 0130 { 1F7 2 --p  1F7 2 -yp  1FE 2 x-p  1FF 2 -yp }
14EE: 0130 { 1FE 2 -yp  1FF 2 --p  1FF 2 -yp  1FE 2 x-p }
14EF: 0130 { 1FE 2 --p  1FF 2 --p  1F8 2 --p  1F8 2 -yp }
14F0: 00B4 { 0FF 2 ---  0FF 2 ---  0FF 2 ---  0AE 2 --- }
14F1: 00B4 { 0FF 2 -y-  0FF 2 -y-  0AE 2 -y-  0FF 2 -y- }
14F2: ~
14F3: ~
14F4: ~
14F5: ~
14F6: ~
14F7: ~
14F8: ~
14F9: ~
14FA: ~
14FB: ~
14FC: ~
14FD: 0130 { 1F7 2 --p  1F9 2 --p  1FE 2 --p  1FA 2 --p }
14FE: 0130 { 1FF 2 x-p  1FA 2 --p  1FE 2 --p  1FA 2 x-p }
14FF: 0130 { 1FE 2 xyp  1FA 2 --p  1F8 2 --p  1FB 2 --p }
