2300: 0025 { 0F8 4 ---  0F8 4 ---  0F8 4 ---  0F8 4 --- }
2301: 0075 { 182 5 ---  182 5 xy-  182 5 xy-  182 5 --- }
2302: 0075 { 182 5 --p  182 5 xyp  182 5 xyp  182 5 --p }
2303: 0075 { 184 5 xy-  182 5 xy-  185 5 xy-  182 5 --- }
2304: 0130 { 187 5 xy-  188 5 xy-  182 5 xy-  182 5 --- }
2305: 0130 { 0AF 5 ---  188 5 xy-  185 5 xy-  182 5 --- }
2306: 0130 { 0CD 6 ---  0CD 6 ---  0FB 4 ---  0FB 4 --- }
2307: 0130 { 0FB 4 ---  0FB 4 ---  0FB 4 ---  0FB 4 --- }
2308: 0130 { 0FB 4 ---  0FB 4 ---  0CD 6 ---  0CD 6 --p }
2309: 010F { 1EC 2 --p  1B0 2 --p  1ED 2 --p  1B1 2 --p }
230A: 010B { 1A2 2 ---  19C 3 ---  1A3 2 ---  19C 3 --- }
230B: 0130 { 202 0 ---  212 0 ---  203 0 ---  213 0 --- }
230C: 0130 { 202 0 --p  212 0 --p  203 0 --p  213 0 --p }
230D: 0130 { 212 0 ---  212 0 ---  213 0 ---  213 0 --- }
230E: 0025 { 2E6 5 ---  2F6 5 ---  2E7 5 ---  2F7 5 --- }
230F: 0025 { 2E6 5 --p  2F6 5 --p  2E7 5 --p  2F7 5 --p }
2310: 2300 { 2E6 5 ---  2F6 5 ---  2E7 5 ---  2F7 5 --- }
2311: 2300 { 2C8 3 ---  2D8 3 ---  2C9 3 ---  2D9 3 --- }
2312: 010F { 1CA 2 ---  1E0 2 ---  1CB 2 ---  1DB 2 --- }
2313: 010E { 1CC 2 ---  1DC 2 ---  1CB 2 ---  1DB 2 --- }
2314: 0110 { 1CC 2 ---  1DC 2 ---  1CA 2 x--  1E0 2 x-- }
2315: 00B8 { 1CD 2 ---  1DD 2 ---  1DD 2 -y-  1CD 2 -y- }
2316: 00B1 { 1E4 2 ---  1E5 2 ---  0FF 2 ---  1E6 2 --- }
2317: 00B2 { 1E7 2 ---  1E8 2 ---  0FF 2 ---  1E9 2 --- }
2318: 00B3 { 0FF 2 ---  184 2 ---  0FF 2 ---  0FF 2 --- }
2319: 00B4 { 0FF 2 ---  0FF 2 ---  0FF 2 ---  0FF 2 --- }
231A: 00B5 { 0FF 2 ---  0FF 2 ---  0FF 2 ---  184 2 x-- }
231B: 00B6 { 0FF 2 ---  1E6 2 x--  1E4 2 x--  1E5 2 x-- }
231C: 00B7 { 0FF 2 ---  1E9 2 x--  1E7 2 x--  1B0 2 --- }
231D: 00BE { 1C1 2 --p  1D1 2 --p  1C3 2 --p  1D3 2 --p }
231E: 00BD { 1E1 2 --p  1F1 2 --p  1E3 2 --p  1F3 2 --p }
231F: 00BF { 1E1 2 ---  1F1 2 ---  1E3 2 ---  1F3 2 --- }
2320: 00C0 { 1C1 2 ---  1D1 2 ---  1C3 2 ---  1D3 2 --- }
2321: 00C1 { 1C4 2 ---  1D4 2 ---  1AF 2 ---  1BF 2 --- }
2322: 00C2 { 1AF 2 x--  1BF 2 x--  1C4 2 x--  1D4 2 x-- }
2323: 00C3 { 0F8 2 ---  1EA 2 ---  0F8 2 ---  191 2 --- }
2324: 0025 { 180 5 ---  190 5 ---  181 5 ---  191 5 --- }
2325: 0130 { 0AE 5 ---  0AE 5 ---  0FB 4 ---  0FB 4 --- }
2326: 0130 { 0FB 4 ---  0FB 4 ---  0AE 5 --p  0AE 5 --p }
2327: 0130 { 0AE 5 --p  0AE 5 --p  181 5 --p  191 5 --p }
2328: 0130 { 04B 7 ---  05B 7 ---  04C 7 ---  05C 7 --- }
2329: 0130 { 04D 7 ---  05D 7 ---  04D 7 ---  05D 7 --- }
232A: 0076 { 1C0 2 ---  1D0 2 -y-  192 2 x--  192 2 x-- }
232B: 0077 { 193 2 x--  193 2 x--  193 2 x--  193 2 x-- }
232C: 0077 { 02E 2 -y-  02E 2 -y-  0FA 2 -y-  0FA 2 -y- }
232D: 0077 { 0FA 2 -y-  0FA 2 -y-  02E 2 -yp  02E 2 -yp }
232E: 0077 { 193 2 x-p  193 2 x-p  192 2 x-p  192 2 x-p }
232F: 0130 { 0FA 2 -y-  0FA 2 -y-  0FA 2 -y-  0FA 2 -y- }
2330: 0130 { 1C3 2 ---  1D3 2 ---  1C4 2 ---  1D4 2 --- }
2331: 0130 { 1D3 2 -y-  1C3 2 -y-  1D4 2 -y-  1C4 2 -y- }
2332: 0130 { 1C3 2 --p  1D3 2 --p  1C4 2 --p  1D4 2 --p }
2333: 0076 { 040 2 ---  050 2 -y-  013 2 -y-  013 2 -y- }
2334: 0077 { 012 2 -y-  012 2 -y-  013 2 -y-  013 2 -y- }
2335: 0077 { 0AE 2 ---  0AE 2 ---  0FB 4 ---  0FB 4 --- }
2336: 0077 { 0FB 4 ---  0FB 4 ---  0AE 2 --p  0AE 2 --p }
2337: 0077 { 012 2 -yp  012 2 -yp  013 2 -yp  013 2 -yp }
2338: 0130 { 043 2 ---  053 2 ---  044 2 ---  054 2 --- }
2339: 0130 { 053 2 -y-  043 2 -y-  054 2 -y-  044 2 -y- }
233A: 0130 { 043 2 --p  053 2 --p  044 2 --p  054 2 --p }
233B: 0130 { 182 5 --p  0BF 3 x--  182 5 xyp  0BF 3 x-- }
233C: 0130 { 0F8 5 ---  0F8 5 ---  195 5 ---  195 5 --- }
233D: 0130 { 196 5 ---  196 5 ---  197 5 ---  197 5 --- }
233E: 0130 { 182 2 --p  192 2 --p  183 2 --p  193 2 --p }
233F: 0130 { 04B 7 --p  05B 7 --p  04C 7 --p  05C 7 --p }
2340: 0130 { 0BF 5 ---  0BF 5 ---  0BF 5 ---  0BF 5 --- }
2341: 0130 { 180 5 ---  190 5 ---  0BE 5 ---  0BE 5 --- }
2342: 0130 { 0BE 5 x--  0BE 5 x--  181 5 ---  191 5 --- }
2343: 0130 { 192 2 x-p  192 2 x-p  03E 2 -y-  03E 2 -y- }
2344: 0130 { 03F 2 x-p  03F 2 x-p  03F 2 x-p  03F 2 x-p }
2345: 0130 { 03E 2 xy-  03E 2 xy-  193 2 x-p  193 2 x-p }
2346: 0130 { 012 2 -y-  012 2 -y-  0BE 2 -yp  0BE 2 -yp }
2347: 0130 { 0BF 2 -yp  0BF 2 -yp  0BF 2 -yp  0BF 2 -yp }
2348: 0130 { 0BE 2 xyp  0BE 2 xyp  013 2 -y-  013 2 -y- }
2349: 0130 { 09F 5 --p  09E 5 --p  08E 5 --p  08F 5 --p }
234A: 0130 { 08E 5 --p  08F 5 --p  08E 5 --p  08F 5 --p }
234B: 0130 { 08E 5 x-p  08F 5 x-p  09F 5 x-p  09E 5 x-p }
234C: 0130 { 182 5 --p  0BE 3 ---  182 5 xyp  0BF 3 x-- }
234D: 0130 { 182 5 --p  0BF 3 x--  182 5 xyp  0BE 3 x-- }
234E: 0130 { 182 5 ---  0CE 6 x--  182 5 xy-  0CF 6 --- }
234F: 0130 { 182 5 --p  0CF 6 x--  182 5 xyp  0CE 6 x-- }
2350: 0130 { 182 5 ---  0CF 6 ---  182 5 xy-  0CF 6 x-- }
2351: 0130 { 181 5 ---  191 5 ---  0AE 5 ---  0AE 5 --- }
2352: 0130 { 192 2 x--  192 2 x--  02E 2 -y-  02E 2 -y- }
2353: 0130 { 02E 2 -yp  02E 2 -yp  193 2 x-p  193 2 x-p }
2354: 0130 { 01F 2 --p  01E 2 --p  00E 2 --p  00F 2 --p }
2355: 0130 { 00E 2 --p  00F 2 --p  00E 2 --p  00F 2 --p }
2356: 0130 { 00E 2 x-p  00F 2 x-p  01F 2 x-p  01E 2 x-p }
2357: 0130 { 013 2 -y-  013 2 -y-  0AE 2 ---  0AE 2 --- }
2358: 0130 { 0AE 2 --p  0AE 2 --p  012 2 -yp  012 2 -yp }
2359: 0130 { 09E 5 -yp  09F 5 -yp  08F 5 -yp  08E 5 -yp }
235A: 0130 { 08F 5 -yp  08E 5 -yp  08F 5 -yp  08E 5 -yp }
235B: 0130 { 08F 5 xyp  08E 5 xyp  09E 5 xyp  09F 5 xyp }
235C: 0130 { 09F 2 --p  09E 2 --p  08E 2 --p  08F 2 --p }
235D: 0130 { 08E 2 --p  08F 2 --p  08E 2 --p  08F 2 --p }
235E: 0130 { 08E 2 x-p  08F 2 x-p  09F 2 x-p  09E 2 x-p }
235F: 0025 { 0AC 7 ---  0BC 7 ---  0AD 7 ---  0BD 7 --- }
2360: 0025 { 02C 7 ---  03C 7 ---  02D 7 ---  03D 7 --- }
2361: 0130 { 1A8 5 ---  1B8 0 ---  1A9 5 ---  1B9 0 --- }
2362: 0130 { 1B8 0 -y-  1A8 5 -y-  1B9 0 -y-  1A9 5 -y- }
2363: 0130 { 1A8 5 --p  1B8 0 --p  1A9 5 --p  1B9 0 --p }
2364: 0130 { 01E 2 -yp  01F 2 -yp  00F 2 -yp  00E 2 -yp }
2365: 0130 { 00F 2 -yp  00E 2 -yp  00F 2 -yp  00E 2 -yp }
2366: 0130 { 00F 2 xyp  00E 2 xyp  01E 2 xyp  01F 2 xyp }
2367: 0025 { 026 0 ---  027 0 -y-  026 0 ---  1C2 0 --- }
2368: 0025 { 026 0 ---  1C3 0 ---  026 0 ---  1C4 0 --- }
2369: 0025 { 026 0 ---  1C5 0 ---  026 0 ---  1C6 0 --- }
236A: 0025 { 026 0 ---  1C7 0 ---  026 0 ---  1C8 0 --- }
236B: 0025 { 026 0 ---  1C9 0 ---  026 0 ---  027 0 -y- }
236C: 0130 { 09E 2 -yp  09F 2 -yp  08F 2 -yp  08E 2 -yp }
236D: 0130 { 08F 2 -yp  08E 2 -yp  08F 2 -yp  08E 2 -yp }
236E: 0130 { 08F 2 xyp  08E 2 xyp  09E 2 xyp  09F 2 xyp }
236F: 0025 { 1A2 0 ---  042 0 ---  1A3 0 ---  041 0 --- }
2370: 0025 { 1A2 0 ---  040 0 ---  1A3 0 ---  041 0 --- }
2371: 0025 { 1A2 0 ---  041 0 x--  1A3 0 ---  040 0 x-- }
2372: 0025 { 03B 0 ---  03C 0 ---  0FB 4 ---  0FB 4 --- }
2373: 0025 { 03D 0 ---  03C 0 ---  0FB 4 ---  0FB 4 --- }
2374: 0025 { 0FB 4 ---  0FB 4 ---  03D 0 x-p  03C 0 x-p }
2375: 0025 { 0FB 4 ---  0FB 4 ---  03B 0 x-p  03C 0 x-p }
2376: 0025 { 026 0 ---  027 0 -y-  026 0 ---  027 0 -y- }
2377: 0025 { 04A 0 ---  071 0 ---  1D2 0 ---  1E2 0 --- }
2378: 0025 { 1D3 0 ---  1E3 0 ---  1D4 0 ---  1E4 0 --- }
2379: 0025 { 1D5 0 ---  1E5 0 ---  1D6 0 ---  1E6 0 --- }
237A: 0025 { 1D7 0 ---  1E7 0 ---  1D8 0 ---  1E8 0 --- }
237B: 0025 { 1D9 0 ---  1E9 0 ---  04A 0 ---  072 0 --- }
237C: 0025 { 198 0 ---  198 0 ---  199 0 ---  199 0 --- }
237D: 0025 { 061 0 ---  071 0 ---  062 0 ---  072 0 --- }
237E: 0025 { 061 0 --p  071 0 --p  062 0 --p  072 0 --p }
237F: 0025 { 04A 0 ---  071 0 ---  04A 0 ---  072 0 --- }
2380: 0025 { 031 0 ---  032 0 ---  032 0 ---  031 0 --- }
2381: 0025 { 1DC 0 -y-  08D 0 -y-  09D 0 xy-  0D7 0 xy- }
2382: 0025 { 09D 0 -y-  0D7 0 -y-  09D 0 xy-  0D7 0 xy- }
2383: 0025 { 09D 0 -y-  0D7 0 -y-  1DC 0 xy-  08D 0 xy- }
2384: 0025 { 022 0 ---  023 0 ---  023 0 ---  022 0 --- }
2385: 0025 { 061 0 ---  032 0 ---  031 0 ---  072 0 --- }
2386: 0025 { 031 0 x--  072 0 x--  061 0 x--  032 0 x-- }
2387: 0025 { 031 0 ---  071 0 ---  032 0 ---  072 0 --- }
2388: 0025 { 032 0 ---  071 0 ---  062 0 ---  072 0 --- }
2389: 0025 { 061 0 ---  071 0 ---  062 0 ---  031 0 --- }
238A: 0025 { 062 0 ---  032 0 ---  062 0 ---  072 0 --- }
238B: 0025 { 032 0 ---  071 0 ---  062 0 ---  072 0 --- }
238C: 0025 { 062 0 ---  071 0 ---  031 0 ---  072 0 --- }
238D: 0025 { 022 0 --p  023 0 --p  023 0 --p  022 0 --p }
238E: 2300 { 294 2 ---  2A4 2 ---  295 2 ---  2A5 2 --- }
238F: 2300 { 0FE 5 ---  0FE 5 ---  0FE 5 ---  0FE 5 --- }
2390: 0025 { 02C 6 ---  03C 6 ---  02D 6 ---  03D 6 --- }
2391: 0025 { 08D 0 ---  08D 0 -y-  0D7 0 x--  0D7 0 xy- }
2392: 0025 { 0D7 0 ---  0D7 0 -y-  0D7 0 x--  0D7 0 xy- }
2393: 0025 { 0D7 0 ---  0D7 0 -y-  08D 0 x--  08D 0 xy- }
2394: 0130 { 1A8 5 ---  1B8 3 ---  1A9 5 ---  1B9 3 --- }
2395: 0130 { 1A8 5 --p  1B8 3 --p  1A9 5 --p  1B9 3 --p }
2396: 0130 { 1B8 3 -y-  1A8 5 -y-  1B9 3 -y-  1A9 5 -y- }
2397: 0130 { 180 5 --p  190 5 --p  181 5 --p  191 5 --p }
2398: 0025 { 058 1 ---  059 1 ---  059 1 ---  058 1 --- }
2399: 0025 { 058 1 --p  059 1 --p  059 1 --p  058 1 --p }
239A: 0025 { 04D 6 ---  04D 6 ---  07B 4 ---  07B 4 --- }
239B: 0025 { 07B 4 ---  07B 4 ---  07B 4 ---  07B 4 --- }
239C: 0025 { 07B 4 ---  07B 4 ---  04D 6 ---  04D 6 --p }
239D: 0025 { 048 1 ---  04E 6 x--  049 1 ---  04F 6 --- }
239E: 0025 { 058 1 ---  04F 6 ---  059 1 ---  04F 6 x-- }
239F: 0025 { 048 1 ---  04F 6 x--  049 1 ---  04E 6 x-- }
23A0: 0025 { 048 1 ---  059 1 ---  049 1 ---  058 1 --- }
23A1: 0025 { 08D 0 ---  1DC 0 ---  0D7 0 x--  09D 0 x-- }
23A2: 0025 { 0D7 0 ---  09D 0 ---  0D7 0 x--  09D 0 x-- }
23A3: 0025 { 0D7 0 ---  09D 0 ---  08D 0 x--  1DC 0 x-- }
23A4: 0025 { 058 1 ---  059 1 ---  009 6 ---  019 6 --- }
23A5: 0025 { 00A 6 ---  01A 6 ---  00B 6 ---  01B 6 --- }
23A6: 0025 { 00C 6 ---  01C 6 ---  058 1 ---  059 1 --- }
23A7: 010E { 1CC 2 --p  1DC 2 --p  1CB 2 --p  1DB 2 --p }
23A8: 0130 { 193 2 x-p  193 2 x-p  193 2 x-p  193 2 x-p }
23A9: 0130 { 182 5 ---  182 5 xy-  187 5 ---  188 5 --- }
23AA: 0130 { 184 5 xy-  182 5 xy-  0BB 5 ---  188 5 --- }
23AB: 0130 { 0AA 7 ---  0BA 7 ---  0AA 7 x--  0BA 7 x-- }
23AC: 0130 { 0AA 7 --p  0BA 7 --p  0AA 7 x-p  0BA 7 x-p }
23AD: 0E70 { 202 0 ---  212 0 ---  203 0 ---  213 0 --- }
23AE: 0E70 { 00D 6 ---  0F8 2 ---  00D 6 ---  0F8 2 --- }
23AF: 0201 { 0F8 5 ---  0F8 5 ---  0F8 5 ---  0F8 5 --- }
23B0: 0025 { 098 6 xy-  088 6 xy-  097 6 xy-  0DE 6 --- }
23B1: 0025 { 085 6 ---  0DF 6 ---  086 6 ---  096 6 --- }
23B2: 0025 { 0F8 4 ---  0F8 4 ---  083 7 ---  083 7 --- }
23B3: 0025 { 084 7 ---  084 7 ---  0F8 4 ---  0F8 4 --- }
23B4: 0025 { 098 6 xy-  088 6 xy-  097 6 xy-  0A8 6 --- }
23B5: 0025 { 085 6 ---  0A9 6 ---  086 6 ---  096 6 --- }
23B6: 020B { 2E6 5 ---  2F6 5 ---  2E7 5 ---  2F7 5 --- }
23B7: 0025 { 018 6 xy-  008 6 xy-  017 6 xy-  028 6 --- }
23B8: 0025 { 005 6 ---  029 6 ---  006 6 ---  016 6 --- }
23B9: 0130 { 182 2 ---  192 2 ---  183 2 ---  193 2 --- }
23BA: 0025 { 2E6 2 ---  2F6 2 ---  2E7 2 ---  2F7 2 --- }
23BB: 0025 { 2E6 2 --p  2F6 2 --p  2E7 2 --p  2F7 2 --p }
23BC: 0130 { 0F8 4 ---  0F8 4 ---  0F8 4 ---  1A5 2 --- }
23BD: 0130 { 1C3 3 ---  1D3 3 ---  1C4 3 ---  1D4 3 --- }
23BE: 0130 { 1C3 3 --p  1D3 3 --p  1C4 3 --p  1D4 3 --p }
23BF: 0130 { 1D4 3 xy-  1C4 3 xy-  1D3 3 xy-  1C3 3 xy- }
23C0: 0025 { 096 6 xy-  086 6 xy-  0EE 6 ---  085 6 xy- }
23C1: 0025 { 0EF 6 ---  097 6 ---  088 6 ---  098 6 --- }
23C2: 0025 { 0F8 1 ---  0F8 1 ---  003 1 ---  003 1 --- }
23C3: 0025 { 004 1 ---  004 1 ---  0F8 1 ---  0F8 1 --- }
23C4: 0025 { 096 6 xy-  086 6 xy-  0B8 6 ---  085 6 xy- }
23C5: 0025 { 0B9 6 ---  097 6 ---  088 6 ---  098 6 --- }
23C6: 0130 { 1A5 2 ---  1A6 2 ---  1A6 2 ---  1B6 2 --- }
23C7: 0025 { 016 6 xy-  006 6 xy-  038 6 ---  005 6 xy- }
23C8: 0025 { 039 6 ---  017 6 ---  008 6 ---  018 6 --- }
23C9: 0130 { 2E6 2 ---  0CE 6 x--  2E7 2 ---  0CF 6 --- }
23CA: 0130 { 2E6 2 ---  0CF 6 ---  2E7 2 ---  0CF 6 x-- }
23CB: 0130 { 2E6 2 ---  0CF 6 x--  2E7 2 ---  0CE 6 x-- }
23CC: 0201 { 2E6 5 ---  2F6 5 ---  2E7 5 ---  2F7 5 --- }
23CD: 0130 { 2AD 2 ---  2BD 2 ---  2AE 2 ---  2BE 2 --- }
23CE: 0130 { 2AD 2 --p  2BD 2 --p  2AE 2 --p  2BE 2 --p }
23CF: 0E70 { 2AD 2 ---  2BD 2 ---  2AE 2 ---  2BE 2 --- }
23D0: 0025 { 098 6 xy-  088 6 xy-  097 6 xy-  0C8 6 --- }
23D1: 0025 { 085 6 ---  0C9 6 ---  086 6 ---  096 6 --- }
23D2: 0025 { 098 7 xy-  088 7 xy-  097 7 xy-  0C8 7 --- }
23D3: 0025 { 085 7 ---  0C9 7 ---  086 7 ---  096 7 --- }
23D4: 0025 { 098 7 xy-  088 7 xy-  097 7 xy-  0A8 7 --- }
23D5: 0025 { 085 7 ---  0A9 7 ---  086 7 ---  096 7 --- }
23D6: 0025 { 098 3 xy-  088 3 xy-  097 3 xy-  0A8 3 --- }
23D7: 0025 { 085 3 ---  0A9 3 ---  086 3 ---  096 3 --- }
23D8: 0025 { 098 3 xy-  088 3 xy-  097 3 xy-  0C8 3 --- }
23D9: 0025 { 085 3 ---  0C9 3 ---  086 3 ---  096 3 --- }
23DA: 0025 { 089 6 ---  099 6 ---  08A 6 ---  0A8 6 --- }
23DB: 0025 { 085 6 ---  0A9 6 ---  086 6 ---  096 6 --- }
23DC: 0025 { 089 6 ---  099 6 ---  08A 6 ---  0C8 6 --- }
23DD: 0025 { 085 6 ---  0C9 6 ---  086 6 ---  096 6 --- }
23DE: 0025 { 018 6 xy-  008 6 xy-  017 6 xy-  009 6 --- }
23DF: 0025 { 005 6 ---  00A 6 ---  006 6 ---  016 6 --- }
23E0: 0025 { 096 6 xy-  086 6 xy-  0D8 6 ---  085 6 xy- }
23E1: 0025 { 0D9 6 ---  097 6 ---  088 6 ---  098 6 --- }
23E2: 0025 { 096 7 xy-  086 7 xy-  0D8 7 ---  085 7 xy- }
23E3: 0025 { 0D9 7 ---  097 7 ---  088 7 ---  098 7 --- }
23E4: 0025 { 096 7 xy-  086 7 xy-  0B8 7 ---  085 7 xy- }
23E5: 0025 { 0B9 7 ---  097 7 ---  088 7 ---  098 7 --- }
23E6: 0025 { 096 3 xy-  086 3 xy-  0B8 3 ---  085 3 xy- }
23E7: 0025 { 0B9 3 ---  097 3 ---  088 3 ---  098 3 --- }
23E8: 0025 { 096 3 xy-  086 3 xy-  0D8 3 ---  085 3 xy- }
23E9: 0025 { 0D9 3 ---  097 3 ---  088 3 ---  098 3 --- }
23EA: 0025 { 08B 6 ---  09B 6 ---  0B8 6 ---  09C 6 --- }
23EB: 0025 { 0B9 6 ---  097 6 ---  088 6 ---  098 6 --- }
23EC: 0025 { 08B 6 ---  09B 6 ---  0D8 6 ---  09C 6 --- }
23ED: 0025 { 0D9 6 ---  097 6 ---  088 6 ---  098 6 --- }
23EE: 0025 { 016 6 xy-  006 6 xy-  019 6 ---  005 6 xy- }
23EF: 0025 { 01A 6 ---  017 6 ---  008 6 ---  018 6 --- }
23F0: 0025 { 098 6 xy-  088 6 xy-  097 6 xy-  089 6 --- }
23F1: 0025 { 085 6 ---  08A 6 ---  086 6 ---  096 6 --- }
23F2: 0025 { 098 7 xy-  088 7 xy-  097 7 xy-  089 7 --- }
23F3: 0025 { 085 7 ---  08A 7 ---  086 7 ---  096 7 --- }
23F4: 0025 { 089 6 ---  099 6 ---  08A 6 ---  0DE 6 --- }
23F5: 0025 { 085 6 ---  0DF 6 ---  086 6 ---  096 6 --- }
23F6: 0025 { 08B 6 ---  09B 6 ---  0EE 6 ---  09C 6 --- }
23F7: 0025 { 0EF 6 ---  097 6 ---  088 6 ---  098 6 --- }
23F8: 0E70 { 0AA 7 --p  0BA 7 --p  0AA 7 x-p  0BA 7 x-p }
23F9: ~
23FA: ~
23FB: ~
23FC: ~
23FD: ~
23FE: ~
23FF: ~
