5200: 0130 { 240 5 ---  250 5 ---  241 5 ---  251 5 --- }
5201: 0130 { 201 5 ---  252 5 ---  201 5 ---  211 5 --- }
5202: 0130 { 200 5 ---  210 5 ---  201 5 ---  211 5 --- }
5203: 0130 { 201 5 ---  211 5 ---  201 5 ---  211 5 --- }
5204: 0130 { 200 5 ---  210 5 ---  203 5 ---  213 5 --- }
5205: 0025 { 0F8 5 ---  0F8 5 ---  200 5 ---  210 5 --- }
5206: 0025 { 200 6 ---  210 6 ---  202 6 ---  212 6 --- }
5207: 0130 { 15E 0 ---  16E 0 ---  15F 0 ---  16F 0 --- }
5208: 0130 { 122 0 ---  123 0 ---  123 0 ---  122 0 --- }
5209: 0025 { 200 6 ---  210 6 ---  0FA 6 ---  0FA 6 --- }
520A: 0106 { 200 5 ---  210 5 ---  202 5 ---  212 5 --- }
520B: 0130 { 0F8 5 ---  220 5 ---  0F8 5 ---  221 5 --- }
520C: 0130 { 0F8 5 x--  221 5 x--  0F8 5 x--  220 5 x-- }
520D: 0130 { 223 7 ---  233 7 ---  224 7 ---  234 7 --- }
520E: 0130 { 225 7 ---  235 7 ---  226 7 ---  236 7 --- }
520F: 0130 { 0FF 7 ---  0FF 7 ---  0FF 7 ---  0FF 7 --- }
5210: 0025 { 260 5 ---  270 5 ---  261 5 ---  271 5 --- }
5211: 0130 { 262 5 ---  272 5 ---  201 5 ---  211 5 --- }
5212: 0130 { 200 5 ---  210 5 ---  202 5 ---  212 5 --- }
5213: 0130 { 202 5 ---  212 5 ---  202 5 ---  212 5 --- }
5214: 0130 { 203 5 ---  213 5 ---  203 5 ---  213 5 --- }
5215: 0025 { 0F8 6 ---  0F8 6 ---  200 6 ---  210 6 --- }
5216: 0025 { 202 6 ---  212 6 ---  202 6 ---  212 6 --- }
5217: 0130 { 16E 0 -y-  15E 0 -y-  16F 0 -y-  15F 0 -y- }
5218: ~
5219: 0025 { 0FA 6 ---  0FA 6 ---  0FA 6 ---  0FA 6 --- }
521A: ~
521B: ~
521C: ~
521D: ~
521E: 0130 { 0F8 7 ---  225 7 ---  0F8 7 ---  226 7 --- }
521F: 0130 { 0F8 7 ---  229 7 ---  0F8 7 ---  22A 7 --- }
5220: 0196 { 250 5 ---  260 5 ---  251 5 ---  261 5 --- }
5221: 019B { 252 5 ---  262 5 ---  253 5 ---  263 5 --- }
5222: 019B { 200 5 ---  202 5 ---  201 5 ---  203 5 --- }
5223: 019B { 200 5 ---  210 5 ---  201 5 ---  211 5 --- }
5224: 019B { 200 5 ---  212 5 ---  201 5 ---  213 5 --- }
5225: 0196 { 0F8 5 ---  200 5 ---  0F8 5 ---  201 5 --- }
5226: 0025 { 200 6 ---  202 6 ---  201 6 ---  203 6 --- }
5227: 0025 { 204 4 ---  204 4 -y-  0F8 4 ---  0F8 4 --- }
5228: 01DE { 202 5 ---  202 5 ---  203 5 ---  203 5 --- }
5229: 01DE { 210 5 ---  210 5 ---  211 5 ---  211 5 --- }
522A: 01DE { 212 5 ---  212 5 ---  213 5 ---  213 5 --- }
522B: 0130 { 205 2 ---  215 2 ---  206 2 ---  216 2 --- }
522C: 015A { 20C 0 ---  21C 0 ---  20D 0 ---  21D 0 --- }
522D: 015A { 20E 0 ---  21E 0 ---  20F 0 ---  21F 0 --- }
522E: 0130 { 235 7 ---  233 7 ---  236 7 ---  234 7 --- }
522F: 0130 { 239 7 ---  233 7 ---  23A 7 ---  234 7 --- }
5230: 01DE { 270 5 ---  210 5 ---  271 5 ---  211 5 --- }
5231: 0130 { 272 5 ---  210 5 ---  211 5 ---  211 5 --- }
5232: 0130 { 202 5 ---  202 5 ---  203 5 ---  203 5 --- }
5233: 0130 { 210 5 ---  210 5 ---  211 5 ---  211 5 --- }
5234: 0130 { 212 5 ---  212 5 ---  213 5 ---  213 5 --- }
5235: 0025 { 0F8 6 ---  200 6 ---  0F8 6 ---  201 6 --- }
5236: 0025 { 202 6 ---  202 6 ---  203 6 ---  203 6 --- }
5237: 0025 { 200 6 ---  0FA 6 ---  201 6 ---  0FA 6 --- }
5238: 01E4 { 192 2 -y-  194 2 -y-  193 2 -y-  186 2 xy- }
5239: 0025 { 217 3 -y-  207 3 ---  208 2 ---  218 2 --- }
523A: 0025 { 207 3 -y-  207 3 ---  208 2 ---  218 2 --- }
523B: 0025 { 207 3 -y-  217 3 ---  208 2 ---  218 2 --- }
523C: 015A { 22C 0 ---  23C 0 ---  22D 0 ---  23D 0 --- }
523D: 015B { 22E 0 ---  23E 0 ---  22F 0 ---  23F 0 --- }
523E: 015B { 20D 0 x--  21D 0 x--  20C 0 x--  21C 0 x-- }
523F: ~
5240: 0130 { 263 4 ---  0FB 4 ---  264 4 ---  0FB 4 --- }
5241: 0130 { 265 4 ---  0FB 4 ---  266 4 ---  0FB 4 --- }
5242: 0130 { 266 4 ---  0FB 4 ---  0FB 4 ---  0FB 4 --- }
5243: 0130 { 267 4 ---  0FB 4 ---  263 4 ---  0FB 4 --- }
5244: 0130 { 0FB 4 ---  0FB 4 ---  273 4 ---  0FB 4 --- }
5245: 0130 { 274 4 ---  0FB 4 ---  0FB 4 ---  0FB 4 --- }
5246: 0130 { 275 4 ---  0FB 4 ---  274 4 ---  0FB 4 --- }
5247: 0130 { 276 4 ---  0FB 4 ---  273 4 ---  0FB 4 --- }
5248: 0130 { 277 4 ---  0FB 4 ---  276 4 ---  0FB 4 --- }
5249: 0130 { 278 4 ---  0FB 4 ---  265 4 ---  0FB 4 --- }
524A: ~
524B: ~
524C: 015A { 22A 0 ---  23A 0 ---  22B 0 ---  23B 0 --- }
524D: 015B { 22B 0 x--  23B 0 x--  22A 0 x--  23A 0 x-- }
524E: 0159 { 1DE 0 -y-  1CE 0 -y-  1DE 0 -y-  1CE 0 -y- }
524F: ~
5250: 0000 { 280 7 ---  282 7 ---  281 7 ---  283 7 --- }
5251: 0000 { 284 7 ---  286 7 ---  285 7 ---  287 7 --- }
5252: 0000 { 288 7 ---  28A 7 ---  289 7 ---  28B 7 --- }
5253: ~
5254: ~
5255: 0130 { 280 2 ---  290 2 ---  281 2 ---  291 2 --- }
5256: 0130 { 282 2 ---  292 2 ---  283 2 ---  293 2 --- }
5257: 0130 { 284 2 ---  294 2 ---  285 2 ---  295 2 --- }
5258: 0130 { 286 2 ---  296 2 ---  287 2 ---  297 2 --- }
5259: 0130 { 288 6 ---  298 6 ---  289 6 ---  299 6 --- }
525A: 0025 { 28A 3 ---  29A 3 ---  28B 3 ---  29B 3 --- }
525B: 0130 { 217 3 -y-  207 3 ---  208 2 ---  218 2 --- }
525C: 0135 { 020 5 ---  020 5 ---  021 5 ---  021 5 --- }
525D: 0136 { 022 5 ---  022 5 ---  023 5 ---  023 5 --- }
525E: ~
525F: ~
5260: 013B { 24D 5 ---  25D 5 ---  24E 5 ---  25E 5 --- }
5261: 013D { 24F 5 ---  25F 5 ---  24F 5 ---  25F 5 --- }
5262: 0133 { 25C 5 ---  26C 5 ---  25D 5 ---  26D 5 --- }
5263: 0134 { 25E 5 ---  26E 5 ---  25F 5 ---  26F 5 --- }
5264: ~
5265: 0130 { 2A0 2 ---  2B0 2 ---  2A1 2 ---  2B1 2 --- }
5266: 0130 { 2A2 2 ---  2B2 2 ---  2A3 2 ---  2B3 2 --- }
5267: 0130 { 2A4 2 ---  2B4 2 ---  2A5 2 ---  2B5 2 --- }
5268: 0130 { 2A6 2 ---  2B6 2 ---  2A7 2 ---  2B7 2 --- }
5269: 0130 { 2A8 6 ---  2B8 6 ---  2A9 6 ---  2B9 6 --- }
526A: 0025 { 2AA 3 ---  2BA 3 ---  2AB 3 ---  2BB 3 --- }
526B: 0130 { 207 3 -y-  207 3 ---  208 2 ---  218 2 --- }
526C: 0137 { 000 5 ---  010 5 ---  001 5 ---  011 5 --- }
526D: 0138 { 002 5 ---  012 5 ---  003 5 ---  013 5 --- }
526E: ~
526F: ~
5270: 013F { 26D 5 ---  27D 5 ---  26E 5 ---  27E 5 --- }
5271: 013E { 26F 5 ---  27F 5 ---  26F 5 ---  27F 5 --- }
5272: 0135 { 27C 5 ---  27C 5 ---  27D 5 ---  27D 5 --- }
5273: 0136 { 27E 5 ---  27E 5 ---  27F 5 ---  27F 5 --- }
5274: ~
5275: 0130 { 2C0 2 ---  2D0 2 ---  2C1 2 ---  2D1 2 --- }
5276: 0130 { 2C2 2 ---  2D2 2 ---  2C3 2 ---  2D3 2 --- }
5277: 0130 { 2C4 2 ---  2D4 2 ---  2C5 2 ---  2D5 2 --- }
5278: 0130 { 2C6 2 ---  2D6 2 ---  2C7 2 ---  2D7 2 --- }
5279: 0130 { 2C8 6 ---  2D8 6 ---  2C9 6 ---  2D9 6 --- }
527A: ~
527B: 0130 { 207 3 -y-  217 3 ---  208 2 ---  218 2 --- }
527C: ~
527D: ~
527E: ~
527F: ~
5280: 0006 { 219 5 -y-  209 5 -y-  209 5 ---  219 5 --- }
5281: 012E { 20A 7 ---  21A 7 ---  20B 7 ---  21B 7 --- }
5282: 0025 { 220 6 ---  230 6 ---  220 6 ---  230 6 --- }
5283: 0025 { 220 6 ---  230 6 ---  221 6 ---  231 6 --- }
5284: 0130 { 222 7 ---  232 7 ---  223 7 ---  233 7 --- }
5285: 0132 { 246 6 ---  248 6 ---  247 6 ---  249 6 --- }
5286: ~
5287: ~
5288: ~
5289: ~
528A: ~
528B: ~
528C: ~
528D: ~
528E: ~
528F: ~
5290: 0130 { 2A0 6 ---  2B0 6 ---  2A1 6 ---  2B1 6 --- }
5291: 0130 { 2A2 6 ---  2B2 6 ---  2A3 6 ---  2B3 6 --- }
5292: 0130 { 2A4 6 ---  2B4 6 ---  2A5 6 ---  2B5 6 --- }
5293: ~
5294: ~
5295: ~
5296: ~
5297: ~
5298: ~
5299: ~
529A: ~
529B: ~
529C: ~
529D: ~
529E: ~
529F: ~
52A0: 0130 { 2C0 6 ---  2D0 6 ---  2C1 6 ---  2D1 6 --- }
52A1: 0130 { 2C2 6 ---  2D2 6 ---  2C3 6 ---  2D3 6 --- }
52A2: 0130 { 2C4 6 ---  2D4 6 ---  2C5 6 ---  2D5 6 --- }
52A3: ~
52A4: ~
52A5: ~
52A6: ~
52A7: ~
52A8: ~
52A9: ~
52AA: ~
52AB: ~
52AC: ~
52AD: ~
52AE: ~
52AF: ~
52B0: 0130 { 204 0 ---  214 0 ---  205 0 ---  215 0 --- }
52B1: 0130 { 206 0 ---  216 0 ---  207 0 ---  217 0 --- }
52B2: ~
52B3: ~
52B4: ~
52B5: ~
52B6: ~
52B7: ~
52B8: ~
52B9: ~
52BA: ~
52BB: ~
52BC: ~
52BD: ~
52BE: ~
52BF: ~
52C0: 0130 { 253 4 ---  0FB 4 ---  254 4 ---  0FB 4 --- }
52C1: 0130 { 0FB 4 ---  0FB 4 ---  255 4 ---  0FB 4 --- }
52C2: 0130 { 256 4 ---  0FB 4 ---  257 4 ---  0FB 4 --- }
52C3: 0130 { 266 4 ---  0FB 4 ---  0FB 4 ---  0FB 4 --- }
52C4: 0130 { 258 4 ---  0FB 4 ---  256 4 ---  0FB 4 --- }
52C5: 0130 { 273 4 ---  0FB 4 ---  265 4 ---  0FB 4 --- }
52C6: 0130 { 264 4 ---  0FB 4 ---  259 4 ---  0FB 4 --- }
52C7: 0130 { 259 4 ---  0FB 4 ---  259 4 ---  0FB 4 --- }
52C8: ~
52C9: ~
52CA: ~
52CB: ~
52CC: ~
52CD: ~
52CE: ~
52CF: ~
52D0: 01E4 { 192 2 -y-  194 2 -y-  193 2 -y-  186 2 xy- }
52D1: 0088 { 0F8 7 x-p  0F8 7 x-p  18E 3 x-p  18E 3 xyp }
52D2: 0088 { 226 3 --p  0F8 7 x-p  226 3 x-p  0F8 3 xyp }
52D3: 0088 { 0F8 7 x-p  226 3 --p  0F8 3 x-p  226 3 xyp }
52D4: 0204 { 0F8 4 ---  0F8 4 ---  0F8 4 ---  0F8 4 --- }
52D5: ~
52D6: ~
52D7: ~
52D8: ~
52D9: ~
52DA: ~
52DB: ~
52DC: ~
52DD: ~
52DE: ~
52DF: ~
52E0: 0078 { 188 3 ---  198 3 ---  189 3 ---  199 3 --- }
52E1: 0079 { 198 3 ---  198 3 ---  199 3 ---  199 3 --- }
52E2: 010A { 1A2 2 ---  19D 3 x--  1A3 2 ---  19C 3 --- }
52E3: 010C { 1A2 2 ---  19C 3 ---  1A3 2 ---  19D 3 --- }
52E4: 0161 { 1B2 2 ---  1BA 2 ---  1D1 2 ---  1F1 2 -y- }
52E5: 010D { 1D1 2 ---  1F1 2 -y-  1D1 2 ---  1F1 2 -y- }
52E6: 0162 { 1D1 2 ---  1F1 2 -y-  1B3 2 ---  1BA 2 --- }
52E7: ~
52E8: ~
52E9: ~
52EA: ~
52EB: ~
52EC: ~
52ED: ~
52EE: ~
52EF: ~
52F0: ~
52F1: ~
52F2: ~
52F3: ~
52F4: 016B { 1BA 2 ---  1B4 2 ---  1F0 2 ---  1D1 2 --- }
52F5: 016C { 1F0 2 ---  1D1 2 ---  1F0 2 ---  1D1 2 --- }
52F6: 016D { 1F0 2 ---  1D1 2 ---  1BA 2 ---  1B5 2 --- }
52F7: ~
52F8: ~
52F9: ~
52FA: ~
52FB: ~
52FC: ~
52FD: ~
52FE: ~
52FF: ~
