6500: 0130 { 1E8 3 ---  1EA 3 ---  1E9 3 ---  1EB 3 --- }
6501: 0130 { 1E8 3 ---  1EA 3 ---  1E9 3 ---  1EB 3 --- }
6502: 0130 { 1E8 2 ---  1EA 2 ---  1E9 2 ---  1EB 2 --- }
6503: 0130 { 1E8 2 ---  1EA 2 ---  1E9 2 ---  1EB 2 --- }
6504: 0004 { 04C 2 --p  04E 2 --p  04D 2 --p  04F 2 --p }
6505: 0025 { 0F8 1 ---  0F8 1 ---  0F8 1 ---  1AA 1 --- }
6506: 0025 { 0F8 1 x--  1AA 1 x--  0F8 1 x--  0F8 1 x-- }
6507: 0025 { 0F8 7 ---  0F8 7 ---  200 7 ---  210 7 --- }
6508: 0025 { 201 7 ---  211 7 ---  202 7 ---  212 7 --- }
6509: 0025 { 203 7 ---  213 7 ---  0F8 7 ---  0F8 7 --- }
650A: 0025 { 0F8 7 x--  0F8 7 x--  203 7 x--  213 7 x-- }
650B: 0025 { 202 7 x--  212 7 x--  201 7 x--  211 7 x-- }
650C: 0025 { 200 7 x--  210 7 x--  0F8 7 x--  0F8 7 x-- }
650D: ~
650E: ~
650F: ~
6510: 0130 { 1EC 3 ---  1EA 3 ---  1ED 3 ---  1EB 3 --- }
6511: 0130 { 1EC 3 ---  1EA 3 ---  1ED 3 ---  1EB 3 --- }
6512: 0130 { 1EC 2 ---  1EA 2 ---  1ED 2 ---  1EB 2 --- }
6513: 0130 { 1EC 2 ---  1EA 2 ---  1ED 2 ---  1EB 2 --- }
6514: 0005 { 0FC 2 --p  0FC 2 --p  0FC 2 --p  0FC 2 --p }
6515: 0025 { 0F8 1 ---  1A8 1 ---  0F8 1 ---  198 1 --- }
6516: 0025 { 0F8 1 ---  198 1 ---  0F8 1 ---  198 1 --- }
6517: 0025 { 0F8 1 ---  198 1 x--  0F8 1 ---  1A8 1 x-- }
6518: 0025 { 1BF 1 x--  2BE 1 xy-  1BE 1 x--  2BE 1 xy- }
6519: 0025 { 1BD 1 x--  2B9 1 x--  2A8 1 x--  2B8 1 x-- }
651A: ~
651B: ~
651C: 002F { 0F8 0 ---  0F8 2 ---  0F8 0 ---  074 4 --- }
651D: 0031 { 0F8 2 ---  0F8 0 ---  077 4 ---  0F8 0 --- }
651E: 0032 { 0F8 0 ---  074 7 --p  0F8 0 ---  0F8 6 --- }
651F: 0034 { 077 7 --p  0F8 0 ---  0F8 6 ---  0F8 0 --- }
6520: 0130 { 1B9 5 ---  1C9 5 ---  1BA 5 ---  180 5 --- }
6521: 0130 { 1BB 5 ---  180 5 ---  1BA 5 ---  181 5 --- }
6522: 0130 { 1BB 5 ---  180 5 ---  1BC 5 ---  1CC 5 --- }
6523: 0130 { 189 5 ---  199 5 ---  18A 5 ---  19A 5 --- }
6524: 0130 { 18B 5 ---  19B 5 ---  18A 5 ---  19A 5 --- }
6525: 0130 { 18B 5 ---  19B 5 ---  18C 5 ---  19C 5 --- }
6526: 0130 { 1B9 5 ---  1C9 5 ---  1BC 5 ---  1CC 5 --- }
6527: 0130 { 1BC 5 x--  1CC 5 x--  1B9 5 x--  1C9 5 x-- }
6528: 0025 { 1DE 1 x--  0F8 1 x--  1DD 1 x--  0F8 1 x-- }
6529: 0025 { 1CF 1 x--  1ED 1 x--  2C8 1 x--  2D8 1 x-- }
652A: 0025 { 0A0 4 ---  0B0 4 ---  0A0 4 x--  0B0 4 x-- }
652B: 0025 { 103 5 ---  103 5 ---  103 5 ---  103 5 --- }
652C: 0025 { 0F8 7 x--  0F8 7 x--  0F8 7 x--  0F8 7 x-- }
652D: 0025 { 0F8 7 x--  0AF 7 x--  0F8 7 x--  0AE 7 x-- }
652E: 0130 { 18B 5 --p  19B 5 --p  18A 5 --p  19A 5 --p }
652F: ~
6530: 0130 { 1D9 5 ---  1C9 5 ---  182 5 ---  180 5 --- }
6531: 0130 { 182 5 ---  180 5 ---  183 5 ---  181 5 --- }
6532: 0130 { 182 5 ---  180 5 ---  1DC 5 ---  1CC 5 --- }
6533: 0130 { 1A9 5 ---  199 5 ---  19B 5 ---  19A 5 --- }
6534: 0130 { 19A 5 ---  19B 5 ---  19B 5 ---  19A 5 --- }
6535: 0130 { 19A 5 ---  19B 5 ---  1AC 5 ---  19C 5 --- }
6536: 0130 { 1D9 5 ---  1C9 5 ---  1DC 5 ---  1CC 5 --- }
6537: 0130 { 1DC 5 x--  1CC 5 x--  1D9 5 x--  1C9 5 x-- }
6538: 0025 { 0F8 1 x--  1FE 1 x--  0F8 1 x--  1FD 1 x-- }
6539: 0025 { 2E9 1 x--  2F9 1 x--  2E8 1 x--  2F8 1 x-- }
653A: 0025 { 0B0 4 ---  0B0 4 ---  0B0 4 x--  0B0 4 x-- }
653B: 0025 { 113 5 ---  102 5 ---  113 5 ---  102 5 --- }
653C: 0025 { 0F8 7 x--  0F8 7 x--  0DE 7 x--  0DF 7 x-- }
653D: 0025 { 0BF 7 x--  0CF 7 x--  0BE 7 x--  0F8 7 x-- }
653E: 0130 { 19A 5 --p  19B 5 --p  19B 5 --p  19A 5 --p }
653F: ~
6540: 0025 { 290 1 -y-  286 1 ---  291 1 -y-  2B7 1 x-- }
6541: 0025 { 292 1 -y-  2B6 1 x--  293 1 -y-  286 1 x-- }
6542: 0025 { 2B0 1 -y-  287 1 ---  2B1 1 -y-  297 1 x-- }
6543: 0025 { 2B2 1 -y-  2B6 1 x--  2B3 1 -y-  2B7 1 x-- }
6544: 0025 { 291 1 xy-  2B7 1 ---  290 1 xy-  286 1 x-- }
6545: 0025 { 2B7 1 xy-  291 1 ---  2B6 1 xy-  292 1 --- }
6546: 0025 { 286 1 xy-  293 1 ---  287 1 -y-  2B0 1 --- }
6547: 0025 { 297 1 xy-  2B1 1 ---  2B6 1 xy-  2B2 1 --- }
6548: 0025 { 2B7 1 xy-  2B3 1 ---  2B7 1 -y-  291 1 x-- }
6549: 0025 { 0F8 7 ---  0F8 7 ---  0F8 7 x--  0EE 4 x-- }
654A: 0025 { 0F8 7 x--  0EF 4 x--  0F8 7 x--  0EE 4 x-- }
654B: 0025 { 112 5 ---  101 5 ---  112 5 ---  101 5 --- }
654C: 0025 { 0F8 1 ---  0F8 1 ---  0F8 1 ---  0F8 1 --- }
654D: 0025 { 0F8 1 ---  0F8 1 ---  0F8 1 ---  0F8 1 --- }
654E: 0025 { 0F8 1 ---  184 4 ---  0F8 1 ---  185 4 --- }
654F: 0025 { 0F8 1 ---  186 4 ---  0F8 1 ---  187 4 --- }
6550: ~
6551: ~
6552: ~
6553: 0025 { 2A2 1 ---  291 1 x--  2A3 1 ---  290 1 x-- }
6554: 0025 { 2BA 1 x--  2B8 1 ---  0F8 1 x--  0F8 1 x-- }
6555: 0025 { 0F8 1 x--  0F8 1 x--  2BA 1 ---  2B5 1 --- }
6556: 0025 { 0F8 1 ---  0F8 1 ---  0E9 1 ---  0E9 1 --- }
6557: 0025 { 0F8 7 ---  0EE 4 ---  0F8 7 ---  0EF 4 --- }
6558: 0025 { 0F8 7 ---  0EE 4 ---  0F8 7 ---  0F8 7 --- }
6559: 0025 { 0F8 7 ---  0AE 7 ---  0F8 7 ---  0AF 7 --- }
655A: 0025 { 0F8 7 ---  0F8 7 ---  0F8 7 ---  0F8 7 --- }
655B: 0025 { 111 5 ---  100 5 ---  111 5 ---  100 5 --- }
655C: 0025 { 190 4 ---  1A0 4 ---  191 4 ---  1A1 4 --- }
655D: 0025 { 192 4 ---  1A2 4 ---  193 4 ---  1A3 4 --- }
655E: 0025 { 194 4 ---  1A4 4 ---  195 4 ---  1A5 4 --- }
655F: 0025 { 196 4 ---  1A6 4 ---  197 4 ---  1A7 4 --- }
6560: 0025 { 120 5 ---  130 5 ---  121 5 ---  131 5 --- }
6561: 0106 { 122 5 ---  132 5 ---  123 5 ---  133 5 --- }
6562: 0106 { 124 5 ---  134 5 ---  125 5 ---  135 5 --- }
6563: 0106 { 126 5 ---  134 5 ---  127 5 ---  135 5 --- }
6564: 0106 { 127 5 ---  134 5 ---  127 5 x--  134 5 x-- }
6565: 0106 { 127 5 x--  135 5 x--  126 5 x--  134 5 x-- }
6566: 0106 { 125 5 x--  135 5 x--  124 5 x--  134 5 x-- }
6567: 0106 { 123 5 x--  133 5 x--  122 5 x--  132 5 x-- }
6568: 0025 { 121 5 x--  131 5 x--  120 5 x--  130 5 x-- }
6569: 0025 { 0BE 7 ---  0F8 7 x--  0BF 7 ---  0CF 7 --- }
656A: 0025 { 0DE 7 ---  0DF 7 ---  0F8 7 ---  0F8 7 --- }
656B: 0025 { 110 5 ---  114 5 ---  110 5 ---  114 5 --- }
656C: 0025 { 1B0 4 ---  1C0 4 ---  1B1 4 ---  1C1 4 --- }
656D: 0025 { 1B2 4 ---  1C2 4 ---  1B3 4 ---  1C3 4 --- }
656E: 0025 { 1B4 4 ---  1C4 4 ---  1B5 4 ---  1C5 4 --- }
656F: 0025 { 1B6 4 ---  1C6 4 ---  1B7 4 ---  1C7 4 --- }
6570: 0025 { 0F8 1 ---  0F8 1 ---  285 1 ---  295 1 --- }
6571: 0025 { 286 1 x--  296 1 ---  2A7 1 x--  2B7 1 --- }
6572: 0025 { 2B8 1 ---  288 1 ---  2E0 1 ---  2C0 1 --- }
6573: 0025 { 2E1 1 ---  2C1 1 ---  2E2 1 ---  2C2 1 --- }
6574: 0025 { 2E3 1 ---  2C3 1 ---  2C4 1 ---  284 1 --- }
6575: 0025 { 1DA 1 ---  294 1 ---  1DB 1 ---  2A4 1 --- }
6576: 0025 { 1DB 1 x--  2A4 1 x--  1DA 1 x--  294 1 x-- }
6577: 0025 { 2C4 1 x--  284 1 x--  2E3 1 x--  2C3 1 x-- }
6578: 0025 { 2E2 1 x--  2C2 1 x--  2E1 1 x--  2C1 1 x-- }
6579: 0025 { 2E0 1 x--  2C0 1 x--  2B8 1 x--  288 1 x-- }
657A: 0025 { 2A7 1 ---  2B7 1 x--  286 1 ---  296 1 x-- }
657B: 0025 { 285 1 x--  295 1 x--  0F8 1 ---  0F8 1 --- }
657C: 0025 { 1D0 4 ---  1E0 4 ---  1D1 4 ---  1E1 4 --- }
657D: 0025 { 1D2 4 ---  1E2 4 ---  1D3 4 ---  1E3 4 --- }
657E: 0025 { 1D4 4 ---  1E4 4 ---  1D5 4 ---  1E5 4 --- }
657F: 0025 { 1D6 4 ---  1E6 4 ---  1D7 4 ---  1E7 4 --- }
6580: 0025 { 0F8 1 ---  0F8 1 ---  285 1 ---  295 1 --- }
6581: 0025 { 286 1 ---  296 1 ---  2A7 1 ---  2B7 1 --- }
6582: 0025 { 2A8 1 ---  2B8 1 ---  2D0 1 ---  2E0 1 --- }
6583: 0025 { 2D1 1 ---  2E1 1 ---  2D2 1 ---  2E2 1 --- }
6584: 0025 { 2D3 1 ---  2E3 1 ---  2B4 1 ---  2C4 1 --- }
6585: 0025 { 1CA 1 ---  1DA 1 ---  2BE 1 ---  1DB 1 --- }
6586: 0025 { 2BE 1 x--  1DB 1 x--  1CA 1 x--  1DA 1 x-- }
6587: 0025 { 2B4 1 x--  2C4 1 x--  2D3 1 x--  2E3 1 x-- }
6588: 0025 { 2D2 1 x--  2E2 1 x--  2D1 1 x--  2E1 1 x-- }
6589: 0025 { 2D0 1 x--  2E0 1 x--  2A8 1 x--  2B8 1 x-- }
658A: 0025 { 2A7 1 x--  2B7 1 x--  286 1 x--  296 1 x-- }
658B: 0025 { 285 1 x--  295 1 x--  0F8 1 ---  0F8 1 --- }
658C: 0025 { 0F8 1 ---  0F8 1 ---  1F1 4 ---  0F8 1 --- }
658D: 0025 { 1F2 4 ---  0F8 1 ---  1F3 4 ---  18D 4 --- }
658E: 0025 { 1F4 4 ---  18E 4 ---  1F5 4 ---  18F 4 --- }
658F: 0025 { 1F6 4 ---  0F8 1 ---  1F7 4 ---  0F8 1 --- }
6590: 0025 { 0F8 1 ---  0F8 1 ---  2A5 1 ---  2B5 1 --- }
6591: 0025 { 2A6 1 ---  2B6 1 ---  287 1 ---  297 1 --- }
6592: 0025 { 288 1 ---  298 1 ---  2C0 1 ---  2D0 1 --- }
6593: 0025 { 2C1 1 ---  2D1 1 ---  2C2 1 ---  2D2 1 --- }
6594: 0025 { 2C3 1 ---  2D3 1 ---  284 1 ---  2B4 1 --- }
6595: 0025 { 294 1 ---  1CA 1 ---  2A4 1 ---  2BE 1 --- }
6596: 0025 { 2A4 1 x--  2BE 1 x--  294 1 x--  1CA 1 x-- }
6597: 0025 { 284 1 x--  2B4 1 x--  2C3 1 x--  2D3 1 x-- }
6598: 0025 { 2C2 1 x--  2D2 1 x--  2C1 1 x--  2D1 1 x-- }
6599: 0025 { 2C0 1 x--  2D0 1 x--  288 1 x--  298 1 x-- }
659A: 0025 { 287 1 x--  297 1 x--  2A6 1 x--  2B6 1 x-- }
659B: 0025 { 2A5 1 x--  2B5 1 x--  0F8 1 ---  0F8 1 --- }
659C: 0025 { 0F8 1 ---  188 4 ---  0F8 1 ---  0F8 1 --- }
659D: 0025 { 0F8 1 ---  0F8 1 ---  19D 4 ---  1AD 4 --- }
659E: 0025 { 19E 4 ---  1AE 4 ---  19F 4 ---  1AF 4 --- }
659F: ~
65A0: 0025 { 0F8 1 ---  0F8 1 ---  285 1 ---  295 1 --- }
65A1: 0025 { 286 1 x--  296 1 ---  2A7 1 x--  2B7 1 --- }
65A2: 0025 { 2A8 1 ---  2B8 1 ---  2E0 1 ---  2F0 1 --- }
65A3: 0025 { 2E1 1 ---  2F1 1 ---  2E2 1 ---  2F2 1 --- }
65A4: 0025 { 2E3 1 ---  2F3 1 ---  2C4 1 ---  2F0 1 --- }
65A5: 0025 { 1DA 1 ---  294 1 ---  1DB 1 ---  2A4 1 --- }
65A6: 0025 { 1DB 1 x--  2A4 1 x--  1DA 1 x--  294 1 x-- }
65A7: 0025 { 2C4 1 x--  2F0 1 x--  2E3 1 x--  2F3 1 x-- }
65A8: 0025 { 2E2 1 x--  2F2 1 x--  2E1 1 x--  2F1 1 x-- }
65A9: 0025 { 2E0 1 x--  2F0 1 x--  2A8 1 x--  2B8 1 x-- }
65AA: 0025 { 2A7 1 ---  2B7 1 x--  286 1 ---  296 1 x-- }
65AB: 0025 { 285 1 x--  295 1 x--  0F8 1 ---  0F8 1 --- }
65AC: 0025 { 0F8 1 ---  0F8 1 ---  0F8 1 ---  0F8 1 --- }
65AD: ~
65AE: ~
65AF: ~
65B0: 0025 { 0F8 1 ---  0F8 1 ---  2A5 1 ---  2B5 1 --- }
65B1: 0025 { 2A6 1 ---  2B6 1 ---  287 1 ---  297 1 --- }
65B2: 0025 { 280 1 ---  290 1 ---  281 1 ---  291 1 --- }
65B3: 0025 { 282 1 ---  292 1 ---  283 1 ---  293 1 --- }
65B4: 0025 { 2A0 1 ---  2B0 1 ---  2A1 1 ---  2B1 1 --- }
65B5: 0025 { 2A2 1 ---  2B2 1 ---  2A3 1 ---  2B3 1 --- }
65B6: 0025 { 2A3 1 x--  2B3 1 x--  2A2 1 x--  2B2 1 x-- }
65B7: 0025 { 2A1 1 x--  2B1 1 x--  2A0 1 x--  2B0 1 x-- }
65B8: 0025 { 283 1 x--  293 1 x--  282 1 x--  292 1 x-- }
65B9: 0025 { 281 1 x--  291 1 x--  280 1 x--  290 1 x-- }
65BA: 0025 { 287 1 x--  297 1 x--  2A6 1 x--  2B6 1 x-- }
65BB: 0025 { 2A5 1 x--  2B5 1 x--  0F8 1 ---  0F8 1 --- }
65BC: 0025 { 1B8 4 ---  1C8 4 ---  0F8 1 ---  0F8 1 --- }
65BD: 0025 { 2A8 1 ---  2B8 1 ---  1BD 1 ---  2B9 1 --- }
65BE: 0025 { 1BE 1 ---  2BE 1 -y-  1BF 1 ---  2BE 1 -y- }
65BF: 0025 { 1CD 1 ---  1CE 1 ---  1CD 1 x--  1CE 1 x-- }
65C0: 0025 { 0F8 1 ---  0F8 1 ---  285 1 ---  295 1 --- }
65C1: 0025 { 286 1 x--  296 1 ---  287 1 ---  297 1 --- }
65C2: 0025 { 288 1 ---  298 1 ---  289 1 ---  299 1 --- }
65C3: 0025 { 28A 1 ---  29A 1 ---  28B 1 ---  29B 1 --- }
65C4: 0025 { 28C 1 ---  29C 1 ---  28D 1 ---  29D 1 --- }
65C5: 0025 { 28E 1 ---  29E 1 ---  28F 1 ---  29F 1 --- }
65C6: 0025 { 28F 1 x--  29F 1 x--  28E 1 x--  29E 1 x-- }
65C7: 0025 { 28D 1 x--  29D 1 x--  28C 1 x--  29C 1 x-- }
65C8: 0025 { 28B 1 x--  29B 1 x--  28A 1 x--  29A 1 x-- }
65C9: 0025 { 289 1 x--  299 1 x--  288 1 x--  298 1 x-- }
65CA: 0025 { 287 1 x--  297 1 x--  286 1 ---  296 1 x-- }
65CB: 0025 { 285 1 x--  295 1 x--  0F8 1 ---  0F8 1 --- }
65CC: 0025 { 1D8 4 ---  0F8 1 ---  0F8 1 ---  0F8 1 --- }
65CD: 0025 { 2C8 1 ---  2D8 1 ---  1CF 1 ---  1ED 1 --- }
65CE: 0025 { 1DD 1 ---  0F8 1 ---  1DE 1 ---  0F8 1 --- }
65CF: 0025 { 1DF 1 ---  1EF 1 -y-  1DF 1 x--  1EF 1 xy- }
65D0: 0025 { 0F8 1 ---  0F8 1 ---  2A5 1 ---  2B5 1 --- }
65D1: 0025 { 2A6 1 ---  2B6 1 ---  2A7 1 ---  2B7 1 --- }
65D2: 0025 { 2A8 1 ---  2B8 1 ---  2A9 1 ---  2B9 1 --- }
65D3: 0025 { 2AA 1 ---  2BE 1 -y-  2AB 1 ---  2BB 1 --- }
65D4: 0020 { 2AC 1 ---  2BC 1 ---  2AD 1 ---  0F8 1 --- }
65D5: 0020 { 2AE 1 ---  0F8 1 ---  2AF 1 ---  2BF 1 --- }
65D6: 0020 { 2AF 1 x--  2BF 1 x--  2AE 1 x--  0F8 1 --- }
65D7: 0020 { 2AD 1 x--  0F8 1 ---  2AC 1 x--  2BC 1 x-- }
65D8: 0025 { 2AB 1 x--  2BB 1 x--  2AA 1 x--  2BE 1 -y- }
65D9: 0025 { 2A9 1 x--  2B9 1 x--  2A8 1 x--  2B8 1 x-- }
65DA: 0025 { 2A7 1 x--  2B7 1 x--  2A6 1 x--  2B6 1 x-- }
65DB: 0025 { 2A5 1 x--  2B5 1 x--  0F8 1 ---  0F8 1 --- }
65DC: 0025 { 2A0 1 ---  2B7 1 x--  2A1 1 ---  296 1 x-- }
65DD: 0025 { 2E8 1 ---  2F8 1 ---  2E9 1 ---  2F9 1 --- }
65DE: 0025 { 0F8 1 ---  1FD 1 ---  0F8 1 ---  1FE 1 --- }
65DF: 0025 { 1EF 1 ---  1FF 1 ---  1EF 1 x--  1FF 1 x-- }
65E0: 0025 { 0F8 1 ---  2D4 1 ---  2C5 1 ---  2D5 1 --- }
65E1: 0025 { 2C6 1 ---  2D6 1 ---  2C7 1 ---  2D7 1 --- }
65E2: 0025 { 2C8 1 ---  2D8 1 ---  2C9 1 ---  2D9 1 --- }
65E3: 0025 { 2CA 1 ---  2DA 1 ---  2CB 1 ---  2DB 1 --- }
65E4: 0020 { 2CC 1 ---  2DC 1 ---  0F8 1 ---  2DD 1 --- }
65E5: 0020 { 0F8 1 ---  2DE 1 ---  2CF 1 ---  2DF 1 --- }
65E6: 0020 { 2CF 1 x--  2DF 1 x--  0F8 1 ---  2DE 1 x-- }
65E7: 0020 { 0F8 1 ---  2DD 1 x--  2CC 1 x--  2DC 1 x-- }
65E8: 0025 { 2CB 1 x--  2DB 1 x--  2CA 1 x--  2DA 1 x-- }
65E9: 0025 { 2C9 1 x--  2D9 1 x--  2C8 1 x--  2D8 1 x-- }
65EA: 0025 { 2C7 1 x--  2D7 1 x--  2C6 1 x--  2D6 1 x-- }
65EB: 0025 { 2C5 1 x--  2D5 1 x--  0F8 1 ---  2D4 1 x-- }
65EC: 0025 { 0F8 1 ---  0F8 1 ---  2BA 1 ---  2B5 1 --- }
65ED: 0025 { 2A2 1 ---  2EA 1 ---  2A3 1 ---  293 1 x-- }
65EE: 0025 { 296 1 ---  291 1 x--  2B7 1 ---  2EA 1 x-- }
65EF: 0025 { 2BA 1 x--  2B5 1 x--  0F8 1 ---  0F8 1 --- }
65F0: 0025 { 2E4 1 ---  2F4 1 ---  2E5 1 ---  2F5 1 --- }
65F1: 0025 { 2E6 1 ---  2F6 1 ---  2E7 1 ---  2F7 1 --- }
65F2: 0025 { 2E8 1 ---  2F8 1 ---  2E9 1 ---  2F9 1 --- }
65F3: 0025 { 0F8 1 ---  2FA 1 ---  2EB 1 ---  2FB 1 --- }
65F4: 0020 { 2EC 1 ---  2FC 1 ---  0F8 1 ---  2FD 1 --- }
65F5: 0020 { 0F8 1 ---  2FE 1 ---  2EF 1 ---  2FF 1 --- }
65F6: 0020 { 2EF 1 x--  2FF 1 x--  0F8 1 ---  2FE 1 x-- }
65F7: 0020 { 0F8 1 ---  2FD 1 x--  2EC 1 x--  2FC 1 x-- }
65F8: 0025 { 2EB 1 x--  2FB 1 x--  0F8 1 ---  2FA 1 x-- }
65F9: 0025 { 2E9 1 x--  2F9 1 x--  2E8 1 x--  2F8 1 x-- }
65FA: 0025 { 2E7 1 x--  2F7 1 x--  2E6 1 x--  2F6 1 x-- }
65FB: 0025 { 2E5 1 x--  2F5 1 x--  2E4 1 x--  2F4 1 x-- }
65FC: 0025 { 2CD 1 ---  2ED 1 ---  2CE 1 ---  2EE 1 --- }
65FD: 0025 { 0F8 1 ---  0F8 1 ---  2CD 1 ---  2ED 1 --- }
65FE: 0025 { 2CE 1 ---  2EE 1 ---  0F8 1 ---  0F8 1 --- }
65FF: 0025 { 28F 1 ---  29F 1 ---  28F 1 x--  29F 1 x-- }
