7800: 0130 { 09B 7 ---  0A5 7 ---  09B 7 ---  0A5 7 --- }
7801: 0130 { 09B 7 ---  0A5 7 ---  09B 7 ---  0A5 7 --- }
7802: 0130 { 09A 7 ---  0A4 7 ---  09A 7 ---  0A4 7 --- }
7803: 0130 { 09A 7 ---  0A4 7 ---  09A 7 ---  0A4 7 --- }
7804: 0130 { 09B 7 ---  0A5 7 ---  09B 7 ---  0A5 7 --- }
7805: 0130 { 09B 7 ---  0A5 7 ---  09B 7 ---  0A5 7 --- }
7806: 0130 { 081 7 ---  081 7 ---  082 7 ---  082 7 --- }
7807: 0130 { 083 7 ---  083 7 ---  081 7 x--  081 7 x-- }
7808: 0130 { 09D 7 ---  0A7 7 ---  09D 7 ---  0A7 7 --- }
7809: 0130 { 09D 7 ---  0A7 7 ---  09D 7 ---  0A7 7 --- }
780A: 0105 { 085 7 ---  089 7 ---  086 7 ---  08A 7 --- }
780B: 0105 { 087 7 ---  08B 7 ---  088 7 ---  08C 7 --- }
780C: 0130 { 0E5 7 ---  0E5 7 ---  0F8 7 ---  0F8 7 --- }
780D: 0130 { 0F8 7 ---  0F8 7 ---  0F8 7 ---  0F8 7 --- }
780E: 0130 { 0F8 7 ---  0F8 7 ---  0F8 7 ---  0F8 7 --- }
780F: 0130 { 0F8 7 ---  0F8 7 ---  0E6 7 ---  0E6 7 --- }
7810: 0130 { 0D3 7 ---  0D3 7 ---  0D3 7 ---  0D3 7 --- }
7811: 0130 { 0D3 7 ---  0D3 7 ---  0D3 7 ---  0D3 7 --- }
7812: 0130 { 0AD 7 ---  0AD 7 ---  0AD 7 ---  0AD 7 --- }
7813: 0130 { 0AD 7 ---  0AD 7 ---  0AD 7 ---  0AD 7 --- }
7814: 0130 { 0D3 7 ---  0D3 7 ---  0D3 7 ---  0D3 7 --- }
7815: 0130 { 0D3 7 ---  0D3 7 ---  0D3 7 ---  0D3 7 --- }
7816: 0130 { 081 7 ---  081 7 ---  082 7 ---  082 7 --- }
7817: 0130 { 083 7 ---  083 7 ---  081 7 x--  081 7 x-- }
7818: 0130 { 080 7 ---  080 7 ---  080 7 ---  080 7 --- }
7819: 0130 { 080 7 ---  080 7 ---  080 7 ---  080 7 --- }
781A: 0105 { 08E 7 ---  092 7 ---  08F 7 ---  093 7 --- }
781B: 0105 { 090 7 ---  094 7 ---  091 7 ---  095 7 --- }
781C: 0130 { 0E5 7 ---  0E7 7 ---  0F8 7 ---  0E8 7 --- }
781D: 0130 { 0F8 7 ---  0E8 7 ---  0F8 7 ---  0E8 7 --- }
781E: 0130 { 0F8 7 ---  0E8 7 ---  0F8 7 ---  0E8 7 --- }
781F: 0130 { 0F8 7 ---  0E8 7 ---  0E6 7 ---  0EA 7 --- }
7820: 0130 { 0B8 7 ---  0C3 7 ---  0B8 7 ---  0C3 7 --- }
7821: 0130 { 0B8 7 ---  0C3 7 ---  0B8 7 ---  0C3 7 --- }
7822: 0130 { 0B7 7 ---  0C2 7 ---  0B7 7 ---  0C2 7 --- }
7823: 0130 { 0B7 7 ---  0C2 7 ---  0B7 7 ---  0C2 7 --- }
7824: 0130 { 0B8 7 ---  0C3 7 ---  0B8 7 ---  0C3 7 --- }
7825: 0130 { 0B8 7 ---  0C3 7 ---  0B8 7 ---  0C3 7 --- }
7826: 0130 { 0B9 7 ---  0C4 7 ---  0BA 7 ---  0C5 7 --- }
7827: 0130 { 0BB 7 ---  0C6 7 ---  0BC 7 ---  0C7 7 --- }
7828: 0130 { 0A7 7 -y-  09D 7 -y-  0A7 7 -y-  09D 7 -y- }
7829: 0130 { 0A7 7 -y-  09D 7 -y-  0A7 7 -y-  09D 7 -y- }
782A: 0105 { 09E 7 ---  092 7 ---  09E 7 ---  093 7 --- }
782B: 0130 { 0E9 6 ---  0E9 6 ---  0F8 6 ---  0F8 6 --- }
782C: 0105 { 0F8 4 ---  0F8 4 ---  0F8 4 ---  0F8 4 --- }
782D: 020C { 0F8 4 ---  0F8 4 ---  0F8 4 ---  0F8 4 --- }
782E: ~
782F: ~
7830: 0130 { 180 2 ---  198 2 ---  180 2 x--  198 2 x-- }
7831: 0130 { 181 2 ---  181 2 -y-  182 2 ---  199 2 --- }
7832: 0130 { 183 2 ---  183 2 -y-  184 2 ---  184 2 -y- }
7833: 0130 { 185 2 ---  185 2 -y-  186 2 ---  186 2 -y- }
7834: 0130 { 187 2 ---  187 2 -y-  188 2 ---  188 2 -y- }
7835: 0130 { 187 2 ---  19A 2 ---  188 2 ---  19B 2 --- }
7836: 0130 { 189 2 ---  19C 2 ---  18A 2 ---  19D 2 --- }
7837: 0130 { 18B 2 ---  19E 2 ---  18B 2 x--  19E 2 x-- }
7838: 0130 { 18C 2 ---  18C 2 -y-  18C 2 x--  18C 2 xy- }
7839: 0130 { 0F8 2 ---  19F 2 ---  18D 2 ---  1A0 2 --- }
783A: 0130 { 18E 2 ---  1A1 2 ---  18F 2 ---  18F 2 -y- }
783B: 0130 { 190 2 ---  1A2 2 ---  0F8 2 ---  1A3 2 --- }
783C: 0130 { 191 2 ---  1A4 2 ---  192 2 ---  194 2 -y- }
783D: 0130 { 084 4 ---  084 4 ---  084 4 ---  084 4 --- }
783E: 0130 { 084 4 ---  084 4 ---  084 4 ---  084 4 --- }
783F: 0130 { 084 4 ---  084 4 ---  084 4 ---  084 4 --- }
7840: 0130 { 193 2 ---  1A5 2 ---  194 2 ---  192 2 -y- }
7841: 0130 { 195 2 ---  195 2 -y-  183 2 x--  183 2 xy- }
7842: 0130 { 196 2 ---  19A 2 ---  197 2 ---  1A6 2 --- }
7843: 0130 { 195 2 ---  195 2 -y-  183 2 x--  1B0 2 --- }
7844: 0130 { 181 2 ---  1B1 2 ---  1A7 2 ---  1B2 2 --- }
7845: 0130 { 1A8 2 ---  1B3 2 ---  1A9 2 ---  1B4 2 --- }
7846: 0130 { 18C 2 ---  1B5 2 ---  18C 2 x--  1B5 2 x-- }
7847: 0130 { 190 2 ---  1B6 2 ---  190 2 x--  1B6 2 x-- }
7848: 0130 { 1AA 2 ---  1B7 2 ---  1AB 2 ---  1B8 2 --- }
7849: 0130 { 1A4 2 -y-  191 2 -y-  194 2 ---  192 2 -y- }
784A: 0130 { 1AC 2 ---  1AC 2 -y-  1AC 2 x--  1AC 2 xy- }
784B: 0130 { 1AD 2 ---  1B9 2 ---  1AD 2 x--  1B9 2 x-- }
784C: 0130 { 1AE 2 ---  1AF 2 xy-  1AF 2 ---  1AE 2 xy- }
784D: 0130 { 0DD 7 ---  0DD 7 ---  0F8 7 ---  0F8 7 --- }
784E: 0130 { 084 4 ---  084 4 ---  084 4 ---  084 4 --- }
784F: 0130 { 084 4 ---  084 4 ---  084 4 ---  084 4 --- }
7850: 0130 { 084 4 ---  084 4 ---  084 4 ---  084 4 --- }
7851: 0130 { 084 4 ---  084 4 ---  084 4 ---  084 4 --- }
7852: 0130 { 084 4 ---  084 4 ---  084 4 ---  084 4 --- }
7853: 0130 { 084 4 ---  084 4 ---  084 4 ---  084 4 --- }
7854: 0130 { 084 4 ---  084 4 ---  084 4 ---  084 4 --- }
7855: 0130 { 084 4 ---  084 4 ---  084 4 ---  084 4 --- }
7856: 0130 { 084 4 ---  084 4 ---  084 4 ---  084 4 --- }
7857: 0130 { 084 4 ---  084 4 ---  084 4 ---  084 4 --- }
7858: 0130 { 084 4 ---  084 4 ---  084 4 ---  084 4 --- }
7859: 0130 { 084 4 ---  084 4 ---  084 4 ---  084 4 --- }
785A: 0130 { 084 4 ---  084 4 ---  084 4 ---  084 4 --- }
785B: 0130 { 084 4 ---  084 4 ---  0DF 7 ---  084 4 --- }
785C: 0130 { 084 4 ---  084 4 ---  084 4 ---  084 4 --- }
785D: 0130 { 0DF 7 ---  0E1 7 ---  0E0 7 ---  0E2 7 --- }
785E: 0130 { 084 4 ---  084 4 ---  084 4 ---  084 4 --- }
785F: 0130 { 084 4 ---  084 4 ---  084 4 ---  084 4 --- }
7860: 0130 { 200 3 ---  213 3 ---  201 1 ---  214 3 --- }
7861: 0130 { 202 1 ---  215 1 ---  202 1 ---  216 1 --- }
7862: 0130 { 202 1 ---  217 1 ---  202 1 ---  218 1 --- }
7863: 0130 { 203 1 ---  219 1 ---  204 1 ---  21A 1 --- }
7864: 0130 { 207 1 ---  21D 3 ---  207 1 ---  21E 3 --- }
7865: 0130 { 207 1 ---  21F 2 ---  207 1 ---  220 3 --- }
7866: 0130 { 208 1 ---  221 3 ---  209 1 ---  222 1 --- }
7867: 0130 { 207 1 ---  225 1 ---  207 1 ---  226 1 --- }
7868: 0130 { 207 1 ---  227 1 ---  207 1 ---  228 1 --- }
7869: 0130 { 20C 1 ---  229 1 ---  20D 1 ---  22A 1 --- }
786A: 0130 { 207 1 ---  22B 0 ---  207 1 ---  22C 0 --- }
786B: 0130 { 207 1 ---  22D 0 ---  207 1 ---  22E 0 --- }
786C: 0130 { 208 1 ---  22F 0 ---  209 1 ---  222 1 --- }
786D: 0130 { 210 1 ---  232 1 ---  202 1 ---  233 1 --- }
786E: 0130 { 202 1 ---  234 1 ---  202 1 ---  235 1 --- }
786F: 0130 { 211 1 ---  236 1 ---  212 1 ---  237 1 --- }
7870: 0130 { 238 1 ---  238 1 ---  239 1 ---  239 1 --- }
7871: 0130 { 23A 1 ---  25A 2 ---  23B 1 ---  25B 2 --- }
7872: 0130 { 23C 1 ---  25C 2 ---  23D 1 ---  25D 3 --- }
7873: 0130 { 23E 1 ---  25E 3 ---  23F 1 ---  25F 1 --- }
7874: 0130 { 242 2 ---  260 1 ---  243 2 ---  261 1 --- }
7875: 0130 { 244 2 ---  262 1 ---  245 2 ---  263 0 --- }
7876: 0130 { 246 0 ---  264 0 ---  247 1 ---  265 1 --- }
7877: 0130 { 248 1 ---  266 1 ---  249 0 ---  267 1 --- }
7878: 0130 { 24A 1 ---  268 3 ---  24B 3 ---  269 3 --- }
7879: 0130 { 24C 1 ---  26A 0 ---  24D 1 ---  26B 1 --- }
787A: 0130 { 24E 0 ---  26C 0 ---  24F 0 ---  26D 0 --- }
787B: 0130 { 250 0 ---  26E 0 ---  251 0 ---  26F 0 --- }
787C: 0130 { 252 2 ---  270 0 ---  253 1 ---  265 1 --- }
787D: 0130 { 254 1 ---  271 1 ---  255 3 ---  272 1 --- }
787E: 0130 { 256 1 ---  273 1 ---  257 3 ---  274 1 --- }
787F: 0130 { 258 1 ---  275 1 ---  259 1 ---  276 1 --- }
7880: 0130 { 277 3 ---  298 3 ---  239 1 ---  299 3 --- }
7881: 0130 { 278 3 ---  29A 3 ---  279 3 ---  29B 3 --- }
7882: 0130 { 27A 2 ---  29C 3 ---  27B 3 ---  29D 3 --- }
7883: 0130 { 27C 3 ---  29E 3 ---  27D 1 ---  29F 1 --- }
7884: 0130 { 27F 0 ---  2A2 0 ---  280 0 ---  2A3 0 --- }
7885: 0130 { 281 1 ---  2A4 1 ---  282 1 ---  2A5 1 --- }
7886: 0130 { 283 1 ---  2A6 1 ---  284 1 ---  2A7 1 --- }
7887: 0130 { 285 1 ---  2A9 1 ---  286 0 ---  2AA 0 --- }
7888: 0130 { 287 0 ---  2AB 1 ---  288 0 ---  2AC 0 --- }
7889: 0130 { 289 0 ---  2AD 1 ---  28A 1 ---  2AE 1 --- }
788A: 0130 { 28B 0 ---  2B0 0 ---  28C 0 ---  2B1 0 --- }
788B: 0130 { 28D 0 ---  2B2 0 ---  28E 0 ---  2B3 0 --- }
788C: 0130 { 28F 0 ---  2B4 0 ---  284 1 ---  2B5 1 --- }
788D: 0130 { 292 1 ---  2B8 1 ---  293 3 ---  2B9 3 --- }
788E: 0130 { 294 1 ---  2BA 1 ---  295 3 ---  2BB 3 --- }
788F: 0130 { 296 1 ---  2BC 1 ---  297 1 ---  2BD 1 --- }
7890: 0130 { 084 4 ---  084 4 ---  084 4 ---  084 4 --- }
7891: 0130 { 202 0 ---  21D 0 ---  203 1 ---  21E 0 --- }
7892: 0130 { 204 3 ---  21F 1 ---  205 3 ---  220 3 --- }
7893: 0130 { 206 3 ---  221 3 ---  178 0 ---  222 1 --- }
7894: 0130 { 209 0 ---  224 0 ---  20A 0 ---  225 0 --- }
7895: 0130 { 20B 3 ---  226 1 ---  20C 3 ---  227 3 --- }
7896: 0130 { 20D 1 ---  228 1 ---  178 0 ---  229 1 --- }
7897: 0130 { 20F 2 ---  22B 2 ---  210 1 ---  22C 2 --- }
7898: 0130 { 211 1 ---  22D 1 ---  212 3 ---  22E 1 --- }
7899: 0130 { 213 3 ---  22F 3 ---  178 0 ---  230 0 --- }
789A: 0130 { 216 3 ---  233 3 ---  217 2 ---  234 2 --- }
789B: 0130 { 218 1 ---  235 2 ---  219 1 ---  236 0 --- }
789C: 0130 { 21A 1 ---  237 1 ---  178 0 ---  238 1 --- }
789D: 0130 { 084 4 ---  084 4 ---  084 4 ---  084 4 --- }
789E: 0130 { 084 4 ---  084 4 ---  084 4 ---  084 4 --- }
789F: 0130 { 084 4 ---  084 4 ---  084 4 ---  084 4 --- }
78A0: 0130 { 084 4 ---  084 4 ---  084 4 ---  084 4 --- }
78A1: 0130 { 23B 2 ---  252 1 ---  23C 2 ---  253 1 --- }
78A2: 0130 { 23D 1 ---  254 1 ---  23E 2 ---  255 1 --- }
78A3: 0130 { 23F 1 ---  256 1 ---  240 1 ---  257 3 --- }
78A4: 0130 { 242 2 ---  252 1 ---  243 2 ---  253 1 --- }
78A5: 0130 { 23D 1 ---  254 1 ---  23E 2 ---  255 1 --- }
78A6: 0130 { 23F 1 ---  256 1 ---  244 1 ---  257 3 --- }
78A7: 0130 { 245 2 ---  252 1 ---  246 2 ---  253 1 --- }
78A8: 0130 { 247 1 ---  254 1 ---  23E 2 ---  255 1 --- }
78A9: 0130 { 23F 1 ---  256 1 ---  240 1 ---  257 3 --- }
78AA: 0130 { 24A 1 ---  252 1 ---  24B 1 ---  25B 1 --- }
78AB: 0130 { 24C 1 ---  25C 1 ---  24D 1 ---  255 1 --- }
78AC: 0130 { 24E 1 ---  25E 1 ---  24F 1 ---  257 3 --- }
78AD: 0130 { 084 4 ---  084 4 ---  084 4 ---  084 4 --- }
78AE: 0130 { 084 4 ---  084 4 ---  084 4 ---  084 4 --- }
78AF: 0130 { 084 4 ---  084 4 ---  084 4 ---  084 4 --- }
78B0: 0130 { 207 0 ---  21B 1 ---  208 0 ---  223 1 --- }
78B1: 0130 { 178 4 ---  178 4 ---  178 4 ---  178 4 --- }
78B2: 0130 { 178 4 ---  178 4 ---  178 4 ---  178 4 --- }
78B3: 0130 { 200 1 ---  21B 1 ---  20E 2 ---  22A 2 --- }
78B4: 0130 { 178 4 ---  178 4 ---  178 4 ---  178 4 --- }
78B5: 0130 { 178 4 ---  178 4 ---  178 4 ---  178 4 --- }
78B6: 0130 { 214 1 ---  231 1 ---  215 1 ---  232 1 --- }
78B7: 0130 { 178 4 ---  178 4 ---  178 4 ---  178 4 --- }
78B8: 0130 { 178 4 ---  178 4 ---  178 4 ---  178 4 --- }
78B9: 0130 { 200 1 ---  21B 1 ---  201 0 ---  21C 2 --- }
78BA: 0130 { 178 4 ---  178 4 ---  178 4 ---  178 4 --- }
78BB: 0130 { 178 4 ---  178 4 ---  178 4 ---  178 4 --- }
78BC: 0130 { 084 4 ---  084 4 ---  084 4 ---  084 4 --- }
78BD: 0130 { 084 4 ---  084 4 ---  084 4 ---  084 4 --- }
78BE: 0130 { 084 4 ---  084 4 ---  084 4 ---  084 4 --- }
78BF: 0130 { 084 4 ---  084 4 ---  084 4 ---  084 4 --- }
78C0: 0130 { 239 1 ---  250 1 ---  241 1 ---  251 1 --- }
78C1: 0130 { 178 4 ---  178 4 ---  178 4 ---  178 4 --- }
78C2: 0130 { 178 4 ---  178 4 ---  178 4 ---  178 4 --- }
78C3: 0130 { 239 1 ---  250 1 ---  23A 1 ---  251 1 --- }
78C4: 0130 { 178 4 ---  178 4 ---  178 4 ---  178 4 --- }
78C5: 0130 { 178 4 ---  178 4 ---  178 4 ---  178 4 --- }
78C6: 0130 { 248 1 ---  258 1 ---  249 1 ---  259 1 --- }
78C7: 0130 { 178 4 ---  178 4 ---  178 4 ---  178 4 --- }
78C8: 0130 { 178 4 ---  178 4 ---  178 4 ---  178 4 --- }
78C9: 0130 { 239 1 ---  250 1 ---  23A 1 ---  251 1 --- }
78CA: 0130 { 178 4 ---  178 4 ---  178 4 ---  178 4 --- }
78CB: 0130 { 178 4 ---  178 4 ---  178 4 ---  178 4 --- }
78CC: 0130 { 084 4 ---  084 4 ---  084 4 ---  084 4 --- }
78CD: 0130 { 084 4 ---  084 4 ---  084 4 ---  084 4 --- }
78CE: 0130 { 084 4 ---  084 4 ---  084 4 ---  084 4 --- }
78CF: 0130 { 084 4 ---  084 4 ---  084 4 ---  084 4 --- }
78D0: 0130 { 200 1 ---  212 1 ---  201 1 ---  213 1 --- }
78D1: 0130 { 202 3 ---  214 3 ---  203 2 ---  215 3 --- }
78D2: 0130 { 204 1 ---  216 1 ---  205 1 ---  217 1 --- }
78D3: 0130 { 206 2 ---  218 3 ---  207 2 ---  219 2 --- }
78D4: 0130 { 20A 3 ---  21A 3 ---  203 2 ---  21B 2 --- }
78D5: 0130 { 204 1 ---  21C 2 ---  205 1 ---  21D 2 --- }
78D6: 0130 { 206 2 ---  21E 2 ---  207 2 ---  21F 2 --- }
78D7: 0130 { 20D 3 ---  220 2 ---  203 2 ---  221 2 --- }
78D8: 0130 { 204 1 ---  222 2 ---  205 1 ---  223 2 --- }
78D9: 0130 { 206 2 ---  224 2 ---  207 2 ---  225 2 --- }
78DA: 0130 { 203 2 ---  228 3 ---  203 2 ---  229 2 --- }
78DB: 0130 { 204 1 ---  22A 3 ---  205 1 ---  22B 2 --- }
78DC: 0130 { 210 2 ---  22C 2 ---  211 2 ---  22D 2 --- }
78DD: 0130 { 084 4 ---  084 4 ---  084 4 ---  084 4 --- }
78DE: 0130 { 084 4 ---  084 4 ---  084 4 ---  084 4 --- }
78DF: 0130 { 084 4 ---  084 4 ---  084 4 ---  084 4 --- }
78E0: 0130 { 212 1 ---  212 1 ---  203 1 ---  203 1 --- }
78E1: 0130 { 22E 3 ---  247 3 ---  22F 3 ---  248 1 --- }
78E2: 0130 { 230 0 ---  249 3 ---  231 1 ---  24A 3 --- }
78E3: 0130 { 232 1 ---  24B 3 ---  233 3 ---  24C 3 --- }
78E4: 0130 { 234 2 ---  24D 2 ---  235 2 ---  24E 2 --- }
78E5: 0130 { 236 2 ---  24F 2 ---  237 2 ---  250 2 --- }
78E6: 0130 { 238 2 ---  251 2 ---  239 2 ---  252 2 --- }
78E7: 0130 { 23A 1 ---  253 1 ---  23B 3 ---  254 3 --- }
78E8: 0130 { 23C 3 ---  255 1 ---  23D 1 ---  256 1 --- }
78E9: 0130 { 23E 2 ---  257 1 ---  23F 2 ---  258 2 --- }
78EA: 0130 { 241 3 ---  25A 3 ---  242 2 ---  25B 3 --- }
78EB: 0130 { 243 2 ---  25C 2 ---  244 2 ---  25D 1 --- }
78EC: 0130 { 245 2 ---  25E 1 ---  246 2 ---  25F 2 --- }
78ED: 0130 { 084 4 ---  084 4 ---  084 4 ---  084 4 --- }
78EE: 0130 { 084 4 ---  084 4 ---  084 4 ---  084 4 --- }
78EF: 0130 { 084 4 ---  084 4 ---  084 4 ---  084 4 --- }
78F0: 0130 { 212 1 ---  279 0 ---  203 1 ---  27A 1 --- }
78F1: 0130 { 260 0 ---  27B 1 ---  261 0 ---  27B 1 --- }
78F2: 0130 { 262 0 ---  27C 1 ---  263 0 ---  27B 1 --- }
78F3: 0130 { 264 1 ---  27B 1 ---  265 3 ---  27D 1 --- }
78F4: 0130 { 266 2 ---  27B 1 ---  267 2 ---  27B 1 --- }
78F5: 0130 { 268 2 ---  27C 1 ---  269 2 ---  27B 1 --- }
78F6: 0130 { 26A 2 ---  27B 1 ---  26B 2 ---  27D 1 --- }
78F7: 0130 { 26C 1 ---  27B 1 ---  26D 1 ---  27B 1 --- }
78F8: 0130 { 26E 1 ---  27C 1 ---  26F 3 ---  27B 1 --- }
78F9: 0130 { 270 1 ---  27B 1 ---  271 3 ---  27D 1 --- }
78FA: 0130 { 273 1 ---  286 1 ---  274 1 ---  286 1 --- }
78FB: 0130 { 275 1 ---  287 1 ---  276 1 ---  286 1 --- }
78FC: 0130 { 277 1 ---  286 1 ---  278 2 ---  288 1 --- }
78FD: 0130 { 084 4 ---  084 4 ---  084 4 ---  084 4 --- }
78FE: 0130 { 084 4 ---  084 4 ---  084 4 ---  084 4 --- }
78FF: 0130 { 084 4 ---  084 4 ---  084 4 ---  084 4 --- }
