1100: 0130 { 180 2 ---  186 2 ---  183 2 ---  186 2 xy- }
1101: 0130 { 183 2 x--  186 2 -y-  180 2 x--  186 2 x-- }
1102: 0130 { 180 2 ---  186 2 ---  183 2 ---  193 2 --- }
1103: 0130 { 183 2 x--  193 2 x--  180 2 x--  186 2 x-- }
1104: 0130 { 180 2 ---  190 2 ---  186 2 ---  186 2 xy- }
1105: 0130 { 186 2 x--  186 2 -y-  180 2 x--  190 2 x-- }
1106: 0130 { 180 2 ---  186 2 ---  180 2 x--  186 2 x-- }
1107: 0130 { 180 2 ---  180 2 -y-  183 2 ---  182 2 -y- }
1108: 0130 { 183 2 ---  182 2 -y-  182 2 ---  183 2 -y- }
1109: 0130 { 183 2 x--  182 2 xy-  180 2 x--  180 2 xy- }
110A: ~
110B: 0130 { 186 2 ---  192 2 -y-  186 2 x--  193 2 -y- }
110C: 012F { 05F 6 xy-  05D 6 xy-  05E 6 xy-  05C 6 xy- }
110D: ~
110E: ~
110F: ~
1110: 0130 { 186 2 -y-  180 2 -y-  186 2 x--  183 2 -y- }
1111: 0130 { 186 2 ---  183 2 xy-  186 2 xy-  180 2 xy- }
1112: 0130 { 186 2 -y-  180 2 -y-  193 2 -y-  183 2 -y- }
1113: 0130 { 193 2 xy-  183 2 xy-  186 2 xy-  180 2 xy- }
1114: 0130 { 190 2 -y-  180 2 -y-  186 2 x--  186 2 -y- }
1115: 0130 { 186 2 ---  186 2 xy-  190 2 xy-  180 2 xy- }
1116: 0130 { 186 2 -y-  180 2 -y-  186 2 xy-  180 2 xy- }
1117: 0130 { 180 2 ---  180 2 -y-  186 2 ---  186 2 -y- }
1118: 0130 { 186 2 x--  186 2 xy-  180 2 x--  180 2 xy- }
1119: 0130 { 180 2 ---  190 2 ---  180 2 x--  190 2 x-- }
111A: ~
111B: ~
111C: ~
111D: 002B { 06C 7 ---  06E 7 ---  06D 7 ---  06F 7 --- }
111E: 0130 { 06C 7 ---  06E 7 ---  06D 7 ---  06F 7 --- }
111F: ~
1120: 0130 { 060 6 ---  182 2 ---  061 6 ---  183 2 --- }
1121: 0130 { 030 4 ---  182 2 ---  031 4 ---  183 2 --- }
1122: 0130 { 180 2 ---  190 2 ---  186 2 ---  193 2 --- }
1123: 0130 { 186 2 x--  193 2 x--  180 2 x--  190 2 x-- }
1124: 0130 { 186 2 ---  186 2 -y-  186 2 x--  186 2 xy- }
1125: 0130 { 182 2 ---  186 2 -y-  183 2 ---  186 2 xy- }
1126: 0130 { 186 2 ---  186 2 -y-  190 2 x--  190 2 x-- }
1127: 0130 { 182 2 ---  192 2 ---  183 2 ---  186 2 xy- }
1128: 0130 { 182 2 ---  186 2 -y-  183 2 ---  193 2 --- }
1129: 0130 { 190 2 ---  190 2 ---  190 2 x--  190 2 xy- }
112A: ~
112B: ~
112C: ~
112D: ~
112E: ~
112F: ~
1130: 0130 { 058 6 ---  182 2 ---  059 6 ---  183 2 --- }
1131: 0130 { 068 6 ---  182 2 ---  069 6 ---  183 2 --- }
1132: 0130 { 190 2 -y-  180 2 -y-  193 2 -y-  186 2 -y- }
1133: 0130 { 193 2 xy-  186 2 xy-  190 2 xy-  180 2 xy- }
1134: 0130 { 186 2 ---  182 2 -y-  186 2 x--  183 2 -y- }
1135: 0130 { 186 2 xy-  186 2 x--  186 2 -y-  186 2 --- }
1136: 0130 { 190 2 ---  190 2 ---  186 2 x--  186 2 xy- }
1137: 0130 { 192 2 -y-  182 2 -y-  186 2 x--  183 2 -y- }
1138: 0130 { 186 2 ---  182 2 -y-  193 2 -y-  183 2 -y- }
1139: 0130 { 190 2 -y-  180 2 -y-  190 2 xy-  180 2 xy- }
113A: 0130 { 191 2 ---  190 2 ---  191 2 x--  190 2 x-- }
113B: 0159 { 1DE 0 -y-  1CE 0 -y-  1DE 0 -y-  1CE 0 -y- }
113C: ~
113D: 0130 { 190 0 ---  190 0 ---  190 0 x--  190 0 x-- }
113E: ~
113F: ~
1140: 01EC { 192 2 -y-  186 2 -y-  193 2 -y-  195 2 -y- }
1141: 01ED { 192 2 -y-  194 2 -y-  193 2 -y-  186 2 xy- }
1142: 01EE { 192 2 -y-  18C 2 -y-  193 2 -y-  1B3 2 -y- }
1143: 0044 { 194 2 ---  192 2 ---  195 2 ---  193 2 --- }
1144: 0044 { 192 2 -y-  194 2 -y-  193 2 -y-  195 2 -y- }
1145: 01EF { 192 2 -y-  1B3 2 xy-  193 2 -y-  18C 2 xy- }
1146: 0130 { 190 2 ---  190 2 ---  193 2 -y-  186 2 xy- }
1147: 0130 { 192 2 -y-  186 2 -y-  190 2 x--  190 2 x-- }
1148: 0130 { 180 2 ---  190 2 ---  183 2 ---  186 2 xy- }
1149: 0130 { 182 2 ---  186 2 -y-  180 2 x--  190 2 x-- }
114A: 0130 { 190 2 ---  190 2 ---  190 2 x--  190 2 xy- }
114B: ~
114C: ~
114D: 0142 { 03A 0 -y-  02A 0 -y-  03B 0 -y-  02B 0 -y- }
114E: ~
114F: ~
1150: 01C4 { 196 2 -y-  0F8 2 ---  197 2 -y-  187 2 -y- }
1151: 01C5 { 197 2 xy-  187 2 xy-  196 2 xy-  0F8 2 --- }
1152: 01C6 { 19B 2 -y-  0F8 2 ---  19C 2 -y-  0F8 2 --- }
1153: 01C7 { 19D 2 -y-  19B 2 -y-  19E 2 -y-  18E 2 -y- }
1154: 01C8 { 19E 2 xy-  18E 2 xy-  19D 2 xy-  19B 2 xy- }
1155: 01C9 { 19C 2 xy-  0F8 2 ---  19B 2 xy-  0F8 2 --- }
1156: 0130 { 190 2 -y-  190 2 ---  186 2 x--  193 2 -y- }
1157: 0130 { 186 2 ---  192 2 -y-  190 2 xy-  190 2 x-- }
1158: 0130 { 190 2 -y-  180 2 -y-  186 2 x--  183 2 -y- }
1159: 0130 { 186 2 ---  182 2 -y-  190 2 xy-  180 2 xy- }
115A: 0130 { 190 2 -y-  191 2 -y-  190 2 xy-  191 2 xy- }
115B: ~
115C: 0130 { 194 2 ---  192 2 ---  186 2 x--  186 2 xy- }
115D: 0130 { 190 2 ---  190 2 ---  186 2 x--  186 2 xy- }
115E: 0130 { 186 2 ---  186 2 -y-  190 2 x--  190 2 xy- }
115F: ~
1160: 0145 { 180 2 ---  190 2 ---  183 2 ---  193 2 --- }
1161: 0146 { 191 2 ---  190 2 ---  183 2 ---  193 2 --- }
1162: 0147 { 1D7 2 ---  190 2 ---  183 2 ---  193 2 --- }
1163: 0148 { 182 2 ---  192 2 ---  180 2 x--  190 2 x-- }
1164: 0149 { 182 2 ---  192 2 ---  191 2 x--  190 2 x-- }
1165: 014A { 182 2 ---  192 2 ---  1D7 2 x--  190 2 x-- }
1166: 014B { 184 2 ---  190 2 ---  195 2 ---  193 2 --- }
1167: 014C { 194 2 ---  192 2 ---  184 2 x--  190 2 x-- }
1168: 014D { 190 2 -y-  180 2 -y-  193 2 -y-  183 2 -y- }
1169: 014E { 192 2 -y-  182 2 -y-  193 2 -y-  183 2 -y- }
116A: 014F { 192 2 -y-  182 2 -y-  190 2 xy-  180 2 xy- }
116B: ~
116C: ~
116D: ~
116E: ~
116F: ~
1170: 0145 { 180 2 ---  180 2 -y-  180 2 x--  180 2 xy- }
1171: 0148 { 182 2 ---  192 2 ---  180 2 x--  190 2 x-- }
1172: 0130 { 191 2 ---  191 2 -y-  191 2 x--  191 2 xy- }
1173: ~
1174: ~
1175: ~
1176: 0153 { 1F4 1 ---  1F6 1 ---  1F5 1 ---  1F7 1 --- }
1177: 0154 { 1F8 1 ---  1F8 1 ---  1F9 1 ---  1F9 1 --- }
1178: 0155 { 1F6 1 -y-  1F4 1 -y-  1F7 1 -y-  1F5 1 -y- }
1179: 012F { 060 6 ---  062 6 ---  061 6 ---  063 6 --- }
117A: 012F { 06C 6 ---  06E 6 ---  06D 6 ---  06F 6 --- }
117B: ~
117C: ~
117D: 0100 { 0C8 5 ---  0D8 5 ---  0C9 5 ---  0D9 5 --- }
117E: 0025 { 1C0 2 ---  1D0 2 ---  1C0 2 x--  1D0 2 x-- }
117F: ~
1180: ~
1181: ~
1182: ~
1183: 0141 { 00A 4 ---  01A 4 ---  00A 4 x--  01A 4 x-- }
1184: 0142 { 02A 4 ---  03A 4 ---  02B 4 ---  03B 4 --- }
1185: 0143 { 083 4 ---  083 4 ---  084 4 ---  084 4 --- }
1186: ~
1187: ~
1188: ~
1189: ~
118A: 0130 { 191 2 ---  190 2 ---  183 2 ---  186 2 xy- }
118B: 0130 { 183 2 ---  186 2 -y-  191 2 x--  190 2 x-- }
118C: ~
118D: ~
118E: ~
118F: ~
1190: ~
1191: 0153 { 1F4 4 ---  1F6 4 ---  1F5 4 ---  1F7 4 --- }
1192: 0154 { 1F8 6 ---  1F8 6 ---  1F9 6 ---  1F9 6 --- }
1193: 0155 { 1F6 6 -y-  1F4 6 -y-  1F7 6 -y-  1F5 6 -y- }
1194: ~
1195: ~
1196: ~
1197: 0005 { 2A4 1 --p  2B4 1 --p  2A5 1 --p  2B5 1 --p }
1198: 0004 { 282 1 --p  2C4 1 --p  283 1 --p  2C5 1 --p }
1199: 0005 { 284 1 --p  2C4 1 --p  285 1 --p  2C5 1 --p }
119A: 0130 { 190 2 -y-  191 2 -y-  186 2 x--  183 2 -y- }
119B: 0130 { 186 2 ---  183 2 -y-  190 2 xy-  191 2 xy- }
119C: ~
119D: ~
119E: ~
119F: ~
11A0: ~
11A1: 0153 { 1F4 7 ---  1F6 7 ---  1F5 7 ---  1F7 7 --- }
11A2: 0154 { 1F8 7 ---  1F8 7 ---  1F9 7 ---  1F9 7 --- }
11A3: 0155 { 1F6 7 -y-  1F4 7 -y-  1F7 7 -y-  1F5 7 -y- }
11A4: ~
11A5: ~
11A6: ~
11A7: 0005 { 284 1 --p  294 1 --p  285 1 --p  295 1 --p }
11A8: 0005 { 0FB 1 --p  0FB 1 --p  0FB 1 --p  0FB 1 --p }
11A9: ~
11AA: ~
11AB: ~
11AC: ~
11AD: ~
11AE: 010E { 1DC 2 -y-  1CC 2 -y-  1DB 2 -y-  1CB 2 -y- }
11AF: ~
11B0: ~
11B1: 0153 { 1F4 6 ---  1F6 6 ---  1F5 6 ---  1F7 6 --- }
11B2: 0154 { 1F8 6 ---  1F8 6 ---  1F9 6 ---  1F9 6 --- }
11B3: 0155 { 1F6 6 -y-  1F4 6 -y-  1F7 6 -y-  1F5 6 -y- }
11B4: 0156 { 1FA 6 ---  1FD 6 ---  1FB 6 ---  1FE 6 --- }
11B5: 0157 { 1FC 6 ---  1FF 6 ---  1FC 6 ---  1FF 6 --- }
11B6: 0158 { 1FB 6 x--  1FE 6 x--  1FA 6 x--  1FD 6 x-- }
11B7: ~
11B8: ~
11B9: ~
11BA: 0130 { 192 2 -y-  186 2 -y-  193 2 -y-  195 2 -y- }
11BB: 0130 { 1D0 2 -y-  18B 2 -y-  193 2 -y-  195 2 -y- }
11BC: 0130 { 192 2 -y-  194 2 -y-  193 2 -y-  186 2 xy- }
11BD: ~
11BE: ~
11BF: ~
11C0: ~
11C1: 0153 { 1F4 6 ---  1F6 6 ---  1F5 6 ---  1F7 6 --- }
11C2: 0154 { 1F8 6 ---  1F8 6 ---  1F9 6 ---  1F9 6 --- }
11C3: 0155 { 1F6 6 -y-  1F4 6 -y-  1F7 6 -y-  1F5 6 -y- }
11C4: ~
11C5: ~
11C6: ~
11C7: ~
11C8: ~
11C9: ~
11CA: ~
11CB: ~
11CC: ~
11CD: ~
11CE: ~
11CF: ~
11D0: ~
11D1: ~
11D2: ~
11D3: ~
11D4: ~
11D5: ~
11D6: ~
11D7: 0025 { 0C0 4 ---  0C2 4 ---  0C1 4 ---  0C3 4 --- }
11D8: 0025 { 0B0 4 ---  0B2 4 ---  0B1 4 ---  0B3 4 --- }
11D9: 0025 { 0F8 4 ---  0F8 4 ---  0F8 4 ---  0F8 4 --- }
11DA: ~
11DB: ~
11DC: 0153 { 1F4 6 ---  1F6 6 ---  1F5 6 ---  1F7 6 --- }
11DD: 0154 { 1F8 6 ---  1F8 6 ---  1F9 6 ---  1F9 6 --- }
11DE: 0155 { 1F6 6 -y-  1F4 6 -y-  1F7 6 -y-  1F5 6 -y- }
11DF: ~
11E0: 0025 { 02D 4 ---  02D 4 -y-  02D 4 x--  02D 4 xy- }
11E1: 0025 { 02D 4 ---  02D 4 -y-  02D 4 x--  02D 4 xy- }
11E2: 0025 { 02D 4 ---  02D 4 -y-  02D 4 x--  02D 4 xy- }
11E3: 0025 { 02D 4 ---  02D 4 -y-  02D 4 x--  02D 4 xy- }
11E4: 0130 { 060 6 ---  062 6 ---  061 6 ---  063 6 --- }
11E5: ~
11E6: ~
11E7: ~
11E8: ~
11E9: ~
11EA: ~
11EB: ~
11EC: 0025 { 1C1 2 ---  1D1 2 ---  1C2 2 ---  1D2 2 --- }
11ED: 0025 { 1F2 2 ---  1E2 2 ---  1C3 2 ---  1D3 2 --- }
11EE: 00B8 { 1DD 2 -y-  1CD 2 -y-  1DF 2 xy-  1CF 2 xy- }
11EF: 00B8 { 1DF 2 -y-  1CF 2 -y-  1CD 2 ---  1DD 2 --- }
11F0: ~
11F1: ~
11F2: ~
11F3: ~
11F4: ~
11F5: ~
11F6: ~
11F7: ~
11F8: ~
11F9: ~
11FA: ~
11FB: ~
11FC: 0025 { 1E1 2 ---  1F1 2 ---  1E2 2 ---  1F2 2 --- }
11FD: 0025 { 1C2 2 ---  1D2 2 ---  1E3 2 ---  1F3 2 --- }
11FE: 00B8 { 1CD 2 ---  1DD 2 ---  1CF 2 x--  1DF 2 x-- }
11FF: 00B8 { 1CF 2 ---  1DF 2 ---  1DD 2 -y-  1CD 2 -y- }
