5100: 0025 { 200 5 ---  210 5 ---  201 5 ---  211 5 --- }
5101: 0025 { 202 5 ---  212 5 ---  203 5 ---  213 5 --- }
5102: 0025 { 204 5 ---  214 5 ---  205 5 ---  215 5 --- }
5103: 0025 { 206 5 ---  216 5 ---  207 5 ---  217 5 --- }
5104: ~
5105: ~
5106: ~
5107: ~
5108: ~
5109: ~
510A: 0025 { 1FF 5 ---  1FE 5 ---  10B 5 ---  1FF 5 --- }
510B: 0025 { 10D 5 ---  1FF 5 ---  10F 5 ---  117 5 xy- }
510C: ~
510D: ~
510E: ~
510F: ~
5110: 0025 { 220 5 ---  230 5 ---  221 5 ---  231 5 --- }
5111: 0025 { 222 5 ---  232 5 ---  223 5 ---  233 5 --- }
5112: 0025 { 224 5 ---  234 5 ---  225 5 ---  235 5 --- }
5113: 0025 { 226 5 ---  236 5 ---  227 5 ---  237 5 --- }
5114: 0025 { 106 5 ---  1F4 5 ---  107 5 ---  1F5 5 --- }
5115: 0025 { 108 5 ---  1F6 5 ---  109 5 ---  1F7 5 --- }
5116: 0025 { 10A 5 ---  1F8 5 ---  10B 5 ---  1F9 5 --- }
5117: 0025 { 10C 5 ---  1FA 5 ---  10D 5 ---  1FB 5 --- }
5118: 0025 { 10E 5 ---  1FC 5 ---  104 5 ---  1FD 5 --- }
5119: 0025 { 105 5 ---  1FE 5 ---  106 5 ---  1FF 5 --- }
511A: 0025 { 107 5 ---  1FF 5 ---  10F 5 ---  117 5 xy- }
511B: 0025 { 1FF 5 ---  1FF 5 ---  116 5 xy-  1FF 5 --- }
511C: ~
511D: ~
511E: ~
511F: ~
5120: 0025 { 240 5 ---  250 5 ---  241 5 ---  251 5 --- }
5121: 0025 { 242 5 ---  252 5 ---  243 5 ---  253 5 --- }
5122: 0025 { 266 5 ---  276 5 ---  267 5 ---  277 5 --- }
5123: 0025 { 122 5 ---  132 5 ---  123 5 ---  133 5 --- }
5124: 0025 { 124 5 ---  134 5 ---  125 5 ---  135 5 --- }
5125: 0025 { 126 5 ---  136 5 ---  127 5 ---  137 5 --- }
5126: 0025 { 128 5 ---  138 5 ---  129 5 ---  139 5 --- }
5127: 0025 { 12A 5 ---  13A 5 ---  12B 5 ---  13B 5 --- }
5128: 0025 { 12C 5 ---  13C 5 ---  12D 5 ---  13D 5 --- }
5129: 0025 { 12E 5 ---  13E 5 ---  12F 5 ---  13F 5 --- }
512A: 0025 { 1FF 5 ---  1FF 5 ---  116 5 xy-  115 5 xy- }
512B: ~
512C: ~
512D: ~
512E: ~
512F: ~
5130: ~
5131: 0025 { 114 5 ---  115 5 ---  1FF 5 ---  1FF 5 --- }
5132: 0025 { 140 5 ---  150 5 ---  141 5 ---  151 5 --- }
5133: 0025 { 142 5 ---  152 5 ---  143 5 ---  153 5 --- }
5134: 0025 { 144 5 ---  154 5 ---  145 5 ---  155 5 --- }
5135: 0025 { 146 5 ---  156 5 ---  147 5 ---  157 5 --- }
5136: 0025 { 148 5 ---  158 5 ---  149 5 ---  159 5 --- }
5137: 0025 { 14A 5 ---  15A 5 ---  14B 5 ---  15B 5 --- }
5138: 0025 { 14C 5 ---  15C 5 ---  14D 5 ---  15D 5 --- }
5139: 0025 { 14E 5 ---  15E 5 ---  14F 5 ---  15F 5 --- }
513A: 0025 { 1FF 5 ---  1FF 5 ---  114 5 xy-  113 5 xy- }
513B: ~
513C: ~
513D: ~
513E: ~
513F: ~
5140: ~
5141: 0025 { 116 5 ---  117 5 ---  1FF 5 ---  1FF 5 --- }
5142: 0025 { 160 5 ---  170 5 ---  161 5 ---  171 5 --- }
5143: 0025 { 162 5 ---  172 5 ---  163 5 ---  173 5 --- }
5144: 0025 { 164 5 ---  174 5 ---  165 5 ---  175 5 --- }
5145: 0025 { 082 3 ---  092 3 ---  083 3 ---  093 3 --- }
5146: 0025 { 084 3 ---  094 3 ---  085 3 ---  095 3 --- }
5147: 0025 { 16A 5 ---  17A 5 ---  16B 5 ---  17B 5 --- }
5148: 0025 { 16C 5 ---  17C 5 ---  16D 5 ---  17D 5 --- }
5149: 0025 { 16E 5 ---  17E 5 ---  16F 5 ---  17F 5 --- }
514A: 0025 { 1FF 5 ---  1FF 5 ---  112 5 xy-  111 5 xy- }
514B: ~
514C: ~
514D: ~
514E: ~
514F: ~
5150: ~
5151: 0025 { 118 5 ---  111 5 ---  1FF 5 ---  1FF 5 --- }
5152: 0025 { 180 5 ---  190 5 ---  181 5 ---  191 5 --- }
5153: 0025 { 182 5 ---  192 5 ---  183 5 ---  193 5 --- }
5154: 0025 { 184 5 ---  194 5 ---  185 5 ---  195 5 --- }
5155: 0025 { 0A2 3 ---  0B2 3 ---  0A3 3 ---  0B3 3 --- }
5156: 0025 { 093 3 xy-  083 3 xy-  092 3 xy-  082 3 xy- }
5157: 0025 { 18A 5 ---  19A 5 ---  18B 5 ---  19B 5 --- }
5158: 0025 { 18C 5 ---  19C 5 ---  18D 5 ---  19D 5 --- }
5159: 0025 { 18E 5 ---  19E 5 ---  18F 5 ---  19F 5 --- }
515A: 0025 { 1FF 5 ---  1FF 5 ---  118 5 xy-  117 5 xy- }
515B: ~
515C: ~
515D: ~
515E: ~
515F: ~
5160: ~
5161: 0025 { 112 5 ---  113 5 ---  1FF 5 ---  1FF 5 --- }
5162: 0025 { 1A0 5 ---  1B0 5 ---  1A1 5 ---  1B1 5 --- }
5163: 0025 { 1A2 5 ---  1B2 5 ---  1A3 5 ---  1B3 5 --- }
5164: 0025 { 1A4 5 ---  1B4 5 ---  1A5 5 ---  1B5 5 --- }
5165: 0025 { 157 5 ---  1B6 5 ---  157 5 ---  1B7 5 --- }
5166: 0025 { 157 5 ---  1B8 5 ---  157 5 ---  1B9 5 --- }
5167: 0025 { 1AA 5 ---  1BA 5 ---  1AB 5 ---  1BB 5 --- }
5168: 0025 { 1AC 5 ---  1BC 5 ---  1AD 5 ---  1BD 5 --- }
5169: 0025 { 1AE 5 ---  1BE 5 ---  1AF 5 ---  1BF 5 --- }
516A: 0025 { 1FF 5 ---  1FF 5 ---  116 5 xy-  115 5 xy- }
516B: ~
516C: ~
516D: ~
516E: ~
516F: ~
5170: ~
5171: 0025 { 114 5 ---  115 5 ---  1FF 5 ---  1FF 5 --- }
5172: 0025 { 1C0 5 ---  1D0 5 ---  1C1 5 ---  1D1 5 --- }
5173: 0025 { 1C2 5 ---  1D2 5 ---  1C3 5 ---  1D3 5 --- }
5174: 0025 { 1C4 5 ---  1D4 5 ---  1C5 5 ---  1D5 5 --- }
5175: 0025 { 1C6 5 ---  1D6 5 ---  1C7 5 ---  1D7 5 --- }
5176: 0025 { 1C8 5 ---  1D8 5 ---  1C9 5 ---  1D9 5 --- }
5177: 0025 { 1CA 5 ---  1DA 5 ---  1CB 5 ---  1DB 5 --- }
5178: 0025 { 1CC 5 ---  1DC 5 ---  1CD 5 ---  1DD 5 --- }
5179: 0025 { 20A 5 ---  21A 5 ---  20B 5 ---  21B 5 --- }
517A: 0025 { 20C 5 ---  21C 5 ---  20D 5 ---  21D 5 --- }
517B: 0025 { 20E 5 ---  21E 5 ---  20F 5 ---  21F 5 --- }
517C: ~
517D: ~
517E: ~
517F: ~
5180: 0025 { 1FF 5 ---  1FF 5 ---  1FF 5 ---  1FF 5 --- }
5181: 0025 { 116 5 ---  117 5 ---  1FF 5 ---  1FF 5 --- }
5182: 0025 { 1E0 5 ---  1F0 5 ---  1E1 5 ---  1F1 5 --- }
5183: 0025 { 1E2 5 ---  1F2 5 ---  1E3 5 ---  1F3 5 --- }
5184: 0025 { 1E4 5 ---  1F4 5 ---  1E5 5 ---  1F5 5 --- }
5185: 0025 { 1E6 5 ---  1F6 5 ---  1E7 5 ---  1F7 5 --- }
5186: 0025 { 1E8 5 ---  1F8 5 ---  1E9 5 ---  1F9 5 --- }
5187: 0025 { 1EA 5 ---  1FA 5 ---  1EB 5 ---  1FB 5 --- }
5188: 0025 { 228 5 ---  238 5 ---  229 5 ---  239 5 --- }
5189: 0025 { 22A 5 ---  23A 5 ---  22B 5 ---  23B 5 --- }
518A: 0025 { 22C 5 ---  23C 5 ---  22D 5 ---  23D 5 --- }
518B: 0025 { 22E 5 ---  23E 5 ---  22F 5 ---  23F 5 --- }
518C: ~
518D: ~
518E: ~
518F: ~
5190: 0025 { 114 5 ---  117 5 ---  1FF 5 ---  1FF 5 --- }
5191: 0025 { 10F 5 xy-  11A 5 ---  107 5 xy-  11A 5 --- }
5192: 0025 { 106 5 xy-  11A 5 ---  105 5 xy-  11A 5 --- }
5193: 0025 { 104 5 xy-  11A 5 ---  10E 5 xy-  11A 5 --- }
5194: 0025 { 10D 5 xy-  11A 5 ---  10C 5 xy-  11A 5 --- }
5195: 0025 { 10B 5 xy-  11A 5 ---  10A 5 xy-  11A 5 --- }
5196: 0025 { 109 5 xy-  11A 5 ---  108 5 xy-  11A 5 --- }
5197: 0025 { 107 5 xy-  11A 5 ---  106 5 xy-  11A 5 --- }
5198: 0025 { 106 5 xy-  11A 5 ---  249 5 ---  259 5 --- }
5199: 0025 { 24A 5 ---  25A 5 ---  24B 5 ---  25B 5 --- }
519A: 0025 { 24C 5 ---  25C 5 ---  24D 5 ---  25D 5 --- }
519B: 0025 { 24E 5 ---  1FF 5 ---  24F 5 ---  1FF 5 --- }
519C: ~
519D: ~
519E: ~
519F: ~
51A0: 0025 { 10F 5 xy-  11A 5 ---  107 5 xy-  11A 5 --- }
51A1: 0025 { 106 5 xy-  11A 5 ---  1FF 5 ---  11A 5 --- }
51A2: ~
51A3: ~
51A4: ~
51A5: ~
51A6: ~
51A7: ~
51A8: ~
51A9: ~
51AA: ~
51AB: ~
51AC: ~
51AD: ~
51AE: ~
51AF: ~
51B0: ~
51B1: ~
51B2: ~
51B3: ~
51B4: ~
51B5: ~
51B6: ~
51B7: ~
51B8: ~
51B9: ~
51BA: ~
51BB: ~
51BC: ~
51BD: ~
51BE: ~
51BF: ~
51C0: ~
51C1: ~
51C2: ~
51C3: ~
51C4: ~
51C5: ~
51C6: ~
51C7: ~
51C8: ~
51C9: ~
51CA: ~
51CB: ~
51CC: ~
51CD: ~
51CE: ~
51CF: ~
51D0: ~
51D1: ~
51D2: ~
51D3: ~
51D4: ~
51D5: ~
51D6: ~
51D7: ~
51D8: ~
51D9: ~
51DA: ~
51DB: ~
51DC: ~
51DD: ~
51DE: ~
51DF: ~
51E0: ~
51E1: ~
51E2: ~
51E3: ~
51E4: ~
51E5: ~
51E6: ~
51E7: ~
51E8: ~
51E9: ~
51EA: ~
51EB: ~
51EC: ~
51ED: ~
51EE: ~
51EF: ~
51F0: ~
51F1: ~
51F2: ~
51F3: ~
51F4: ~
51F5: ~
51F6: ~
51F7: ~
51F8: ~
51F9: ~
51FA: ~
51FB: ~
51FC: ~
51FD: ~
51FE: ~
51FF: ~
