3000: 0145 { 186 2 x--  198 2 x--  180 2 x--  185 2 x-- }
3001: 0100 { 180 2 ---  190 2 ---  181 2 ---  191 2 --- }
3002: 0148 { 180 2 ---  185 2 ---  186 2 ---  198 2 --- }
3003: 0196 { 0F8 4 x--  184 2 x--  0F8 4 x--  183 2 x-- }
3004: 019B { 184 2 x--  194 2 x--  183 2 x--  193 2 x-- }
3005: 01A0 { 183 2 ---  193 2 ---  184 2 ---  194 2 --- }
3006: 01A5 { 0F8 4 x--  183 2 ---  0F8 4 x--  184 2 --- }
3007: 01AA { 0F8 4 ---  182 2 x--  182 2 x--  192 2 x-- }
3008: 01AF { 182 2 ---  192 2 ---  0F8 4 x--  182 2 --- }
3009: 0130 { 18C 2 ---  19C 2 -y-  18D 2 ---  19D 2 -y- }
300A: 0100 { 19E 2 -yp  18E 2 --p  19F 2 -yp  18F 2 --p }
300B: 0025 { 19E 3 -y-  18E 3 ---  19F 3 -y-  18F 3 --- }
300C: 0025 { 1A5 3 ---  1B5 3 ---  1A6 3 ---  1B6 3 --- }
300D: 0025 { 1A7 3 ---  1A8 3 ---  1A8 3 ---  1A7 3 --- }
300E: 0025 { 1A9 3 ---  1B9 3 ---  1AA 3 ---  1BA 3 --- }
300F: 0025 { 217 2 -yp  237 2 --p  234 2 --p  227 2 --p }
3010: 014B { 188 2 x--  198 2 x--  187 2 x--  197 2 x-- }
3011: 0025 { 1A0 2 ---  1B0 2 ---  1A1 2 ---  1B1 2 --- }
3012: 014C { 187 2 ---  197 2 ---  188 2 ---  198 2 --- }
3013: 01DE { 194 2 x--  1A4 2 x--  193 2 x--  1A3 2 x-- }
3014: 0025 { 1A4 2 x--  1A0 2 ---  1A3 2 x--  1A1 2 --- }
3015: 0025 { 1A3 2 ---  1A0 2 ---  1A4 2 ---  1A1 2 --- }
3016: 01E0 { 193 2 ---  1A3 2 ---  194 2 ---  1A4 2 --- }
3017: 01E2 { 192 2 x--  1A2 2 x--  1A2 2 x--  1A1 2 --- }
3018: 01E4 { 1A2 2 ---  1A0 2 ---  192 2 ---  1A2 2 --- }
3019: 0130 { 19C 2 ---  19C 2 -y-  19D 2 ---  19D 2 -y- }
301A: 0025 { 18E 2 --p  18E 2 --p  18F 2 --p  18F 2 --p }
301B: 0025 { 18E 3 ---  18E 3 ---  18F 3 ---  18F 3 --- }
301C: 0002 { 1CC 2 ---  1DC 2 ---  1CD 2 ---  1DD 2 --- }
301D: 0002 { 1CE 2 ---  1DE 2 ---  1CF 2 ---  1DF 2 --- }
301E: 0025 { 217 2 -yp  237 2 --p  234 2 --p  216 2 xyp }
301F: 0025 { 217 2 -yp  216 2 -yp  234 2 --p  227 2 --p }
3020: 014D { 198 2 xy-  186 2 xy-  185 2 xy-  180 2 xy- }
3021: 014E { 190 2 -y-  180 2 -y-  191 2 -y-  181 2 -y- }
3022: 014F { 185 2 -y-  180 2 -y-  198 2 -y-  186 2 -y- }
3023: 0130 { 189 2 ---  199 2 ---  18A 2 ---  19A 2 --- }
3024: 0130 { 18A 2 x--  19A 2 x--  18A 2 ---  19A 2 --- }
3025: 0130 { 18A 2 x--  19A 2 x--  18B 2 ---  19B 2 --- }
3026: 0130 { 189 2 ---  199 2 ---  18B 2 ---  19B 2 --- }
3027: 0130 { 18C 2 ---  1B2 2 ---  18D 2 ---  1B3 2 --- }
3028: 0145 { 186 2 x--  186 2 xy-  186 2 ---  186 2 -y- }
3029: 0130 { 19C 2 ---  1B2 2 ---  19D 2 ---  1B3 2 --- }
302A: 0025 { 18E 2 --p  19E 2 --p  18F 2 --p  19F 2 --p }
302B: 0025 { 18E 3 ---  19E 3 ---  18F 3 ---  19F 3 --- }
302C: 0002 { 1EC 2 ---  1FC 2 ---  1ED 2 ---  1FD 2 --- }
302D: 0002 { 1EE 2 ---  1FE 2 ---  1EF 2 ---  1FF 2 --- }
302E: 0025 { 217 2 -yp  237 2 --p  216 2 x-p  227 2 --p }
302F: 0025 { 216 2 --p  237 2 --p  234 2 --p  227 2 --p }
3030: 0130 { 196 2 x--  191 2 x--  187 2 x--  195 2 x-- }
3031: 0130 { 187 2 ---  195 2 ---  196 2 ---  191 2 --- }
3032: 0130 { 1AB 2 ---  1BB 2 ---  1AE 2 ---  1BE 2 --- }
3033: 0130 { 1AD 2 ---  1BD 2 ---  1AE 2 ---  1BE 2 --- }
3034: 0130 { 1AD 2 ---  1BD 2 ---  1AC 2 ---  1BC 2 --- }
3035: 01AA { 0F8 4 x--  1AF 2 ---  1AF 2 ---  1BF 2 --- }
3036: 01AF { 1AF 2 x--  1BF 2 x--  0F8 4 x--  1AF 2 x-- }
3037: 0025 { 1CA 2 ---  1DA 2 ---  1CB 2 ---  1DB 2 --- }
3038: 0025 { 1AB 3 ---  1BB 3 ---  1AE 3 ---  1BE 3 --- }
3039: 0025 { 1AD 3 ---  1BD 3 ---  1AE 3 ---  1BE 3 --- }
303A: 0025 { 1AD 3 ---  1BD 3 ---  1AC 3 ---  1BC 3 --- }
303B: 012F { 1E9 2 x--  1F9 2 x--  1E8 2 x--  1F8 2 x-- }
303C: 012F { 1E8 2 ---  1F8 2 ---  1E9 2 ---  1F9 2 --- }
303D: 0025 { 0F8 4 x-p  260 2 --p  230 2 --p  240 2 --p }
303E: 0025 { 231 2 --p  241 2 --p  232 2 --p  242 2 --p }
303F: 0025 { 233 2 --p  243 2 --p  0F8 4 x-p  261 2 --p }
3040: 0130 { 191 2 xy-  196 2 xy-  195 2 xy-  187 2 xy- }
3041: 0130 { 195 2 -y-  187 2 -y-  191 2 -y-  196 2 -y- }
3042: 0130 { 1A5 2 ---  1B5 2 ---  1A6 2 ---  1B6 2 --- }
3043: 0130 { 1A7 2 ---  1A8 2 ---  1A8 2 ---  1A7 2 --- }
3044: 0130 { 1A9 2 ---  1B9 2 ---  1AA 2 ---  1BA 2 --- }
3045: 01E2 { 1BF 2 ---  0F8 4 x--  0F8 4 x--  0F8 4 --- }
3046: 01E4 { 0F8 4 ---  0F8 4 x--  1BF 2 x--  0F8 4 --- }
3047: 0100 { 1B7 2 ---  0F8 4 ---  1B8 2 ---  0F8 4 x-- }
3048: 0100 { 1B4 2 ---  0F8 4 ---  1B4 2 ---  0F8 4 x-- }
3049: 0100 { 1B7 2 ---  19E 3 -y-  1B8 2 ---  19F 3 -y- }
304A: 0100 { 1B4 2 ---  19E 3 -y-  1B4 2 ---  19F 3 -y- }
304B: 012F { 1EA 2 ---  1FA 2 ---  1EB 2 ---  1FB 2 --- }
304C: 012F { 1FA 2 -y-  1EA 2 -y-  1FB 2 -y-  1EB 2 -y- }
304D: 0100 { 180 2 --p  190 2 --p  181 2 --p  191 2 --p }
304E: 0025 { 215 2 xyp  205 2 xyp  214 2 xyp  217 2 -yp }
304F: 0025 { 214 2 -yp  234 2 --p  215 2 -yp  205 2 -yp }
3050: 0130 { 1D3 2 --p  1D3 2 -yp  1D3 2 x-p  1D3 2 xyp }
3051: 0025 { 0F8 4 x-p  1D0 2 --p  0F8 4 --p  1D1 2 --p }
3052: 0025 { 0F8 4 x-p  1D1 2 x-p  0F8 4 --p  1D0 2 x-p }
3053: 0100 { 1D3 2 --p  1D3 2 -yp  1D3 2 x-p  1D3 2 xyp }
3054: 0025 { 0F8 4 x-p  1C0 2 --p  0F8 4 --p  1C1 2 --p }
3055: 0025 { 0F8 4 x-p  1C1 2 x-p  0F8 4 --p  1C0 2 x-p }
3056: 0025 { 0F8 4 x-p  0F8 4 x-p  0F8 4 x-p  1C0 2 --p }
3057: 0025 { 0F8 4 --p  1C1 2 --p  0F8 4 x-p  1C1 2 x-p }
3058: 0025 { 0F8 4 --p  1C0 2 x-p  0F8 4 x-p  0F8 4 x-p }
3059: 0025 { 0F8 4 --p  1D1 2 --p  1D2 2 --p  1C3 2 --p }
305A: 0025 { 1D2 2 x-p  1C3 2 x-p  0F8 4 x-p  1D1 2 x-p }
305B: 0025 { 217 2 --p  224 2 --p  200 2 --p  210 2 --p }
305C: 0025 { 201 2 --p  211 2 --p  202 2 --p  212 2 --p }
305D: 0025 { 203 2 --p  213 2 --p  217 2 --p  224 2 --p }
305E: 0025 { 205 2 x-p  215 2 x-p  237 2 --p  214 2 x-p }
305F: 0025 { 227 2 --p  214 2 --p  205 2 --p  215 2 --p }
3060: 0196 { 1D0 2 --p  1C3 2 --p  1D1 2 --p  1D3 2 --p }
3061: 019B { 1C3 2 --p  1D3 2 --p  1D3 2 --p  1D3 2 --p }
3062: 01A0 { 1D3 2 x-p  1D3 2 x-p  1C3 2 x-p  1D3 2 x-p }
3063: 01A5 { 1D1 2 x-p  1D3 2 x-p  1D0 2 x-p  1C3 2 x-p }
3064: 01AA { 1D2 2 --p  1C3 2 --p  1D3 2 --p  1D3 2 --p }
3065: 01AF { 1D3 2 x-p  1D3 2 x-p  1D2 2 x-p  1C3 2 x-p }
3066: 0025 { 0F8 4 x-p  0F8 4 x-p  1D2 2 --p  1D2 2 -yp }
3067: 0025 { 1D3 2 --p  1D3 2 -yp  1D3 2 x-p  1D3 2 xyp }
3068: 0025 { 1D2 2 x-p  1D2 2 xyp  0F8 4 x-p  0F8 4 x-p }
3069: 0025 { 1D1 2 -yp  0F8 4 -yp  1C3 2 -yp  1D2 2 -yp }
306A: 0025 { 1C3 2 xyp  1D2 2 xyp  1D1 2 xyp  0F8 4 xyp }
306B: 0025 { 0F8 4 x-p  0F8 4 x-p  230 2 --p  220 2 --p }
306C: 0025 { 231 2 --p  221 2 --p  232 2 --p  222 2 --p }
306D: 0025 { 233 2 --p  223 2 --p  0F8 4 x-p  0F8 4 x-p }
306E: 0025 { 206 2 -yp  0F8 4 xyp  207 2 -yp  0F8 4 xyp }
306F: 0025 { 216 2 -yp  206 2 -yp  217 2 -yp  207 2 -yp }
3070: 01DE { 1D3 2 --p  1D3 2 -yp  1D3 2 x-p  1D3 2 xyp }
3071: 0025 { 0F8 4 --p  1C5 2 x-p  0F8 4 x-p  1C4 2 x-p }
3072: 0025 { 0F8 4 --p  1C4 2 --p  0F8 4 x-p  1C5 2 --p }
3073: 01E0 { 1D3 2 --p  1D3 2 -yp  1D3 2 x-p  1D3 2 xyp }
3074: 01E2 { 1D3 2 --p  1D3 2 -yp  1D3 2 x-p  1D3 2 xyp }
3075: 01E4 { 1D3 2 --p  1D3 2 -yp  1D3 2 x-p  1D3 2 xyp }
3076: 0025 { 0F8 4 x-p  0F8 4 x-p  1C0 2 -yp  0F8 4 x-p }
3077: 0025 { 1C1 2 -yp  0F8 4 --p  1C1 2 xyp  0F8 4 x-p }
3078: 0025 { 1C0 2 xyp  0F8 4 --p  0F8 4 x-p  0F8 4 x-p }
3079: 0025 { 0F8 4 --p  1C4 2 --p  0F8 4 x-p  1C4 2 x-p }
307A: 0025 { 1C3 2 xyp  1C3 2 x-p  1C3 2 -yp  1C3 2 --p }
307B: 0025 { 260 2 --p  270 2 --p  240 2 --p  250 2 --p }
307C: 0025 { 241 2 --p  251 2 --p  242 2 --p  252 2 --p }
307D: 0025 { 243 2 --p  253 2 --p  261 2 --p  271 2 --p }
307E: 0025 { 217 2 xyp  207 2 xyp  216 2 xyp  206 2 xyp }
307F: 0025 { 207 2 xyp  0F8 4 xyp  206 2 xyp  0F8 4 xyp }
3080: 01EE { 1D3 2 --p  1D3 2 -yp  1D3 2 x-p  1D3 2 xyp }
3081: 01C7 { 1D3 2 -yp  1C3 2 -yp  1D3 2 -yp  1D3 2 -yp }
3082: 01C8 { 1D3 2 xyp  1D3 2 xyp  1D3 2 xyp  1C3 2 xyp }
3083: 01EF { 1D3 2 --p  1D3 2 -yp  1D3 2 x-p  1D3 2 xyp }
3084: 01C4 { 1C3 2 -yp  1D2 2 -yp  1D3 2 -yp  1D3 2 -yp }
3085: 01C5 { 1D3 2 xyp  1D3 2 xyp  1C3 2 xyp  1D2 2 xyp }
3086: 0025 { 1C5 2 xyp  0F8 4 -yp  1C4 2 xyp  0F8 4 xyp }
3087: 0025 { 1C4 2 -yp  0F8 4 -yp  1C5 2 -yp  0F8 4 xyp }
3088: 01EC { 1D3 2 --p  1D3 2 -yp  1D3 2 x-p  1D3 2 xyp }
3089: 01ED { 1D3 2 --p  1D3 2 -yp  1D3 2 x-p  1D3 2 xyp }
308A: 0006 { 1C8 2 ---  1D8 2 ---  1C9 2 ---  1D9 2 --- }
308B: 0025 { 0F8 4 x-p  0F8 4 x-p  262 2 --p  272 2 --p }
308C: 0025 { 263 2 --p  273 2 --p  264 2 --p  274 2 --p }
308D: 0025 { 265 2 --p  275 2 --p  0F8 4 x-p  0F8 4 x-p }
308E: 0025 { 207 2 x-p  217 2 x-p  206 2 x-p  216 2 x-p }
308F: 0025 { 0F8 4 x-p  207 2 x-p  0F8 4 x-p  206 2 x-p }
3090: 01C6 { 1C3 2 -yp  1D0 2 -yp  1D3 2 -yp  1D1 2 -yp }
3091: 0025 { 1D0 2 -yp  0F8 4 xyp  1D1 2 -yp  0F8 4 -yp }
3092: 0025 { 1D1 2 xyp  0F8 4 xyp  1D0 2 xyp  0F8 4 -yp }
3093: 01C9 { 1D3 2 xyp  1D1 2 xyp  1C3 2 xyp  1D0 2 xyp }
3094: 0025 { 1C0 2 -yp  0F8 4 xyp  1C1 2 -yp  0F8 4 -yp }
3095: 0025 { 1C1 2 xyp  0F8 4 xyp  1C0 2 xyp  0F8 4 -yp }
3096: 014B { 188 2 x-p  1F7 2 x-p  187 2 x-p  1F6 2 x-p }
3097: 014B { 188 2 x-p  1F5 2 x-p  187 2 x-p  1F4 2 x-p }
3098: 014B { 188 2 x-p  1D7 2 x-p  187 2 x-p  1D6 2 x-p }
3099: 014B { 188 2 x-p  1D5 2 x-p  187 2 x-p  1D4 2 x-p }
309A: 014C { 187 2 --p  1D4 2 --p  188 2 --p  1D5 2 --p }
309B: 014C { 187 2 --p  1D6 2 --p  188 2 --p  1D7 2 --p }
309C: 014C { 187 2 --p  1F4 2 --p  188 2 --p  1F5 2 --p }
309D: 014C { 187 2 --p  1F6 2 --p  188 2 --p  1F7 2 --p }
309E: 0025 { 0F8 4 x-p  206 2 --p  0F8 4 x-p  207 2 --p }
309F: 0025 { 206 2 --p  216 2 --p  207 2 --p  217 2 --p }
30A0: 0025 { 1F0 2 --p  1C3 2 --p  1F1 2 --p  1D3 2 --p }
30A1: 0025 { 1A0 2 ---  1F0 2 --p  1A1 2 ---  1F1 2 --p }
30A2: 0025 { 1A0 2 ---  1F1 2 x-p  1A1 2 ---  1F0 2 x-p }
30A3: 0025 { 1F1 2 x-p  1D3 2 x-p  1F0 2 x-p  1C3 2 x-p }
30A4: 0025 { 1A0 2 ---  1E0 2 --p  1A1 2 ---  1E1 2 --p }
30A5: 0025 { 1A0 2 ---  1E1 2 x-p  1A1 2 ---  1E0 2 x-p }
30A6: 014B { 1C7 2 x-p  1C3 2 --p  1D3 2 --p  1D3 2 --p }
30A7: 014B { 1D3 2 x-p  1D3 2 x-p  1C6 2 x-p  1C3 2 x-p }
30A8: 014B { 1D7 2 x-p  1C3 2 --p  1D6 2 x-p  1D3 2 --p }
30A9: 014B { 1D5 2 x-p  1D3 2 x-p  1D4 2 x-p  1C3 2 x-p }
30AA: 014C { 1D4 2 --p  1C3 2 --p  1D5 2 --p  1D3 2 --p }
30AB: 014C { 1D6 2 --p  1D3 2 x-p  1D7 2 --p  1C3 2 x-p }
30AC: 014C { 1C6 2 --p  1C3 2 --p  1D3 2 --p  1D3 2 --p }
30AD: 014C { 1D3 2 x-p  1D3 2 x-p  1C7 2 --p  1C3 2 x-p }
30AE: 0130 { 238 3 -y-  228 3 -y-  239 3 -y-  229 3 -y- }
30AF: 0130 { 23A 3 -y-  22A 3 -y-  23B 3 -y-  22B 3 -y- }
30B0: 0025 { 1C3 2 -yp  1F0 2 -yp  1D3 2 -yp  1F1 2 -yp }
30B1: 0025 { 1A0 2 --p  1F3 2 x-p  1A1 2 --p  1E3 2 x-p }
30B2: 0025 { 1A0 2 --p  1E3 2 --p  1A1 2 --p  1F3 2 --p }
30B3: 0025 { 1D3 2 xyp  1F1 2 xyp  1C3 2 xyp  1F0 2 xyp }
30B4: 0025 { 1F2 2 --p  1C3 2 --p  1D3 2 --p  1D3 2 --p }
30B5: 0025 { 1D3 2 x-p  1D3 2 x-p  1F2 2 x-p  1C3 2 x-p }
30B6: 014B { 1C3 2 -yp  1C7 2 xyp  1D3 2 -yp  1D3 2 -yp }
30B7: 014B { 1D3 2 xyp  1D3 2 xyp  1C3 2 xyp  1C6 2 xyp }
30B8: 014B { 1C3 2 -yp  1D7 2 xyp  1D3 2 -yp  1D6 2 xyp }
30B9: 014B { 1D3 2 xyp  1D5 2 xyp  1C3 2 xyp  1D4 2 xyp }
30BA: 014C { 1C3 2 -yp  1D4 2 -yp  1D3 2 -yp  1D5 2 -yp }
30BB: 014C { 1D3 2 xyp  1D6 2 -yp  1C3 2 xyp  1D7 2 -yp }
30BC: 014C { 1C3 2 -yp  1C6 2 -yp  1D3 2 -yp  1D3 2 -yp }
30BD: 014C { 1D3 2 xyp  1D3 2 xyp  1C3 2 xyp  1C7 2 -yp }
30BE: 0130 { 208 3 ---  218 3 ---  209 3 ---  219 3 --- }
30BF: 0130 { 20A 3 ---  21A 3 ---  20B 3 ---  21B 3 --- }
30C0: 0025 { 1A0 2 ---  1F1 2 --p  1F2 2 --p  1C3 2 --p }
30C1: 0025 { 1F3 2 xyp  1B0 2 ---  1E3 2 xyp  1B1 2 --- }
30C2: 0025 { 1E3 2 -yp  1B0 2 ---  1F3 2 -yp  1B1 2 --- }
30C3: 0025 { 1F2 2 x-p  1C3 2 x-p  1A0 2 x--  1F1 2 x-p }
30C4: 0025 { 1D3 2 --p  1D3 2 -yp  1D3 2 x-p  1D3 2 xyp }
30C5: 0025 { 1D3 2 --p  1D3 2 -yp  1D3 2 x-p  1D3 2 xyp }
30C6: 014B { 1F7 2 xyp  188 2 x-p  1F6 2 xyp  187 2 x-p }
30C7: 014B { 1F5 2 xyp  188 2 x-p  1F4 2 xyp  187 2 x-p }
30C8: 014B { 1D7 2 xyp  188 2 xyp  1D6 2 xyp  187 2 xyp }
30C9: 014B { 1D5 2 xyp  188 2 xyp  1D4 2 xyp  187 2 xyp }
30CA: 014C { 1D4 2 -yp  187 2 -yp  1D5 2 -yp  188 2 -yp }
30CB: 014C { 1D6 2 -yp  187 2 -yp  1D7 2 -yp  188 2 -yp }
30CC: 014C { 1F4 2 -yp  187 2 --p  1F5 2 -yp  188 2 --p }
30CD: 014C { 1F6 2 -yp  187 2 --p  1F7 2 -yp  188 2 --p }
30CE: 0130 { 228 3 ---  238 3 ---  229 3 ---  239 3 --- }
30CF: 0130 { 22A 3 ---  23A 3 ---  22B 3 ---  23B 3 --- }
30D0: 0025 { 1F1 2 -yp  1A0 2 -y-  1C3 2 -yp  1F2 2 -yp }
30D1: 0025 { 1F0 2 -yp  1B0 2 ---  1F1 2 -yp  1B1 2 --- }
30D2: 0025 { 1F1 2 xyp  1B0 2 ---  1F0 2 xyp  1B1 2 --- }
30D3: 0025 { 1C3 2 xyp  1F2 2 xyp  1F1 2 xyp  1A0 2 xy- }
30D4: 0025 { 1C3 2 -yp  1F2 2 -yp  1D3 2 -yp  1D3 2 -yp }
30D5: 0025 { 1D3 2 xyp  1D3 2 xyp  1C3 2 xyp  1F2 2 xyp }
30D6: 0025 { 1A0 2 ---  1E1 2 --p  1A1 2 ---  1E1 2 x-p }
30D7: 014B { 188 2 x-p  1E7 2 x--  187 2 x-p  1E6 2 x-- }
30D8: 014B { 188 2 x-p  1E5 2 x--  187 2 x-p  1E4 2 x-- }
30D9: 014C { 187 2 --p  1E4 2 ---  188 2 --p  1E5 2 --- }
30DA: 014C { 187 2 --p  1E6 2 ---  188 2 --p  1E7 2 --- }
30DB: 0025 { 0F8 3 x--  0F8 3 x--  262 3 ---  272 3 --- }
30DC: 0025 { 263 3 ---  273 3 ---  264 3 ---  274 3 --- }
30DD: 0025 { 265 3 ---  275 3 ---  0F8 3 x--  0F8 3 x-- }
30DE: 0130 { 238 2 -yp  228 2 -yp  239 2 -yp  229 2 -yp }
30DF: 0130 { 23A 2 -yp  22A 2 -yp  23B 2 -yp  22B 2 -yp }
30E0: 0025 { 1C3 2 --p  1D3 2 --p  1D3 2 --p  1D3 2 --p }
30E1: 0025 { 1D3 2 x-p  1D3 2 x-p  1C3 2 x-p  1D3 2 x-p }
30E2: 0025 { 1A0 2 ---  1B0 2 ---  1A1 2 ---  1E0 2 --p }
30E3: 0025 { 1A0 2 ---  1E0 2 x-p  1A1 2 ---  1B1 2 --- }
30E4: 0025 { 1E0 2 -yp  1B0 2 ---  1E1 2 -yp  1B1 2 --- }
30E5: 0025 { 1E1 2 xyp  1B0 2 ---  1E0 2 xyp  1B1 2 --- }
30E6: 0025 { 1E1 2 -yp  1B0 2 ---  1E1 2 xyp  1B1 2 --- }
30E7: 014B { 1E7 2 xy-  188 2 x-p  1E6 2 xy-  187 2 x-p }
30E8: 014B { 1E5 2 xy-  188 2 x-p  1E4 2 xy-  187 2 x-p }
30E9: 014C { 1E4 2 -y-  187 2 --p  1E5 2 -y-  188 2 --p }
30EA: 014C { 1E6 2 -y-  187 2 --p  1E7 2 -y-  188 2 --p }
30EB: 0025 { 0F8 3 x--  0F8 3 x--  230 3 ---  220 3 --- }
30EC: 0025 { 231 3 ---  221 3 ---  232 3 ---  222 3 --- }
30ED: 0025 { 233 3 ---  223 3 ---  0F8 3 x--  0F8 3 x-- }
30EE: 0130 { 208 2 --p  218 2 --p  209 2 --p  219 2 --p }
30EF: 0130 { 20A 2 --p  21A 2 --p  20B 2 --p  21B 2 --p }
30F0: 0025 { 1D3 2 -yp  1C3 2 -yp  1D3 2 -yp  1D3 2 -yp }
30F1: 0025 { 1D3 2 xyp  1D3 2 xyp  1D3 2 xyp  1C3 2 xyp }
30F2: 0025 { 1A0 2 ---  1B0 2 ---  1E0 2 -yp  1B1 2 --- }
30F3: 0025 { 1E0 2 xyp  1B0 2 ---  1A1 2 ---  1B1 2 --- }
30F4: 0025 { 1A0 2 ---  1B0 2 ---  1F2 2 --p  1F2 2 -yp }
30F5: 0025 { 1F2 2 x-p  1F2 2 xyp  1A1 2 ---  1B1 2 --- }
30F6: 0025 { 215 3 xy-  205 3 xy-  214 3 xy-  217 3 -y- }
30F7: 0025 { 214 3 -y-  234 3 ---  215 3 -y-  205 3 -y- }
30F8: 0025 { 0F8 3 x--  260 3 ---  230 3 ---  240 3 --- }
30F9: 0025 { 231 3 ---  241 3 ---  232 3 ---  242 3 --- }
30FA: 0025 { 233 3 ---  243 3 ---  0F8 3 x--  261 3 --- }
30FB: 0025 { 260 3 ---  270 3 ---  240 3 ---  250 3 --- }
30FC: 0025 { 241 3 ---  251 3 ---  242 3 ---  252 3 --- }
30FD: 0025 { 243 3 ---  253 3 ---  261 3 ---  271 3 --- }
30FE: 0130 { 228 2 --p  238 2 --p  229 2 --p  239 2 --p }
30FF: 0130 { 22A 2 --p  23A 2 --p  22B 2 --p  23B 2 --p }
