6D00: 0025 { 2ED 6 ---  2FD 6 ---  2EE 6 ---  2FE 6 --- }
6D01: 0025 { 2EF 6 ---  2FF 6 ---  29C 6 ---  2AC 6 --- }
6D02: 0025 { 2D4 5 ---  2D4 5 ---  2D4 5 ---  280 5 --- }
6D03: 0025 { 2D4 5 ---  281 5 ---  2D4 5 ---  282 5 --- }
6D04: 0025 { 2D4 5 ---  283 5 ---  2D4 5 ---  2D4 5 --- }
6D05: 0025 { 0F8 1 ---  127 1 ---  0F8 1 ---  128 1 --- }
6D06: 0025 { 0F8 1 ---  138 1 ---  0F8 1 ---  167 1 --- }
6D07: ~
6D08: 0025 { 0F8 1 ---  0F8 1 ---  0F8 1 ---  290 1 --- }
6D09: 0025 { 0F8 1 ---  291 1 ---  0F8 1 ---  292 1 --- }
6D0A: 0025 { 0F8 1 ---  293 1 ---  0F8 1 ---  294 1 --- }
6D0B: 0025 { 0F8 1 ---  295 1 ---  0F8 1 ---  296 1 --- }
6D0C: 0025 { 0F8 1 ---  297 1 ---  0F8 1 ---  0F8 1 --- }
6D0D: ~
6D0E: ~
6D0F: ~
6D10: 0025 { 0F8 1 ---  110 1 ---  0F8 1 ---  111 1 --- }
6D11: 0025 { 0F8 1 ---  112 1 ---  103 1 ---  113 1 --- }
6D12: 0025 { 104 1 ---  114 1 ---  0F8 1 ---  115 1 --- }
6D13: ~
6D14: 0025 { 0F8 1 ---  0F8 1 ---  109 1 ---  119 1 --- }
6D15: 0025 { 10A 1 ---  11A 1 ---  10B 1 ---  11B 1 --- }
6D16: 0025 { 10C 1 ---  11C 1 ---  10D 1 ---  11D 1 --- }
6D17: 0025 { 10E 1 ---  11E 1 ---  10F 1 ---  11F 1 --- }
6D18: 0025 { 0F8 1 ---  0F8 1 ---  2A0 1 ---  2B0 1 --- }
6D19: 0025 { 2A1 1 ---  2B1 1 ---  2A2 1 ---  2B2 1 --- }
6D1A: 0025 { 2A3 1 ---  2B3 1 ---  2A4 1 ---  2B4 1 --- }
6D1B: 0025 { 2A5 1 ---  2B5 1 ---  2A6 1 ---  2B6 1 --- }
6D1C: 0025 { 2A7 1 ---  2B7 1 ---  0F8 1 ---  0F8 1 --- }
6D1D: ~
6D1E: ~
6D1F: ~
6D20: 0025 { 120 1 ---  130 1 ---  121 1 ---  131 1 --- }
6D21: 0025 { 122 1 ---  132 1 ---  123 1 ---  133 1 --- }
6D22: 0025 { 124 1 ---  134 1 ---  125 1 ---  135 1 --- }
6D23: 0025 { 126 1 ---  136 1 ---  126 1 ---  137 1 --- }
6D24: 0025 { 126 1 ---  137 1 ---  129 1 ---  139 1 --- }
6D25: 0025 { 12A 1 ---  13A 1 ---  12B 1 ---  13B 1 --- }
6D26: 0025 { 12C 1 ---  13C 1 ---  12D 1 ---  13D 1 --- }
6D27: 0025 { 12E 1 ---  13E 1 ---  12F 1 ---  13F 1 --- }
6D28: 0025 { 0F8 1 ---  0F8 1 ---  2C0 1 ---  0F8 1 --- }
6D29: 0025 { 2C1 1 ---  0F8 1 ---  2C2 1 ---  0F8 1 --- }
6D2A: 0025 { 2C3 1 ---  0F8 1 ---  2C4 1 ---  0F8 1 --- }
6D2B: 0025 { 2C5 1 ---  0F8 1 ---  2C6 1 ---  0F8 1 --- }
6D2C: ~
6D2D: ~
6D2E: ~
6D2F: ~
6D30: 0025 { 140 1 ---  150 1 ---  141 1 ---  151 1 --- }
6D31: 0025 { 142 1 ---  152 1 ---  143 1 ---  153 1 --- }
6D32: 0025 { 144 1 ---  154 1 ---  145 1 ---  155 1 --- }
6D33: 0025 { 146 1 ---  156 1 ---  147 1 ---  157 1 --- }
6D34: 0025 { 137 1 ---  137 1 ---  137 1 ---  137 1 --- }
6D35: 0025 { 137 1 ---  137 1 ---  137 1 ---  137 1 --- }
6D36: 0025 { 14C 1 ---  15C 1 ---  14D 1 ---  15D 1 --- }
6D37: 0025 { 14E 1 ---  15E 1 ---  14F 1 ---  15F 1 --- }
6D38: 0025 { 1E0 4 ---  1F0 4 ---  1E1 4 ---  1F1 4 --- }
6D39: 0025 { 1E2 4 ---  1F2 4 ---  1E3 4 ---  1F3 4 --- }
6D3A: 0025 { 1E4 4 ---  1F4 4 ---  1E5 4 ---  1F5 4 --- }
6D3B: 0025 { 1E6 4 ---  1F6 4 ---  1E7 4 ---  1F7 4 --- }
6D3C: 0025 { 1E8 4 ---  1F8 4 ---  1E9 4 ---  1F9 4 --- }
6D3D: 0025 { 1EA 4 ---  1FA 4 ---  1EB 4 ---  1FB 4 --- }
6D3E: 0025 { 1EC 4 ---  1FC 4 ---  1ED 4 ---  1FD 4 --- }
6D3F: 0025 { 1EE 4 ---  1FE 4 ---  1EF 4 ---  1FF 4 --- }
6D40: 0025 { 160 1 ---  170 1 ---  161 1 ---  171 1 --- }
6D41: 0025 { 162 1 ---  172 1 ---  163 1 ---  173 1 --- }
6D42: 0025 { 164 1 ---  174 1 ---  165 1 ---  175 1 --- }
6D43: 0025 { 166 1 ---  176 1 ---  126 1 -y-  171 1 --- }
6D44: 0025 { 126 1 -y-  178 1 x--  126 1 -y-  177 1 --- }
6D45: 0025 { 126 1 -y-  178 1 ---  126 1 -y-  178 1 x-- }
6D46: 0025 { 126 1 -y-  177 1 ---  126 1 -y-  178 1 --- }
6D47: 0025 { 161 1 x--  108 1 ---  160 1 x--  116 1 --- }
6D48: 0025 { 004 4 ---  004 4 ---  004 4 ---  004 4 --- }
6D49: 0025 { 2D4 5 ---  2D1 5 ---  2D4 5 ---  2D2 5 --- }
6D4A: 0025 { 2D4 5 ---  2D3 5 ---  2D4 5 ---  2D4 5 --- }
6D4B: 0025 { 004 4 ---  004 4 ---  004 4 ---  004 4 --- }
6D4C: 0025 { 004 4 ---  004 4 ---  004 4 ---  004 4 --- }
6D4D: 0025 { 004 4 ---  004 4 ---  004 4 ---  004 4 --- }
6D4E: 0025 { 2D4 5 ---  2D4 5 ---  2D4 5 ---  2D8 5 --- }
6D4F: 0025 { 2D4 5 ---  2D9 5 ---  2D4 5 ---  2D4 5 --- }
6D50: 0025 { 100 1 ---  101 1 ---  100 1 x--  101 1 x-- }
6D51: ~
6D52: ~
6D53: 0025 { 105 1 ---  106 1 ---  105 1 x--  106 1 x-- }
6D54: 0025 { 148 1 ---  158 1 ---  149 1 ---  159 1 --- }
6D55: 0025 { 14A 1 ---  15A 1 ---  14B 1 ---  15B 1 --- }
6D56: 0025 { 16E 1 ---  17E 1 ---  16F 1 ---  17F 1 --- }
6D57: 0025 { 289 1 ---  117 1 ---  289 1 x--  117 1 x-- }
6D58: 0025 { 0F8 1 ---  0F8 1 ---  2E0 5 ---  2F0 5 --- }
6D59: 0025 { 2E1 5 ---  2F1 5 ---  2E2 5 ---  2F2 5 --- }
6D5A: 0025 { 2E3 5 ---  2F3 5 ---  2E4 5 ---  2F4 5 --- }
6D5B: 0025 { 0F8 1 ---  205 5 ---  0F8 1 ---  20C 5 --- }
6D5C: 0025 { 20F 5 ---  257 5 ---  256 5 ---  258 5 --- }
6D5D: 0025 { 2E5 5 ---  2F5 5 ---  2E6 5 ---  2F6 5 --- }
6D5E: 0025 { 2E7 5 ---  2F7 5 ---  2E8 5 ---  2F8 5 --- }
6D5F: 0025 { 2E9 5 ---  2F9 5 ---  2D4 5 ---  2D4 5 --- }
6D60: 0025 { 101 1 ---  101 1 ---  101 1 x--  101 1 x-- }
6D61: 0106 { 0AB 2 ---  0BB 0 ---  0AB 2 x--  0BB 0 x-- }
6D62: ~
6D63: 0025 { 106 1 ---  106 1 ---  106 1 x--  106 1 x-- }
6D64: 0025 { 168 1 ---  288 1 ---  169 1 ---  179 1 --- }
6D65: 0025 { 16A 1 ---  17A 1 ---  16B 1 ---  17B 1 --- }
6D66: 0025 { 16C 1 ---  17C 1 ---  16D 1 ---  17D 1 --- }
6D67: 0025 { 117 1 ---  117 1 ---  117 1 x--  117 1 x-- }
6D68: 0025 { 200 5 ---  210 5 ---  201 5 ---  211 5 --- }
6D69: 0025 { 202 5 ---  212 5 ---  203 5 ---  213 5 --- }
6D6A: 0025 { 204 5 ---  214 5 ---  201 5 x--  215 5 --- }
6D6B: 0025 { 206 5 ---  216 5 ---  207 5 ---  217 5 --- }
6D6C: 0025 { 208 5 ---  218 5 ---  209 5 ---  219 5 --- }
6D6D: 0025 { 20A 5 ---  21A 5 ---  20B 5 ---  21B 5 --- }
6D6E: 0025 { 201 5 x--  21C 5 ---  20D 5 ---  21D 5 --- }
6D6F: 0025 { 20E 5 ---  21E 5 ---  200 5 x--  21F 5 --- }
6D70: 0025 { 101 1 ---  102 1 ---  101 1 x--  102 1 x-- }
6D71: 0106 { 0AA 2 ---  0BA 0 ---  0AB 2 ---  0BB 0 --- }
6D72: 0106 { 0AB 2 x--  0BB 0 x--  0AA 2 x--  0BA 0 x-- }
6D73: 0025 { 106 1 ---  107 1 ---  106 1 x--  107 1 x-- }
6D74: 0025 { 178 1 x--  178 1 ---  177 1 ---  178 1 x-- }
6D75: 0025 { 178 1 ---  177 1 ---  178 1 x--  177 1 x-- }
6D76: 0025 { 177 1 ---  178 1 ---  178 1 ---  178 1 x-- }
6D77: 0025 { 117 1 ---  118 1 ---  117 1 x--  118 1 x-- }
6D78: 0025 { 220 5 ---  230 5 ---  221 5 ---  231 5 --- }
6D79: 0025 { 222 5 ---  232 5 ---  223 5 ---  233 5 --- }
6D7A: 0025 { 224 5 ---  234 5 ---  225 5 ---  235 5 --- }
6D7B: 0025 { 226 5 ---  236 5 ---  227 5 ---  237 5 --- }
6D7C: 0025 { 228 5 ---  238 5 ---  229 5 ---  239 5 --- }
6D7D: 0025 { 22A 5 ---  23A 5 ---  22B 5 ---  23B 5 --- }
6D7E: 0025 { 22C 5 ---  23C 5 ---  22D 5 ---  23D 5 --- }
6D7F: 0025 { 22E 5 ---  23E 5 ---  22F 5 ---  23F 5 --- }
6D80: ~
6D81: ~
6D82: 0025 { 0F8 1 ---  0F8 1 ---  0F8 1 ---  183 4 --- }
6D83: 0025 { 0F8 1 ---  193 4 ---  0F8 1 ---  1A0 4 --- }
6D84: 0025 { 0F8 1 ---  1A0 4 x--  0F8 1 ---  193 4 x-- }
6D85: 0025 { 0F8 1 ---  183 4 x--  0F8 1 ---  0F8 1 --- }
6D86: 0130 { 004 4 ---  004 4 x--  004 4 ---  004 4 x-- }
6D87: 0130 { 004 4 ---  004 4 x--  004 4 ---  004 4 x-- }
6D88: 0025 { 240 5 ---  25E 5 ---  241 5 ---  251 5 --- }
6D89: 0025 { 242 5 ---  252 5 ---  243 5 ---  253 5 --- }
6D8A: 0025 { 244 5 ---  254 5 ---  245 5 ---  266 5 x-- }
6D8B: 0025 { 246 5 ---  25F 5 x--  247 5 ---  25E 5 x-- }
6D8C: 0025 { 248 5 ---  25D 5 x--  249 5 ---  25C 5 x-- }
6D8D: 0025 { 24A 5 ---  25B 5 x--  24B 5 ---  25B 5 --- }
6D8E: 0025 { 24C 5 ---  25C 5 ---  24D 5 ---  25D 5 --- }
6D8F: 0025 { 24E 5 ---  25E 5 ---  24F 5 ---  25F 5 --- }
6D90: ~
6D91: ~
6D92: 0025 { 1CA 4 ---  1DA 4 ---  1CB 4 ---  1DB 4 --- }
6D93: 0025 { 1CC 4 ---  1DC 4 ---  1CD 4 ---  1DD 4 --- }
6D94: 0025 { 1CD 4 x--  1DD 4 x--  1CC 4 x--  1DC 4 x-- }
6D95: 0025 { 1CB 4 x--  1DB 4 x--  1CA 4 x--  1DA 4 x-- }
6D96: 0130 { 004 4 x--  004 4 x--  004 4 x--  004 4 x-- }
6D97: 0130 { 004 4 x--  004 4 x--  004 4 x--  004 4 x-- }
6D98: 0025 { 26E 5 ---  27E 5 ---  26F 5 ---  27F 5 --- }
6D99: 0025 { 004 4 ---  004 4 ---  004 4 ---  004 4 --- }
6D9A: 0025 { 004 4 ---  004 4 ---  004 4 ---  004 4 --- }
6D9B: 0025 { 26F 5 x--  27F 5 x--  26E 5 x--  27E 5 x-- }
6D9C: 0025 { 268 5 ---  278 5 ---  269 5 ---  279 5 --- }
6D9D: 0025 { 26A 5 ---  27A 5 ---  26B 5 ---  27B 5 --- }
6D9E: 0025 { 26C 5 ---  27C 5 ---  26D 5 ---  27D 5 --- }
6D9F: 0025 { 26E 5 ---  27E 5 ---  26F 5 ---  27F 5 --- }
6DA0: 0025 { 180 4 ---  190 4 ---  181 4 ---  191 4 --- }
6DA1: 0025 { 182 4 ---  192 4 ---  181 4 x--  191 4 x-- }
6DA2: 0025 { 184 4 ---  194 4 ---  185 4 ---  195 4 --- }
6DA3: 0025 { 186 4 ---  196 4 ---  187 4 ---  197 4 --- }
6DA4: 0025 { 187 4 x--  197 4 x--  186 4 x--  196 4 x-- }
6DA5: 0025 { 185 4 x--  195 4 x--  184 4 x--  194 4 x-- }
6DA6: 0025 { 181 4 ---  191 4 ---  182 4 x--  192 4 x-- }
6DA7: 0025 { 181 4 x--  191 4 x--  180 4 x--  190 4 x-- }
6DA8: 0025 { 26E 5 ---  27E 5 ---  26F 5 ---  27F 5 --- }
6DA9: 0025 { 004 4 ---  004 4 ---  004 4 ---  004 4 --- }
6DAA: 0025 { 29B 5 ---  2D4 5 ---  29D 5 ---  2D4 5 --- }
6DAB: 0025 { 26F 5 x--  27F 5 x--  26E 5 x--  27E 5 x-- }
6DAC: 0025 { 260 5 ---  270 5 ---  261 5 ---  271 5 --- }
6DAD: 0025 { 262 5 ---  272 5 ---  263 5 ---  273 5 --- }
6DAE: 0025 { 264 5 ---  274 5 ---  265 5 ---  275 5 --- }
6DAF: 0025 { 26E 5 ---  27E 5 ---  26F 5 ---  27F 5 --- }
6DB0: 0025 { 190 4 ---  190 4 -y-  1A1 4 ---  1B1 4 --- }
6DB1: 0025 { 1A1 4 xy-  1B2 4 ---  1A3 4 ---  1A1 4 --- }
6DB2: 0025 { 1A4 4 ---  1B4 4 ---  1A5 4 ---  1B5 4 --- }
6DB3: 0025 { 1A6 4 ---  1B6 4 ---  1A7 4 ---  1B7 4 --- }
6DB4: 0025 { 1A7 4 x--  1B7 4 x--  1A6 4 x--  1B6 4 x-- }
6DB5: 0025 { 1A5 4 x--  1B5 4 x--  1A4 4 x--  1B4 4 x-- }
6DB6: 0025 { 1A3 4 x--  1A1 4 x--  1A1 4 -y-  1B2 4 x-- }
6DB7: 0025 { 1A1 4 x--  1B1 4 x--  190 4 x--  190 4 xy- }
6DB8: 0025 { 26E 5 ---  25A 5 x--  26F 5 ---  25A 5 --- }
6DB9: 0025 { 2BC 5 x--  2AB 5 ---  2BB 5 x--  2CB 5 x-- }
6DBA: 0025 { 284 5 ---  2D4 5 ---  285 5 ---  2D4 5 --- }
6DBB: 0025 { 26F 5 x--  25A 5 x--  26E 5 x--  259 5 x-- }
6DBC: 0025 { 266 5 ---  276 5 ---  267 5 ---  277 5 --- }
6DBD: 0025 { 250 5 ---  255 5 ---  250 5 x--  255 5 x-- }
6DBE: 0025 { 267 5 x--  277 5 x--  266 5 x--  276 5 x-- }
6DBF: 0025 { 26E 5 ---  259 5 ---  26F 5 ---  25A 5 --- }
6DC0: 0025 { 1C0 4 ---  1D0 4 ---  1C1 4 ---  1D1 4 --- }
6DC1: 0025 { 1C2 4 ---  1D2 4 ---  1C3 4 ---  1D3 4 --- }
6DC2: 0025 { 1C4 4 ---  1D4 4 ---  1C5 4 ---  1D5 4 --- }
6DC3: 0025 { 1C6 4 ---  1D6 4 ---  1C7 4 ---  1D7 4 --- }
6DC4: 0025 { 1C7 4 x--  1D7 4 x--  1C6 4 x--  1D6 4 x-- }
6DC5: 0025 { 1C5 4 x--  1D5 4 x--  1C4 4 x--  1D4 4 x-- }
6DC6: 0025 { 1C3 4 x--  1D3 4 x--  1C2 4 x--  1D2 4 x-- }
6DC7: 0025 { 1C1 4 x--  1D1 4 x--  1C0 4 x--  1D0 4 x-- }
6DC8: 0025 { 286 5 ---  298 5 ---  287 5 ---  299 5 --- }
6DC9: 0025 { 28A 5 ---  29A 5 ---  28B 5 ---  29A 5 x-- }
6DCA: 0025 { 28C 5 ---  299 5 x--  28D 5 ---  298 5 x-- }
6DCB: 0025 { 2AA 4 ---  2BA 4 ---  2AB 4 ---  2BB 4 --- }
6DCC: 0025 { 2AC 4 ---  2BC 4 ---  2AD 4 ---  2BD 4 --- }
6DCD: 0025 { 0F8 5 x--  0F8 5 x--  0F8 5 x--  0F8 5 x-- }
6DCE: 0025 { 0F8 5 x--  0AD 4 x--  0F8 5 x--  0AC 4 x-- }
6DCF: 0025 { 004 4 ---  004 4 ---  004 4 ---  004 4 --- }
6DD0: 0025 { 18E 4 ---  19E 4 ---  18F 4 ---  19F 4 --- }
6DD1: 0025 { 0F8 3 ---  0F8 3 ---  0AC 6 ---  0BC 6 --- }
6DD2: 0025 { 0AD 6 ---  0BD 6 ---  0F8 3 ---  0F8 3 --- }
6DD3: 0025 { 18E 4 ---  19E 4 ---  18F 4 ---  19F 4 --- }
6DD4: 0025 { 188 4 ---  198 4 ---  189 4 ---  199 4 --- }
6DD5: 0025 { 18A 4 ---  19A 4 ---  18B 4 ---  19B 4 --- }
6DD6: 0025 { 18C 4 ---  19C 4 ---  18D 4 ---  19D 4 --- }
6DD7: 0025 { 18E 4 ---  19E 4 ---  18F 4 ---  19F 4 --- }
6DD8: 0025 { 2A8 5 ---  2B8 0 ---  2A9 5 ---  2B9 5 --- }
6DD9: 0025 { 2AA 5 ---  2BA 5 ---  2AA 5 x--  2BB 5 --- }
6DDA: 0025 { 2A9 5 x--  2BC 5 ---  2A8 5 x--  2B8 0 x-- }
6DDB: 0025 { 2CA 4 ---  2DA 4 ---  2CB 4 ---  2DB 4 --- }
6DDC: 0025 { 2CC 4 ---  2DC 4 ---  2CD 4 ---  2DD 4 --- }
6DDD: 0025 { 0F8 5 x--  0F8 5 x--  0CA 4 x--  0CB 4 x-- }
6DDE: 0025 { 0BD 4 x--  0CD 4 x--  0BC 4 x--  0CC 4 x-- }
6DDF: ~
6DE0: 0025 { 1AE 4 ---  19E 4 ---  1AF 4 ---  19F 4 --- }
6DE1: 0025 { 0F8 3 ---  0F8 3 ---  0DE 6 ---  0FE 6 --- }
6DE2: 0025 { 0DF 6 ---  0FF 6 ---  0F8 3 ---  0F8 3 --- }
6DE3: 0025 { 1AE 4 ---  19E 4 ---  1AF 4 ---  19F 4 --- }
6DE4: 0025 { 1A8 4 ---  1B8 4 ---  1A9 4 ---  1B9 4 --- }
6DE5: 0025 { 1AA 4 ---  1BA 4 ---  1AB 4 ---  1BB 4 --- }
6DE6: 0025 { 1AC 4 ---  1BC 4 ---  1AD 4 ---  1BD 4 --- }
6DE7: 0025 { 1AE 4 ---  19E 4 ---  1AF 4 ---  19F 4 --- }
6DE8: 0025 { 2C8 0 ---  2DA 0 ---  2C9 5 ---  2DB 0 --- }
6DE9: 0025 { 2CA 5 ---  2DC 0 ---  2CB 5 ---  2DC 0 x-- }
6DEA: 0025 { 2CC 5 ---  2DB 0 x--  2C8 0 x--  2DA 0 x-- }
6DEB: 0025 { 2B0 7 ---  2C0 7 ---  2B1 7 ---  2C1 7 --- }
6DEC: 0025 { 2B2 7 ---  2C2 7 ---  2B3 7 ---  2C3 7 --- }
6DED: ~
6DEE: ~
6DEF: ~
6DF0: 0025 { 1AE 4 ---  1BE 4 ---  1AF 4 ---  1BF 4 --- }
6DF1: ~
6DF2: ~
6DF3: 0025 { 1AE 4 ---  1BE 4 ---  1AF 4 ---  1BF 4 --- }
6DF4: 0025 { 1C8 4 ---  1D8 4 ---  1C9 4 ---  1D9 4 --- }
6DF5: 0025 { 1C9 4 ---  1D9 4 ---  1C9 4 x--  1D9 4 x-- }
6DF6: 0025 { 1C9 4 x--  1D9 4 x--  1C8 4 x--  1D8 4 x-- }
6DF7: 0025 { 1AE 4 ---  1BE 4 ---  1AF 4 ---  1BF 4 --- }
6DF8: 0025 { 2EA 0 ---  2FA 0 ---  2EB 0 ---  2FB 0 --- }
6DF9: 0025 { 2EC 0 ---  2FC 0 ---  2EC 0 x--  2FC 0 x-- }
6DFA: 0025 { 2EB 0 x--  2FB 0 x--  2EA 0 x--  2FA 0 x-- }
6DFB: 0025 { 2B4 7 ---  2C4 7 ---  2B5 7 ---  2C5 7 --- }
6DFC: 0025 { 2B6 7 ---  2C6 7 ---  2B7 7 ---  2C7 7 --- }
6DFD: 0025 { 004 4 ---  004 4 ---  004 4 ---  004 4 --- }
6DFE: 0025 { 004 4 ---  004 4 ---  004 4 ---  004 4 --- }
6DFF: ~
