7F00: 0130 { 0F8 0 --p  0F8 0 --p  0F8 0 --p  286 7 --p }
7F01: 0130 { 0F8 0 --p  287 7 --p  0F8 0 --p  288 7 --p }
7F02: 0130 { 0F8 0 --p  289 7 --p  0F8 0 --p  28A 7 --p }
7F03: 0130 { 0F8 0 --p  28B 7 --p  0F8 0 --p  0F8 0 --p }
7F04: 0130 { 286 7 --p  296 7 --p  287 7 --p  297 7 --p }
7F05: 0130 { 28A 7 --p  29A 7 --p  28B 7 --p  29B 7 --p }
7F06: 0025 { 102 2 ---  095 2 ---  103 2 ---  096 2 --- }
7F07: 0004 { 04C 2 --p  04E 2 --p  04D 2 --p  04F 2 --p }
7F08: 0130 { 2C2 2 ---  2D2 2 ---  2C3 2 ---  2E2 2 --- }
7F09: 0100 { 2A4 2 ---  2B4 2 ---  2A5 2 ---  2B5 2 --- }
7F0A: 002B { 0A2 1 ---  0B2 1 ---  0A3 1 ---  0B3 1 --- }
7F0B: 0025 { 0C2 2 ---  0D2 2 ---  0C3 2 ---  0D3 2 --- }
7F0C: 0025 { 0C0 2 ---  0D0 2 ---  0C1 2 ---  0D1 2 --- }
7F0D: 0145 { 280 2 ---  290 2 ---  2A0 2 ---  193 2 --- }
7F0E: 0100 { 2A1 2 ---  192 2 ---  2A0 2 ---  195 2 --- }
7F0F: 0130 { 2A1 2 ---  194 2 ---  280 2 x--  290 2 x-- }
7F10: 0130 { 0F8 0 --p  0F8 0 --p  296 7 --p  2A6 7 --p }
7F11: 0130 { 297 7 --p  2A7 7 --p  298 7 --p  2A8 7 --p }
7F12: 0130 { 299 7 --p  2A9 7 --p  29A 7 --p  2AA 7 --p }
7F13: 0130 { 29B 7 --p  2AB 7 --p  0F8 0 --p  0F8 0 --p }
7F14: 0130 { 2B6 7 --p  2C6 7 --p  2B7 7 --p  2C7 7 --p }
7F15: 0130 { 284 7 --p  2CA 7 --p  285 7 --p  2CB 7 --p }
7F16: 0025 { 095 2 ---  095 2 ---  096 2 ---  096 2 --- }
7F17: 0005 { 0FC 2 --p  0FC 2 --p  0FC 2 --p  0FC 2 --p }
7F18: 0025 { 2C0 2 ---  2D0 2 ---  2C1 2 ---  2D1 2 --- }
7F19: 0025 { 0F8 3 ---  0F8 3 ---  2C0 2 ---  2D0 2 --- }
7F1A: 0025 { 2C1 2 ---  2D1 2 ---  0F8 3 ---  0F8 3 --- }
7F1B: 01E2 { 192 2 ---  192 2 ---  195 2 ---  292 2 xy- }
7F1C: 01E4 { 192 2 ---  292 2 -y-  195 2 ---  195 2 --- }
7F1D: 0130 { 2A2 2 ---  290 2 ---  193 2 ---  193 2 --- }
7F1E: 0130 { 192 2 ---  192 2 ---  195 2 ---  195 2 --- }
7F1F: 0130 { 194 2 ---  194 2 ---  2A2 2 x--  290 2 x-- }
7F20: 0130 { 0F8 0 --p  0F8 0 --p  2B6 7 --p  2C6 7 --p }
7F21: 0130 { 2B7 7 --p  2C7 7 --p  282 7 --p  2C8 7 --p }
7F22: 0130 { 283 7 --p  2C9 7 --p  284 7 --p  2CA 7 --p }
7F23: 0130 { 285 7 --p  2CB 7 --p  0F8 0 --p  0F8 0 --p }
7F24: 0130 { 293 7 --p  2E6 7 --p  294 7 --p  2E7 7 --p }
7F25: 0130 { 2DA 7 --p  2EA 7 --p  2DB 7 --p  2EB 7 --p }
7F26: 0107 { 046 2 ---  046 2 -y-  046 2 x--  046 2 xy- }
7F27: 0108 { 04A 2 ---  04A 2 -y-  04A 2 x--  04A 2 xy- }
7F28: 0025 { 2E0 2 ---  0F8 3 ---  2E1 2 ---  0F8 3 --- }
7F29: 0025 { 0F8 3 ---  0F8 3 ---  2E0 2 ---  0F8 3 --- }
7F2A: 0025 { 2E1 2 ---  0F8 3 ---  0F8 3 ---  0F8 3 --- }
7F2B: 01E4 { 192 2 ---  192 2 ---  292 2 x--  195 2 --- }
7F2C: 01E2 { 292 2 ---  192 2 ---  195 2 ---  195 2 --- }
7F2D: 0130 { 2A2 2 ---  280 2 -y-  193 2 ---  2A0 2 -y- }
7F2E: 0130 { 192 2 ---  2A1 2 -y-  195 2 ---  2A0 2 -y- }
7F2F: 0130 { 194 2 ---  2A1 2 -y-  2A2 2 x--  280 2 xy- }
7F30: 0130 { 0F8 0 --p  0F8 0 --p  293 7 --p  2E6 7 --p }
7F31: 0130 { 294 7 --p  2E7 7 --p  295 7 --p  2E8 7 --p }
7F32: 0130 { 2D9 7 --p  2E9 7 --p  2DA 7 --p  2EA 7 --p }
7F33: 0025 { 2DB 7 --p  2EB 7 --p  0F8 0 --p  0F8 0 --p }
7F34: 001F { 102 2 ---  095 2 ---  103 2 ---  096 2 --- }
7F35: 0100 { 2A0 2 ---  193 2 ---  2A5 2 ---  084 2 --- }
7F36: 0100 { 2A0 2 ---  193 2 ---  2A5 2 ---  094 2 --- }
7F37: 0100 { 2A5 2 x--  094 2 x--  2A0 2 x--  193 2 x-- }
7F38: 0100 { 2A5 2 x--  084 2 x--  2A0 2 x--  193 2 x-- }
7F39: 0025 { 082 2 ---  092 2 ---  083 2 ---  093 2 --- }
7F3A: 0145 { 291 2 ---  290 2 ---  2A0 2 ---  193 2 --- }
7F3B: 0025 { 10C 2 ---  12E 2 ---  10D 2 ---  12F 2 --- }
7F3C: 0025 { 108 2 ---  118 2 ---  109 2 ---  119 2 --- }
7F3D: 0025 { 10A 2 ---  11A 2 ---  10B 2 ---  11B 2 --- }
7F3E: 0025 { 11C 2 ---  12C 2 ---  11D 2 ---  12D 2 --- }
7F3F: 0025 { 10E 2 ---  11E 2 ---  10E 2 ---  11E 2 --- }
7F40: 0025 { 0FE 3 ---  0FE 3 ---  15A 3 ---  15A 3 --- }
7F41: 0025 { 0FE 3 ---  0FE 3 ---  0FE 3 ---  0FE 3 --- }
7F42: 0025 { 15B 3 ---  15B 3 ---  0FE 3 ---  0FE 3 --- }
7F43: 0025 { 0FE 3 ---  0FE 3 ---  0FE 3 ---  0FE 3 --- }
7F44: 0020 { 095 2 ---  095 2 ---  096 2 ---  096 2 --- }
7F45: 0025 { 2C4 2 --p  2F1 2 --p  2C5 2 --p  2A3 2 --p }
7F46: 0025 { 2C5 2 x-p  2A3 2 --p  2C5 2 --p  2A3 2 --p }
7F47: 0025 { 2C5 2 x-p  2A3 2 --p  2C4 2 x-p  2F1 2 x-p }
7F48: 0025 { 115 2 -yp  105 2 -yp  107 2 --p  106 2 -yp }
7F49: 0025 { 107 2 --p  106 2 xyp  115 2 xyp  105 2 xyp }
7F4A: 0025 { 107 2 --p  107 2 --p  107 2 --p  107 2 --p }
7F4B: 0025 { 0F8 3 ---  12E 2 -y-  0F8 3 ---  12F 2 -y- }
7F4C: 0025 { 128 2 ---  138 2 ---  129 2 ---  139 2 --- }
7F4D: 0025 { 12A 2 ---  13A 2 ---  12B 2 ---  13B 2 --- }
7F4E: 0025 { 10C 2 ---  10C 2 ---  10D 2 ---  10D 2 --- }
7F4F: 0025 { 10E 2 x--  11E 2 x--  10E 2 x--  11E 2 x-- }
7F50: 0025 { 0FE 3 ---  100 3 x--  15E 3 ---  160 3 --- }
7F51: 0025 { 0FE 3 ---  161 3 ---  0FE 3 ---  162 3 --- }
7F52: 0025 { 15F 3 ---  163 3 ---  0FE 3 ---  100 3 --- }
7F53: 0025 { 0FE 3 ---  101 3 ---  0FE 3 ---  101 3 x-- }
7F54: 0025 { 104 3 ---  114 3 ---  0F8 3 ---  0F8 3 --- }
7F55: 0025 { 2F0 2 --p  2F0 2 --p  2A3 2 --p  2A3 2 --p }
7F56: 0025 { 2A3 2 --p  2A3 2 --p  2A3 2 --p  2A3 2 --p }
7F57: 0025 { 2A3 2 --p  2A3 2 --p  2F0 2 x-p  2F0 2 x-p }
7F58: 0025 { 107 2 --p  107 2 --p  107 2 --p  116 2 xyp }
7F59: 0025 { 107 2 --p  116 2 -yp  107 2 --p  107 2 --p }
7F5A: 0025 { 0F8 3 ---  0F8 3 ---  0F8 3 ---  0F8 3 --- }
7F5B: 0025 { 12E 2 ---  0F8 3 ---  12F 2 ---  0F8 3 --- }
7F5C: 0025 { 10F 2 ---  11F 2 ---  0F8 3 ---  0F8 3 --- }
7F5D: 0025 { 12E 2 -y-  10C 2 -y-  12F 2 -y-  10D 2 -y- }
7F5E: 0025 { 10C 2 ---  12E 2 ---  10D 2 ---  12F 2 --- }
7F5F: 0025 { 10E 2 x--  11E 2 x--  10E 2 ---  11E 2 --- }
7F60: 0025 { 110 3 x--  120 3 x--  16A 3 x--  16C 3 --- }
7F61: 0025 { 0FE 3 ---  16D 3 ---  0FE 3 ---  16D 3 x-- }
7F62: 0025 { 16A 3 ---  16C 3 x--  110 3 ---  120 3 --- }
7F63: 0025 { 111 3 ---  121 3 ---  111 3 x--  121 3 x-- }
7F64: 015D { 1F4 2 ---  1F7 2 ---  1F5 2 ---  1FC 2 --- }
7F65: 015E { 1F5 2 x--  1FC 2 ---  1F5 2 ---  1FD 2 --- }
7F66: 0130 { 1F5 2 x--  1FD 2 ---  1F6 2 ---  1F8 2 --- }
7F67: 0130 { 104 3 ---  104 3 ---  13E 2 ---  13E 2 --- }
7F68: 0025 { 107 2 --p  107 2 --p  116 2 x-p  107 2 --p }
7F69: 0025 { 116 2 --p  107 2 --p  107 2 --p  107 2 --p }
7F6A: 0025 { 116 2 --p  116 2 -yp  107 2 --p  107 2 --p }
7F6B: 0025 { 107 2 x-p  107 2 x-p  116 2 x-p  116 2 xyp }
7F6C: 0025 { 0F8 3 ---  0F8 3 ---  10F 2 x--  11F 2 x-- }
7F6D: 0130 { 2F7 5 ---  2D3 5 ---  2F8 5 ---  2D4 5 --- }
7F6E: 0130 { 2F9 5 ---  2D5 5 ---  2FA 5 ---  2D6 5 --- }
7F6F: 0130 { 2FB 5 ---  2D7 5 ---  2FC 5 ---  2D8 5 --- }
7F70: 0025 { 0F8 3 ---  0F8 3 ---  0F8 3 ---  0F8 3 --- }
7F71: 0025 { 170 3 ---  172 3 ---  171 3 ---  173 3 --- }
7F72: 0025 { 0F8 3 ---  0F8 3 ---  0F8 3 ---  0F8 3 --- }
7F73: 0025 { 174 3 ---  176 3 ---  175 3 ---  177 3 --- }
7F74: 0160 { 1F7 2 ---  1F7 2 -y-  1FE 2 x--  1FF 2 -y- }
7F75: 0161 { 1FE 2 -y-  1FF 2 ---  1FF 2 -y-  1FE 2 x-- }
7F76: 0162 { 1FE 2 ---  1FF 2 ---  1F8 2 ---  1F8 2 -y- }
7F77: 0025 { 104 3 ---  104 3 ---  13E 2 ---  157 2 xy- }
7F78: 0106 { 2F2 3 ---  0F8 3 ---  2F6 3 ---  130 3 --- }
7F79: 0106 { 2F6 3 x--  131 3 ---  2F2 3 x--  0F8 3 --- }
7F7A: 0025 { 0C2 2 ---  0D2 2 ---  0C3 2 ---  0D3 2 --- }
7F7B: 0025 { 130 3 ---  133 3 ---  131 3 ---  134 3 --- }
7F7C: 0106 { 2F6 3 x--  123 3 ---  2F6 3 x--  124 3 --- }
7F7D: 0130 { 2FC 5 x--  2D8 5 x--  2FB 5 x--  2D7 5 x-- }
7F7E: 0130 { 2FA 5 x--  2D6 5 x--  2F9 5 x--  2D5 5 x-- }
7F7F: 0130 { 2F8 5 x--  2D4 5 x--  2F7 5 x--  2D3 5 x-- }
7F80: 0130 { 292 2 xy-  290 2 x--  2A0 2 -y-  286 7 --p }
7F81: 0130 { 2A1 2 -y-  287 7 --p  2A0 2 -y-  288 7 --p }
7F82: 0130 { 2A1 2 -y-  289 7 --p  2A0 2 -y-  28A 7 --p }
7F83: 0130 { 2A1 2 -y-  28B 7 --p  292 2 -y-  290 2 --- }
7F84: 0163 { 1F7 2 ---  1F9 2 ---  1FE 2 ---  1FA 2 --- }
7F85: 0164 { 1FF 2 x--  1FA 2 ---  1FE 2 ---  1FA 2 x-- }
7F86: 0165 { 1FE 2 xy-  1FA 2 ---  1F8 2 ---  1FB 2 --- }
7F87: 0025 { 104 3 ---  104 3 ---  156 2 xy-  146 2 xy- }
7F88: 0130 { 1F4 2 ---  1F7 2 ---  1F6 2 ---  1F8 2 --- }
7F89: 0106 { 2F2 3 ---  0F8 3 ---  2F6 3 ---  0F8 3 --- }
7F8A: 0106 { 2F6 3 x--  0F8 3 ---  2F6 3 x--  0F8 3 --- }
7F8B: 0106 { 2F6 3 x--  0F8 3 ---  2F2 3 x--  0F8 3 --- }
7F8C: 0025 { 133 3 ---  133 3 ---  134 3 ---  134 3 --- }
7F8D: 0165 { 1FD 2 ---  1FA 2 ---  1F8 2 ---  1FB 2 --- }
7F8E: ~
7F8F: ~
7F90: 0130 { 2A2 2 x--  280 2 xy-  296 7 --p  2A6 7 --p }
7F91: 0130 { 297 7 --p  2A7 7 --p  298 7 --p  2A8 7 --p }
7F92: 0130 { 299 7 --p  2A9 7 --p  29A 7 --p  2AA 7 --p }
7F93: 0130 { 29B 7 --p  2AB 7 --p  2A2 2 ---  280 2 -y- }
7F94: 0025 { 110 3 x--  120 3 x--  0F8 3 ---  0F8 3 --- }
7F95: 0025 { 104 3 ---  104 3 ---  0F8 3 ---  0F8 3 --- }
7F96: 0025 { 104 3 ---  114 3 ---  0FB 2 x--  141 2 -y- }
7F97: 0025 { 104 3 ---  104 3 ---  0FB 2 x--  0FB 2 x-- }
7F98: 0025 { 0FB 2 x--  0FB 2 x--  0FB 2 x--  0FB 2 x-- }
7F99: 0025 { 13E 2 ---  13E 2 ---  13E 2 ---  13E 2 --- }
7F9A: 0130 { 28D 7 x-p  29D 7 x-p  28C 7 x-p  29C 7 x-p }
7F9B: 0025 { 0FA 3 -y-  0FA 3 -y-  0FA 3 -y-  0FA 3 -y- }
7F9C: 0025 { 141 2 x--  151 2 -y-  140 2 x--  150 2 x-- }
7F9D: 0025 { 140 2 ---  150 2 ---  141 2 ---  151 2 xy- }
7F9E: 0025 { 151 2 ---  141 2 xy-  150 2 xy-  140 2 xy- }
7F9F: 0025 { 150 2 -y-  140 2 -y-  151 2 x--  141 2 -y- }
7FA0: 0130 { 2A2 2 x--  290 2 x--  296 7 --p  2A6 7 --p }
7FA1: 0130 { 297 7 --p  2A7 7 --p  298 7 --p  2A8 7 --p }
7FA2: 0130 { 299 7 --p  2A9 7 --p  29A 7 --p  2AA 7 --p }
7FA3: 0130 { 29B 7 --p  2AB 7 --p  2A2 2 ---  290 2 --- }
7FA4: 0025 { 150 2 -y-  140 2 -y-  0FB 2 x--  141 2 -y- }
7FA5: 0025 { 0FB 2 x--  141 2 xy-  150 2 xy-  140 2 xy- }
7FA6: 0025 { 140 2 ---  150 2 ---  141 2 ---  0FB 2 x-- }
7FA7: 0025 { 141 2 x--  0FB 2 x--  140 2 x--  150 2 x-- }
7FA8: 0025 { 0FB 2 x--  151 2 -y-  0FB 2 x--  0FB 2 x-- }
7FA9: 0025 { 0FB 2 x--  0FB 2 x--  0FB 2 x--  151 2 xy- }
7FAA: 0025 { 151 2 ---  0FB 2 x--  0FB 2 x--  0FB 2 x-- }
7FAB: 0025 { 0FB 2 x--  0FB 2 x--  151 2 x--  0FB 2 x-- }
7FAC: 0025 { 151 2 ---  151 2 -y-  0FB 2 x--  0FB 2 x-- }
7FAD: 0025 { 0FB 2 x--  0FB 2 x--  151 2 x--  151 2 xy- }
7FAE: 0025 { 0FB 2 x--  151 2 -y-  0FB 2 x--  151 2 xy- }
7FAF: 0025 { 0C2 2 ---  0D2 2 ---  0C3 2 ---  0C4 2 --- }
7FB0: 0130 { 2A2 2 x--  280 2 xy-  2B6 7 --p  2C6 7 --p }
7FB1: 0130 { 2B7 7 --p  2C7 7 --p  282 7 --p  2C8 7 --p }
7FB2: 0130 { 283 7 --p  2C9 7 --p  284 7 --p  2CA 7 --p }
7FB3: 0130 { 285 7 --p  2CB 7 --p  2A2 2 ---  280 2 -y- }
7FB4: 0025 { 156 2 -y-  146 2 -y-  13E 2 ---  147 2 -y- }
7FB5: 0025 { 13E 2 ---  147 2 xy-  156 2 xy-  146 2 xy- }
7FB6: 0025 { 146 2 ---  156 2 ---  147 2 ---  13E 2 --- }
7FB7: 0025 { 147 2 x--  13E 2 ---  146 2 x--  156 2 x-- }
7FB8: 0025 { 13E 2 ---  157 2 -y-  13E 2 ---  13E 2 --- }
7FB9: 0025 { 13E 2 ---  13E 2 ---  13E 2 ---  157 2 xy- }
7FBA: 0025 { 157 2 ---  13E 2 ---  13E 2 ---  13E 2 --- }
7FBB: 0025 { 13E 2 ---  13E 2 ---  157 2 x--  13E 2 --- }
7FBC: 0130 { 28C 7 --p  29C 7 --p  28D 7 --p  29D 7 --p }
7FBD: 0130 { 28E 7 --p  29E 7 --p  28F 7 --p  29F 7 --p }
7FBE: 0130 { 2ED 7 --p  2FD 7 --p  2EE 7 --p  2FE 7 --p }
7FBF: 0130 { 14A 2 ---  1FC 2 ---  1F6 2 ---  1F8 2 --- }
7FC0: 0130 { 2A2 2 x--  290 2 x--  2B6 7 --p  2C6 7 --p }
7FC1: 0130 { 2B7 7 --p  2C7 7 --p  282 7 --p  2C8 7 --p }
7FC2: 0130 { 283 7 --p  2C9 7 --p  284 7 --p  2CA 7 --p }
7FC3: 0130 { 285 7 --p  2CB 7 --p  2A2 2 ---  290 2 --- }
7FC4: 0025 { 154 2 -y-  144 2 -y-  0FB 2 ---  145 2 -y- }
7FC5: 0025 { 0FB 2 x--  145 2 xy-  154 2 xy-  144 2 xy- }
7FC6: 0025 { 144 2 ---  154 2 ---  145 2 ---  0FB 2 -y- }
7FC7: 0025 { 145 2 x--  0FB 2 xy-  144 2 x--  154 2 x-- }
7FC8: 0025 { 0FB 2 xy-  155 2 -y-  0FB 2 xy-  0FB 2 xy- }
7FC9: 0025 { 0FB 2 -y-  0FB 2 -y-  0FB 2 -y-  155 2 xy- }
7FCA: 0025 { 155 2 ---  0FB 2 x--  0FB 2 x--  0FB 2 x-- }
7FCB: 0025 { 0FB 2 ---  0FB 2 ---  155 2 x--  0FB 2 --- }
7FCC: 0130 { 2F2 3 ---  1F4 2 ---  2F6 3 ---  1F5 2 --- }
7FCD: 0130 { 2F6 3 x--  1F5 2 x--  2F2 3 x--  1F6 2 --- }
7FCE: 0163 { 1F7 2 ---  1F9 2 ---  1FC 2 ---  1FA 2 --- }
7FCF: 0025 { 0F8 3 ---  0F8 3 ---  133 3 ---  133 3 --- }
7FD0: 0130 { 2A2 2 x--  280 2 xy-  293 7 --p  2E6 7 --p }
7FD1: 0130 { 294 7 --p  2E7 7 --p  295 7 --p  2E8 7 --p }
7FD2: 0130 { 2D9 7 --p  2E9 7 --p  2DA 7 --p  2EA 7 --p }
7FD3: 0025 { 2DB 7 --p  2EB 7 --p  2A2 2 ---  280 2 -y- }
7FD4: 0130 { 2E6 7 -yp  293 7 -yp  2E7 7 -yp  294 7 -yp }
7FD5: 0130 { 2E8 7 -yp  295 7 -yp  2E9 7 -yp  2D9 7 -yp }
7FD6: 0130 { 2EA 7 -yp  2DA 7 -yp  2EB 7 -yp  2DB 7 -yp }
7FD7: 0025 { 0F8 3 ---  0F8 3 ---  0C0 2 ---  0D0 2 --- }
7FD8: 0025 { 0C1 2 ---  0D1 2 ---  0F8 3 ---  0F8 3 --- }
7FD9: 0025 { 0FB 2 ---  141 2 xy-  104 3 x--  114 3 x-- }
7FDA: 0025 { 13E 2 ---  147 2 xy-  104 3 x--  104 3 x-- }
7FDB: 0130 { 13E 2 x--  13E 2 x--  104 3 x--  104 3 x-- }
7FDC: 0130 { 2CC 7 --p  2DC 7 --p  2CD 7 --p  2DD 7 --p }
7FDD: 0130 { 2CE 7 --p  2DE 7 --p  2CF 7 --p  2DF 7 --p }
7FDE: 0130 { 2E4 7 --p  2F4 7 --p  2E5 7 --p  2F5 7 --p }
7FDF: 0025 { 134 3 ---  134 3 ---  0F8 3 ---  0F8 3 --- }
7FE0: 0100 { 2A1 2 ---  192 2 ---  2A0 2 ---  195 2 --- }
7FE1: 0130 { 2A1 2 ---  194 2 ---  280 2 x--  290 2 x-- }
7FE2: 0130 { 1F4 2 ---  1F7 2 ---  1F5 2 ---  1FC 2 --- }
7FE3: 0130 { 1F5 2 x--  1FC 2 ---  1F5 2 ---  1FD 2 --- }
7FE4: 0025 { 150 2 -y-  140 2 -y-  151 2 x--  141 2 -y- }
7FE5: 0025 { 151 2 ---  141 2 xy-  150 2 xy-  140 2 xy- }
7FE6: 0130 { 148 2 ---  1FC 2 ---  14B 2 ---  14D 2 --- }
7FE7: 0130 { 14C 2 ---  1FC 2 ---  1F5 2 ---  1FD 2 --- }
7FE8: 0130 { 148 2 ---  1FC 2 ---  149 2 ---  0B4 2 --- }
7FE9: 0130 { 14A 2 ---  1FC 2 ---  1F5 2 ---  1FD 2 --- }
7FEA: 0130 { 148 2 ---  1FC 2 ---  149 2 ---  14D 2 --- }
7FEB: 0130 { 14A 2 ---  1FC 2 ---  1F5 2 ---  1FD 2 --- }
7FEC: 0130 { 148 2 ---  1FC 2 ---  149 2 ---  0A4 2 --- }
7FED: 0130 { 14A 2 ---  1FC 2 ---  1F5 2 ---  1FD 2 --- }
7FEE: 0025 { 0F8 3 x--  0F8 3 x--  110 3 ---  120 3 --- }
7FEF: 0025 { 0F8 3 ---  0F8 3 ---  130 3 ---  133 3 --- }
7FF0: 0130 { 296 7 -yp  286 7 -yp  297 7 -yp  287 7 -yp }
7FF1: 0130 { 298 7 -yp  288 7 -yp  299 7 -yp  289 7 -yp }
7FF2: 0130 { 29A 7 -yp  28A 7 -yp  29B 7 -yp  28B 7 -yp }
7FF3: 0130 { 2CD 7 x-p  2DD 7 x-p  2CC 7 x-p  2DC 7 x-p }
7FF4: 0025 { 158 3 x--  159 3 x--  137 3 x--  13C 3 x-- }
7FF5: 0025 { 0FE 3 ---  16D 3 ---  0FE 3 ---  16D 3 x-- }
7FF6: 0025 { 137 3 ---  13C 3 ---  158 3 ---  159 3 --- }
7FF7: 0025 { 111 3 ---  121 3 ---  111 3 x--  121 3 x-- }
7FF8: 0025 { 13D 3 ---  13D 3 ---  13D 3 ---  13D 3 --- }
7FF9: 0025 { 170 3 ---  172 3 ---  171 3 ---  173 3 --- }
7FFA: 0025 { 13D 3 ---  13D 3 ---  13D 3 ---  13D 3 --- }
7FFB: 0025 { 174 3 ---  176 3 ---  175 3 ---  177 3 --- }
7FFC: 0130 { 2B6 7 -yp  2A6 7 -yp  2B7 7 -yp  2A7 7 -yp }
7FFD: 0130 { 282 7 -yp  2A8 7 -yp  283 7 -yp  2A9 7 -yp }
7FFE: 0130 { 284 7 -yp  2AA 7 -yp  285 7 -yp  2AB 7 -yp }
7FFF: 0025 { 131 3 ---  134 3 ---  0F8 3 ---  0F8 3 --- }
