7100: 0130 { 08D 3 ---  08D 3 -y-  08D 3 x--  08D 3 xy- }
7101: 0130 { 09D 3 ---  09D 3 -y-  09D 3 x--  09D 3 xy- }
7102: 0130 { 0BB 2 ---  0F8 2 ---  0F8 2 ---  0F8 2 --- }
7103: 0130 { 0F8 3 ---  0F8 3 ---  0F8 3 ---  0F0 3 --- }
7104: 0130 { 0F7 2 ---  0F7 2 -y-  0F7 2 x--  0F7 2 xy- }
7105: 0130 { 0E7 2 ---  0E7 2 -y-  0E7 2 x--  0E7 2 xy- }
7106: 0130 { 0D7 2 ---  0D7 2 -y-  0D7 2 x--  0D7 2 xy- }
7107: 0130 { 0C7 2 ---  0C7 2 -y-  0C7 2 x--  0C7 2 xy- }
7108: 0130 { 0C8 2 ---  0D8 2 ---  0C9 2 ---  0D9 2 --- }
7109: 0130 { 0C9 2 x--  0D9 2 x--  0C8 2 x--  0D8 2 x-- }
710A: 0130 { 0D8 2 -y-  0C8 2 -y-  0D9 2 -y-  0C9 2 -y- }
710B: 0130 { 0D9 2 xy-  0C9 2 xy-  0D8 2 xy-  0C8 2 xy- }
710C: 0130 { 08E 5 ---  09E 5 ---  08E 5 x--  09E 5 x-- }
710D: 0130 { 09E 5 -y-  08E 5 -y-  09E 5 xy-  08E 5 xy- }
710E: 0130 { 08F 5 ---  08F 5 -y-  09F 5 -y-  09F 5 --- }
710F: 0130 { 09F 5 xy-  09F 5 x--  08F 5 x--  08F 5 xy- }
7110: 0130 { 192 2 ---  18D 2 -y-  18D 2 -y-  189 2 -y- }
7111: 0130 { 18D 2 xy-  189 2 xy-  193 2 ---  18D 2 xy- }
7112: 0130 { 192 2 ---  194 2 ---  193 2 ---  195 2 --- }
7113: 0130 { 19A 2 ---  189 2 ---  19A 2 ---  189 2 x-- }
7114: 0130 { 194 2 ---  192 2 ---  195 2 ---  193 2 --- }
7115: 0130 { 189 2 -y-  19A 2 -y-  19A 2 -y-  19A 2 -y- }
7116: 0130 { 19A 2 xy-  19A 2 xy-  189 2 xy-  19A 2 xy- }
7117: 0130 { 19A 2 ---  19A 2 ---  19A 2 ---  189 2 x-- }
7118: 0130 { 19A 2 ---  189 2 ---  19A 2 ---  19A 2 --- }
7119: 0130 { 189 2 -y-  19A 2 -y-  189 2 xy-  19A 2 -y- }
711A: 0130 { 0F8 5 ---  188 2 -y-  188 2 -y-  189 2 -y- }
711B: 0130 { 188 2 xy-  189 2 xy-  0F8 5 ---  188 2 xy- }
711C: 0130 { 0F8 5 xy-  188 2 -y-  0F8 5 xy-  188 2 xy- }
711D: 0130 { 0F8 5 ---  0F8 5 ---  2E9 2 ---  2F9 2 --- }
711E: 0130 { 2EA 2 ---  2FA 2 ---  0F8 5 ---  0F8 5 --- }
711F: 0130 { 182 2 x--  183 2 xy-  180 2 x--  180 2 xy- }
7120: 0130 { 2E1 3 ---  1FF 3 -y-  1AA 3 ---  089 3 --- }
7121: 0130 { 1BE 3 ---  08A 3 ---  2EB 3 ---  09A 3 --- }
7122: 0130 { 2E1 3 ---  2C7 3 ---  1AA 3 ---  096 3 --- }
7123: 0130 { 1BE 3 ---  08A 3 -y-  2EB 3 ---  09A 3 --- }
7124: 0130 { 2E1 3 ---  1FF 3 -y-  2EB 3 ---  09A 3 --- }
7125: 0130 { 08A 3 ---  099 3 ---  09A 3 ---  09A 3 --- }
7126: 0130 { 1FF 3 -y-  1FF 3 ---  089 3 ---  08A 3 -y- }
7127: 0130 { 0F8 5 ---  16C 2 ---  16C 2 ---  16D 2 --- }
7128: 0130 { 16C 2 x--  16D 2 x--  0F8 5 ---  16C 2 x-- }
7129: 0130 { 0F8 5 ---  16A 2 ---  0F8 5 ---  16B 2 --- }
712A: 0130 { 16A 2 ---  17A 2 ---  16B 2 ---  17B 2 --- }
712B: 0130 { 16B 2 x--  17B 2 x--  16A 2 x--  17A 2 x-- }
712C: 0130 { 0F8 5 ---  16B 2 x--  0F8 5 ---  16A 2 x-- }
712D: 0130 { 1F6 2 ---  16E 2 ---  0F8 5 ---  16F 2 --- }
712E: 0130 { 0F8 5 ---  16F 2 x--  1F6 2 x--  16E 2 x-- }
712F: 0130 { 186 2 ---  182 2 -y-  190 2 xy-  180 2 xy- }
7130: 0130 { 1FF 3 ---  2C7 3 ---  08A 3 -y-  096 3 --- }
7131: 0130 { 099 3 ---  096 3 x--  09A 3 ---  2FB 3 --- }
7132: 0130 { 2E1 3 ---  1FF 3 -y-  2EB 3 ---  09A 3 --- }
7133: 0130 { 1FF 3 ---  2C7 3 ---  09A 3 ---  2FB 3 --- }
7134: 0130 { 1FF 3 ---  2C7 3 ---  09A 3 ---  2FB 3 --- }
7135: 0130 { 08A 3 -y-  096 3 ---  099 3 ---  096 3 x-- }
7136: 0130 { 1AA 3 ---  089 3 ---  1BE 3 ---  08A 3 --- }
7137: 0130 { 16D 2 ---  17D 2 ---  17D 2 ---  0F8 5 --- }
7138: 0130 { 17D 2 x--  0F8 5 ---  16D 2 x--  17D 2 x-- }
7139: 0130 { 17A 2 ---  0F8 5 ---  17B 2 ---  0F8 5 --- }
713A: 0130 { 0F8 5 ---  0F8 5 ---  0F8 5 ---  0F8 5 --- }
713B: 0130 { 0F8 5 ---  0F8 5 ---  0F8 5 ---  0F8 5 --- }
713C: 0130 { 17B 2 x--  0F8 5 ---  17A 2 x--  0F8 5 --- }
713D: 0130 { 180 2 ---  190 2 ---  183 2 ---  193 2 --- }
713E: 0130 { 182 2 ---  192 2 ---  183 2 ---  193 2 --- }
713F: 0130 { 182 2 ---  192 2 ---  180 2 x--  190 2 x-- }
7140: 0130 { 2E1 3 ---  2C7 3 ---  1AA 3 ---  096 3 --- }
7141: 0130 { 1BE 3 ---  096 3 x--  2EB 3 ---  2FB 3 --- }
7142: 0130 { 1FF 3 ---  2C7 3 ---  097 3 ---  096 3 --- }
7143: 0130 { 1BE 3 ---  096 3 x--  2EB 3 ---  2FB 3 --- }
7144: 0130 { 2E1 3 ---  2C7 3 ---  2EB 3 ---  2FB 3 --- }
7145: 0130 { 089 3 ---  08A 3 -y-  08A 3 ---  099 3 --- }
7146: 0130 { 099 3 x--  096 3 x--  08A 3 x--  096 3 --- }
7147: 0130 { 17C 2 ---  0F8 5 ---  17D 2 ---  0F8 5 --- }
7148: 0130 { 17D 2 x--  0F8 5 ---  17C 2 x--  0F8 5 --- }
7149: 0130 { 0F8 5 ---  0F8 5 ---  0F8 5 ---  0F8 5 --- }
714A: 0130 { 0F8 5 ---  168 2 ---  0F8 5 ---  16B 2 --- }
714B: 0130 { 0F8 5 ---  16B 2 x--  0F8 5 ---  168 2 x-- }
714C: 0130 { 19A 2 -y-  19A 2 -y-  19A 2 -y-  19F 2 --- }
714D: 0130 { 184 2 ---  190 2 ---  195 2 ---  193 2 --- }
714E: 0130 { 194 2 ---  192 2 ---  195 2 ---  193 2 --- }
714F: 0130 { 194 2 ---  192 2 ---  184 2 x--  190 2 x-- }
7150: 0130 { 089 3 ---  08A 3 -y-  099 3 ---  097 3 -y- }
7151: 0130 { 099 3 x--  097 3 xy-  089 3 x--  08A 3 xy- }
7152: 0130 { 097 3 x--  096 3 x--  1FF 3 x--  2C7 3 x-- }
7153: 0130 { 0F8 5 ---  2B7 3 ---  2B6 3 ---  2C6 3 --- }
7154: 0130 { 2B6 3 x--  2C6 3 x--  0F8 5 x--  2B7 3 x-- }
7155: 0130 { 089 3 -y-  1A2 3 -y-  08A 3 -y-  1A3 3 -y- }
7156: 0130 { 08A 3 xy-  1A3 3 xy-  089 3 xy-  1A2 3 xy- }
7157: 0130 { 08A 3 x--  099 3 x--  089 3 x--  08A 3 xy- }
7158: 0130 { 1F2 2 ---  0F8 5 ---  1F2 2 x--  0F8 5 --- }
7159: 0130 { 168 2 ---  178 2 ---  16B 2 ---  17B 2 --- }
715A: 0130 { 178 2 ---  0F8 5 ---  17B 2 ---  0F8 5 --- }
715B: 0130 { 17B 2 x--  0F8 5 ---  178 2 x--  0F8 5 --- }
715C: 0130 { 16B 2 x--  17B 2 x--  168 2 x--  178 2 x-- }
715D: 0130 { 190 2 -y-  180 2 -y-  193 2 -y-  183 2 -y- }
715E: 0130 { 192 2 -y-  182 2 -y-  193 2 -y-  183 2 -y- }
715F: 0130 { 192 2 -y-  182 2 -y-  190 2 xy-  180 2 xy- }
7160: 0130 { 089 3 ---  08A 3 -y-  097 3 ---  099 3 --- }
7161: 0130 { 097 3 x--  099 3 x--  089 3 x--  08A 3 xy- }
7162: 0130 { 1A3 3 x--  096 3 ---  1A2 3 x--  096 3 x-- }
7163: 0130 { 1A2 3 ---  089 3 ---  1A3 3 ---  08A 3 --- }
7164: 0130 { 1A3 3 x--  08A 3 x--  1A2 3 x--  089 3 x-- }
7165: 0130 { 2B7 3 -y-  0F8 5 -y-  2C6 3 -y-  2B6 3 -y- }
7166: 0130 { 2C6 3 xy-  2B6 3 xy-  2B7 3 xy-  0F8 5 xy- }
7167: 0130 { 1BE 3 x--  08A 3 x--  1AA 3 x--  089 3 x-- }
7168: 0130 { 08A 3 ---  096 3 ---  099 3 ---  096 3 --- }
7169: 0130 { 1AA 3 ---  089 3 ---  1BE 3 ---  08A 3 --- }
716A: 0130 { 1BE 3 x--  08A 3 x--  1AA 3 x--  089 3 x-- }
716B: 0130 { 19A 2 ---  19A 2 ---  19A 2 ---  19A 2 --- }
716C: 0130 { 18F 2 ---  19A 2 -y-  19A 2 -y-  19A 2 -y- }
716D: 0130 { 0F8 5 x--  0F8 5 x--  0F8 5 x--  0BF 3 x-- }
716E: 0130 { 0AB 3 x--  0BE 3 x--  0AA 3 x--  0BA 3 x-- }
716F: 0130 { 08C 3 x--  09C 3 x--  08B 3 x--  09B 3 x-- }
7170: 0130 { 2E1 3 ---  1FF 3 -y-  1AA 3 ---  089 3 --- }
7171: 0130 { 1AA 3 ---  089 3 ---  1BE 3 ---  08A 3 --- }
7172: 0130 { 1BE 3 ---  08A 3 ---  2EB 3 ---  09A 3 --- }
7173: 0130 { 139 3 --p  13B 3 --p  13A 3 --p  13C 3 --p }
7174: 0130 { 101 3 ---  105 3 ---  102 3 ---  106 3 --- }
7175: 0130 { 103 3 ---  107 3 ---  104 3 ---  1E0 3 --- }
7176: 0130 { 0CD 3 ---  0CD 3 ---  0CD 3 ---  0CD 3 --- }
7177: 0130 { 0F8 5 ---  0CD 3 ---  0CD 3 ---  0CD 3 --- }
7178: 0130 { 0CD 3 ---  0CD 3 ---  0F8 5 ---  0CD 3 --- }
7179: 0130 { 0CD 3 ---  0F8 5 ---  0F8 5 ---  0CD 3 --- }
717A: 0130 { 0F8 5 ---  0CD 3 ---  0CD 3 ---  0F8 5 --- }
717B: 0130 { 19A 2 -y-  19A 2 -y-  19A 2 -y-  19F 2 --- }
717C: 0130 { 194 2 ---  192 2 ---  195 2 ---  193 2 --- }
717D: 0130 { 0F8 5 x--  0E9 3 x--  0B5 3 x--  0E8 3 x-- }
717E: 0130 { 095 3 x--  0E4 3 x--  088 3 x--  0D4 3 x-- }
717F: 0130 { 087 3 x--  0D3 3 x--  086 3 x--  0C4 3 x-- }
7180: 0130 { 164 3 --p  174 3 --p  165 3 --p  175 3 --p }
7181: 0130 { 166 3 --p  176 3 --p  167 3 --p  177 3 --p }
7182: 0130 { 165 3 x-p  175 3 x-p  164 3 x-p  174 3 x-p }
7183: 0130 { 13B 3 -yp  139 3 -yp  13C 3 -yp  13A 3 -yp }
7184: 0130 { 1E1 3 ---  20D 3 ---  1D2 3 ---  21D 3 --- }
7185: 0130 { 254 3 ---  24B 3 ---  1E0 3 ---  25B 3 --- }
7186: 0130 { 0CD 3 ---  0F8 5 ---  0CD 3 ---  0CD 3 --- }
7187: 0130 { 0CD 3 ---  0CD 3 ---  0CD 3 ---  0F8 5 --- }
7188: 0130 { 0F8 5 ---  0CD 3 ---  0F8 5 ---  0F8 5 --- }
7189: 0130 { 0F8 5 ---  0F8 5 ---  0F8 5 ---  0CD 3 --- }
718A: 0130 { 0F8 5 ---  0F8 5 ---  0CD 3 ---  0F8 5 --- }
718B: 0130 { 0CD 3 ---  0F8 5 ---  0F8 5 ---  0F8 5 --- }
718C: 0130 { 18F 2 ---  19A 2 -y-  19A 2 -y-  19A 2 -y- }
718D: 0130 { 1AE 2 ---  1AE 2 ---  1AE 2 ---  1AE 2 --- }
718E: 0130 { 1AE 2 ---  19A 2 -y-  1AE 2 ---  19A 2 -y- }
718F: 0130 { 0F8 5 ---  0B0 5 ---  0F8 5 ---  0B1 5 --- }
7190: 0130 { 170 3 --p  173 3 --p  171 3 --p  173 3 x-p }
7191: 0130 { 172 3 --p  0F8 5 --p  172 3 x-p  0F8 5 --p }
7192: 0130 { 171 3 x-p  173 3 --p  170 3 x-p  173 3 x-p }
7193: 0130 { 2E1 3 ---  1FF 3 ---  1BE 3 ---  099 3 --- }
7194: 0130 { 1BE 3 ---  096 3 x--  2EB 3 ---  2FB 3 --- }
7195: 0130 { 089 3 ---  1A2 3 -y-  097 3 ---  099 3 --- }
7196: 0130 { 2EB 3 x--  09A 3 x--  2E1 3 x--  1FF 3 xy- }
7197: 0130 { 1AA 3 ---  1A3 3 xy-  1BE 3 ---  1A2 3 xy- }
7198: 0130 { 00C 3 -y-  0F8 3 xy-  00C 3 xy-  0F8 3 xy- }
7199: 0130 { 262 3 ---  274 3 ---  263 3 ---  275 3 --- }
719A: 0130 { 264 3 ---  252 3 ---  265 3 ---  253 3 --- }
719B: 0130 { 192 2 ---  182 2 -y-  186 2 x--  183 2 -y- }
719C: 0130 { 186 2 ---  182 2 -y-  193 2 ---  183 2 -y- }
719D: 0130 { 186 2 ---  182 2 -y-  190 2 x--  180 2 xy- }
719E: 0130 { 184 2 ---  190 2 ---  184 2 x--  190 2 x-- }
719F: 0130 { 0C0 5 ---  0D0 5 ---  0C1 5 ---  0D1 5 --- }
71A0: 0130 { 104 3 x--  1E0 3 x--  103 3 x--  107 3 x-- }
71A1: 0130 { 102 3 x--  106 3 x--  101 3 x--  105 3 x-- }
71A2: 0130 { 13A 3 x-p  13C 3 x-p  139 3 x-p  13B 3 x-p }
71A3: 0130 { 1FF 3 ---  2C7 3 ---  09A 3 ---  2FB 3 --- }
71A4: 0130 { 1AA 3 ---  096 3 ---  1BE 3 ---  096 3 --- }
71A5: 0130 { 2EB 3 x--  2FB 3 x--  1BE 3 x--  096 3 --- }
71A6: 0130 { 097 3 x--  096 3 x--  1FF 3 x--  2C7 3 x-- }
71A7: 0130 { 0F8 5 ---  16A 2 ---  0F8 5 ---  169 2 --- }
71A8: 0130 { 16A 2 ---  17A 2 ---  169 2 ---  179 2 --- }
71A9: 0130 { 169 2 x--  179 2 x--  16A 2 x--  17A 2 x-- }
71AA: 0130 { 0F8 5 ---  169 2 x--  0F8 5 ---  16A 2 x-- }
71AB: 0130 { 184 2 ---  190 2 ---  193 2 ---  186 2 xy- }
71AC: 0130 { 192 2 -y-  182 2 -y-  190 2 x--  180 2 xy- }
71AD: 0130 { 186 2 ---  182 2 -y-  190 2 x--  180 2 xy- }
71AE: 0130 { 182 2 ---  192 2 ---  183 2 ---  186 2 xy- }
71AF: 0130 { 2B8 5 ---  2C8 5 ---  2B9 5 ---  2C9 5 --- }
71B0: 0130 { 1E0 3 x--  25B 3 x--  254 3 x--  24B 3 x-- }
71B1: 0130 { 1D2 3 x--  21D 3 x--  1E1 3 x--  20D 3 x-- }
71B2: 0130 { 13C 3 xyp  13A 3 xyp  13B 3 xyp  139 3 xyp }
71B3: 0130 { 1AA 3 ---  1A2 3 -y-  1BE 3 ---  1A3 3 -y- }
71B4: 0130 { 0F8 5 ---  0F8 5 ---  1A1 2 x--  1B1 2 x-- }
71B5: 0130 { 1A1 2 ---  1B1 2 ---  0F8 5 ---  0F8 5 --- }
71B6: 0130 { 089 3 -y-  1A2 3 -y-  09A 3 ---  09A 3 --- }
71B7: 0130 { 17A 2 ---  0F8 5 ---  179 2 ---  0F8 5 --- }
71B8: 0130 { 186 2 ---  192 2 ---  186 2 x--  193 2 --- }
71B9: 0130 { 186 2 ---  192 2 ---  195 2 ---  186 2 xy- }
71BA: 0130 { 179 2 x--  0F8 5 ---  17A 2 x--  0F8 5 --- }
71BB: 0130 { 190 2 -y-  180 2 -y-  190 2 xy-  180 2 xy- }
71BC: 0130 { 192 2 ---  186 2 -y-  184 2 x--  190 2 x-- }
71BD: 0130 { 190 2 ---  186 2 ---  195 2 ---  193 2 --- }
71BE: 0130 { 194 2 ---  192 2 ---  190 2 x--  186 2 x-- }
71BF: 0130 { 192 2 ---  186 2 -y-  186 2 x--  195 2 --- }
71C0: 0130 { 1C3 7 ---  1D3 7 ---  1C4 7 ---  1D4 7 --- }
71C1: 0130 { 1C5 7 ---  1D5 7 ---  1C6 7 ---  1D6 7 --- }
71C2: 0130 { 1C4 7 x--  1D4 7 x--  1C3 7 x--  1D3 7 x-- }
71C3: 0130 { 1FF 3 -y-  1FF 3 ---  089 3 ---  08A 3 -y- }
71C4: 0130 { 08A 3 ---  099 3 ---  09A 3 ---  09A 3 --- }
71C5: 0130 { 1FF 3 -y-  1FF 3 ---  09A 3 ---  09A 3 --- }
71C6: 0130 { 0A0 4 -y-  0F8 5 ---  0A1 4 -y-  0F8 5 --- }
71C7: 0130 { 0A0 7 -yp  0F8 5 ---  0A1 7 -yp  0F8 5 --- }
71C8: 0130 { 205 3 ---  235 3 ---  206 3 ---  236 3 --- }
71C9: 0130 { 194 2 ---  186 2 -y-  195 2 ---  186 2 xy- }
71CA: 0130 { 180 2 ---  190 2 ---  183 2 ---  186 2 xy- }
71CB: 0130 { 186 2 ---  192 2 ---  184 2 x--  190 2 x-- }
71CC: 0130 { 184 2 ---  190 2 ---  195 2 ---  186 2 xy- }
71CD: 0130 { 184 2 ---  190 2 ---  186 2 x--  193 2 --- }
71CE: 0130 { 194 2 ---  182 2 -y-  186 2 x--  183 2 -y- }
71CF: 0130 { 182 2 ---  186 2 -y-  183 2 ---  193 2 --- }
71D0: 0130 { 1E3 7 ---  182 2 ---  1E4 7 ---  183 2 --- }
71D1: 0130 { 1E5 7 ---  182 2 ---  1E6 7 ---  183 2 --- }
71D2: 0130 { 1E4 7 x--  182 2 ---  1E3 7 x--  183 2 --- }
71D3: 0130 { 1E3 7 ---  180 2 ---  1E4 7 ---  183 2 --- }
71D4: 0130 { 1FF 3 -y-  1FF 3 ---  1A2 3 x--  089 3 x-- }
71D5: 0130 { 099 3 ---  182 2 ---  09A 3 ---  183 2 --- }
71D6: 0130 { 1FF 3 ---  182 2 ---  099 3 ---  183 2 --- }
71D7: 0130 { 0F8 5 -y-  0A0 4 ---  0F8 5 -y-  0A1 4 --- }
71D8: 0130 { 0F8 5 -y-  0A0 7 --p  0F8 5 -y-  0A1 7 --p }
71D9: 0130 { 180 2 ---  190 2 ---  180 2 x--  186 2 x-- }
71DA: 0130 { 194 2 ---  194 2 ---  195 2 ---  0CB 2 --- }
71DB: 0130 { 194 2 ---  0CC 2 x--  195 2 ---  193 2 --- }
71DC: 0130 { 194 2 ---  194 2 ---  195 2 ---  0CC 2 --- }
71DD: 0130 { 194 2 ---  0CB 2 ---  195 2 ---  193 2 --- }
71DE: 0130 { 194 2 ---  0CA 2 x--  195 2 ---  0CB 2 xy- }
71DF: 0130 { 194 2 ---  0CC 2 ---  195 2 ---  0CB 2 x-- }
71E0: 0130 { 1AA 3 ---  096 3 ---  1BE 3 ---  096 3 x-- }
71E1: 0130 { 20C 3 ---  21C 3 ---  20C 3 x--  21C 3 x-- }
71E2: 0130 { 1FF 3 -y-  1FF 3 ---  089 3 ---  1A2 3 xy- }
71E3: 0130 { 190 2 -y-  180 2 -y-  190 2 xy-  1FE 2 x-- }
71E4: 0130 { 1A1 2 x--  1B1 2 x--  1AB 2 ---  1BB 2 --- }
71E5: 0130 { 020 6 ---  020 6 ---  021 6 ---  021 6 --- }
71E6: 0130 { 022 6 ---  022 6 ---  023 6 ---  023 6 --- }
71E7: 0130 { 000 6 ---  010 6 ---  001 6 ---  011 6 --- }
71E8: 0130 { 002 6 ---  012 6 ---  003 6 ---  013 6 --- }
71E9: 0130 { 19A 2 -y-  19A 2 -y-  1BF 2 ---  19A 2 -y- }
71EA: 0130 { 0CA 2 ---  0CB 2 x--  195 2 ---  0CA 2 --- }
71EB: 0130 { 195 2 ---  0CB 2 ---  0CC 2 xy-  0CA 2 --- }
71EC: 0130 { 0CB 2 ---  0CC 2 ---  195 2 ---  0CA 2 x-- }
71ED: 0130 { 195 2 ---  0CB 2 x--  0CB 2 xy-  0CA 2 -y- }
71EE: 0130 { 195 2 ---  192 2 ---  0CA 2 x--  0CC 2 --- }
71EF: 0130 { 0CB 2 x--  0CA 2 -y-  195 2 ---  193 2 --- }
71F0: 0130 { 0F8 5 ---  0F8 5 ---  0F8 5 ---  0F8 5 --- }
71F1: 0130 { 20E 3 ---  21E 3 ---  20F 3 ---  21F 3 --- }
71F2: 0130 { 0F8 5 ---  0F8 5 ---  0F8 5 ---  0F8 5 --- }
71F3: 0130 { 190 2 -y-  180 2 -y-  190 2 xy-  1FD 2 --- }
71F4: 0130 { 190 2 -y-  1FE 2 ---  190 2 xy-  180 2 xy- }
71F5: 0130 { 192 2 -y-  182 2 -y-  190 2 xy-  1FE 2 x-- }
71F6: 0130 { 190 2 -y-  1FE 2 ---  193 2 -y-  183 2 -y- }
71F7: 0130 { 0A2 4 ---  0A0 4 -y-  0A3 4 ---  0A1 4 -y- }
71F8: 0130 { 0A2 7 --p  0A0 7 -yp  0A3 7 --p  0A1 7 -yp }
71F9: 0130 { 19A 2 xy-  1BF 2 ---  19A 2 xy-  19A 2 xy- }
71FA: 0130 { 0CB 2 xy-  0CC 2 ---  195 2 ---  193 2 --- }
71FB: 0130 { 194 2 ---  192 2 ---  0CB 2 x--  0CA 2 x-- }
71FC: 0130 { 0CA 2 x--  0CB 2 ---  195 2 ---  193 2 --- }
71FD: 0130 { 194 2 ---  192 2 ---  0CB 2 x--  0CC 2 x-- }
71FE: 0130 { 194 2 ---  192 2 ---  0CB 2 x--  0CA 2 x-- }
71FF: 0130 { 0CB 2 xy-  0CC 2 x--  195 2 ---  193 2 --- }
