3100: 0025 { 20F 2 x-p  21F 2 x-p  20E 2 x-p  21E 2 x-p }
3101: 0025 { 20D 2 x-p  21D 2 x-p  20C 2 x-p  21C 2 x-p }
3102: 0025 { 20C 2 --p  21C 2 --p  20D 2 --p  21D 2 --p }
3103: 0025 { 20E 2 --p  21E 2 --p  20F 2 --p  21F 2 --p }
3104: 0025 { 244 2 ---  254 2 ---  245 2 ---  255 2 --- }
3105: 0130 { 24E 2 ---  25E 2 ---  24F 2 ---  25F 2 --- }
3106: 0025 { 205 3 x--  215 3 x--  217 3 ---  214 3 x-- }
3107: 0025 { 234 3 -y-  214 3 ---  205 3 ---  215 3 --- }
3108: 0025 { 0F8 3 x--  206 3 ---  0F8 3 x--  207 3 --- }
3109: 0025 { 206 3 ---  216 3 ---  207 3 ---  217 3 --- }
310A: 0025 { 207 3 x--  217 3 x--  206 3 x--  216 3 x-- }
310B: 0025 { 0F8 3 x--  207 3 x--  0F8 3 x--  206 3 x-- }
310C: 0025 { 200 5 ---  210 5 ---  201 5 ---  211 5 --- }
310D: 0130 { 0F8 4 x-p  1C1 2 x-p  0F8 4 --p  1C0 2 x-p }
310E: 0025 { 217 3 -y-  237 3 ---  234 3 ---  227 3 --- }
310F: 0025 { 06C 6 ---  06E 6 ---  06D 6 ---  06F 6 --- }
3110: 0025 { 22F 2 x-p  23F 2 x-p  22E 2 x-p  23E 2 x-p }
3111: 0025 { 22D 2 x-p  23D 2 x-p  22C 2 x-p  23C 2 x-p }
3112: 0025 { 22C 2 --p  23C 2 --p  22D 2 --p  23D 2 --p }
3113: 0025 { 22E 2 --p  23E 2 --p  22F 2 --p  23F 2 --p }
3114: 0006 { 246 2 ---  256 2 ---  247 2 ---  257 2 --- }
3115: 0130 { 26E 2 ---  27E 2 ---  26F 2 ---  27F 2 --- }
3116: 0130 { 26C 2 ---  27C 2 ---  26D 2 ---  27D 2 --- }
3117: 0130 { 24C 2 ---  25C 2 ---  24D 2 ---  25D 2 --- }
3118: 0025 { 206 3 -y-  0F8 3 xy-  207 3 -y-  0F8 3 xy- }
3119: 0025 { 216 3 -y-  206 3 -y-  217 3 -y-  207 3 -y- }
311A: 0025 { 217 3 xy-  207 3 xy-  216 3 xy-  206 3 xy- }
311B: 0025 { 207 3 xy-  0F8 3 xy-  206 3 xy-  0F8 3 xy- }
311C: 0025 { 220 5 ---  230 5 ---  221 5 ---  231 5 --- }
311D: 0130 { 1D3 2 x-p  1D3 2 x-p  1D2 2 x-p  1C3 2 x-p }
311E: 0025 { 276 2 --p  277 2 --p  234 2 --p  227 2 --p }
311F: 0025 { 266 2 -yp  217 2 --p  267 2 -yp  234 2 -yp }
3120: 0025 { 20F 3 x--  21F 3 x--  20E 3 x--  21E 3 x-- }
3121: 0025 { 20D 3 x--  21D 3 x--  20C 3 x--  21C 3 x-- }
3122: 0025 { 20C 3 ---  21C 3 ---  20D 3 ---  21D 3 --- }
3123: 0025 { 20E 3 ---  21E 3 ---  20F 3 ---  21F 3 --- }
3124: 0006 { 256 2 ---  256 2 ---  257 2 ---  257 2 --- }
3125: 0130 { 248 2 ---  258 2 ---  249 2 ---  259 2 --- }
3126: 0130 { 24A 2 ---  25A 2 ---  24B 2 ---  25B 2 --- }
3127: 0025 { 276 3 ---  277 3 ---  234 3 ---  227 3 --- }
3128: 0025 { 266 3 -y-  217 3 ---  267 3 -y-  234 3 -y- }
3129: 0025 { 216 3 ---  237 3 ---  234 3 ---  227 3 --- }
312A: 0025 { 217 3 ---  224 3 ---  200 3 ---  210 3 --- }
312B: 0025 { 201 3 ---  211 3 ---  202 3 ---  212 3 --- }
312C: ~
312D: ~
312E: 0025 { 234 2 x-p  227 2 x-p  276 2 x-p  277 2 x-p }
312F: 0025 { 217 2 -yp  266 2 --p  234 2 --p  267 2 --p }
3130: 0025 { 22F 3 x--  23F 3 x--  22E 3 x--  23E 3 x-- }
3131: 0025 { 22D 3 x--  23D 3 x--  22C 3 x--  23C 3 x-- }
3132: 0025 { 22C 3 ---  23C 3 ---  22D 3 ---  23D 3 --- }
3133: 0025 { 22E 3 ---  23E 3 ---  22F 3 ---  23F 3 --- }
3134: ~
3135: 0130 { 268 2 ---  278 2 ---  269 2 ---  279 2 --- }
3136: 0130 { 26A 2 ---  27A 2 ---  26B 2 ---  27B 2 --- }
3137: 0025 { 234 3 x--  227 3 x--  276 3 x--  277 3 x-- }
3138: 0025 { 217 3 -y-  266 3 ---  234 3 ---  267 3 --- }
3139: 0025 { 217 3 -y-  237 3 ---  216 3 x--  227 3 --- }
313A: 0025 { 203 3 ---  213 3 ---  217 3 ---  224 3 --- }
313B: 0025 { 217 3 -y-  237 3 ---  234 3 ---  216 3 xy- }
313C: ~
313D: ~
313E: 0025 { 217 3 -y-  216 3 -y-  234 3 ---  227 3 --- }
313F: ~
3140: 01E2 { 1C0 0 x--  191 0 ---  191 0 ---  191 0 --- }
3141: 01E4 { 191 0 ---  191 0 ---  1C0 0 ---  191 0 --- }
3142: 01E2 { 191 0 -y-  191 0 -y-  1C1 0 ---  191 0 -y- }
3143: 01E4 { 1C1 0 x--  191 0 -y-  191 0 -y-  191 0 -y- }
3144: ~
3145: ~
3146: ~
3147: ~
3148: ~
3149: ~
314A: ~
314B: ~
314C: ~
314D: ~
314E: ~
314F: ~
3150: 01EC { 191 0 ---  1C2 0 xy-  191 0 ---  191 0 --- }
3151: 01ED { 191 0 ---  191 0 ---  191 0 ---  1C2 0 -y- }
3152: ~
3153: ~
3154: ~
3155: ~
3156: ~
3157: ~
3158: ~
3159: ~
315A: ~
315B: ~
315C: ~
315D: ~
315E: ~
315F: ~
3160: 01C4 { 1B2 0 xy-  1A3 0 ---  1C2 0 xy-  1B2 0 xy- }
3161: 01C5 { 1C2 0 -y-  1B2 0 -y-  1B2 0 -y-  1A3 0 --- }
3162: ~
3163: ~
3164: ~
3165: ~
3166: ~
3167: ~
3168: ~
3169: ~
316A: ~
316B: ~
316C: ~
316D: ~
316E: ~
316F: ~
3170: ~
3171: ~
3172: ~
3173: ~
3174: ~
3175: ~
3176: ~
3177: ~
3178: ~
3179: ~
317A: ~
317B: ~
317C: ~
317D: ~
317E: ~
317F: ~
3180: 021F { 004 4 ---  004 4 ---  004 4 ---  004 4 --- }
3181: 021F { 18C 0 ---  1BC 0 ---  18C 0 ---  1BD 0 --- }
3182: 021F { 18C 0 ---  1BE 0 ---  18C 0 ---  1BF 0 --- }
3183: ~
3184: ~
3185: ~
3186: ~
3187: ~
3188: ~
3189: ~
318A: ~
318B: ~
318C: ~
318D: ~
318E: ~
318F: ~
3190: 021F { 18D 0 ---  19D 0 ---  18E 0 ---  19E 0 --- }
3191: 021F { 1CC 0 ---  1DC 0 ---  1CD 0 ---  1DD 0 --- }
3192: 021F { 1CE 0 ---  1DE 0 ---  1CF 0 ---  1DF 0 --- }
3193: ~
3194: ~
3195: ~
3196: ~
3197: ~
3198: ~
3199: ~
319A: ~
319B: ~
319C: ~
319D: ~
319E: ~
319F: ~
31A0: 021F { 1AD 0 ---  18B 0 ---  1AE 0 ---  18C 0 --- }
31A1: 021F { 1EC 0 ---  1FC 0 ---  1ED 0 ---  1FD 0 --- }
31A2: 021F { 1EE 0 ---  1FE 0 ---  1EF 0 ---  1FF 0 --- }
31A3: ~
31A4: ~
31A5: ~
31A6: ~
31A7: ~
31A8: ~
31A9: ~
31AA: ~
31AB: ~
31AC: ~
31AD: ~
31AE: ~
31AF: ~
31B0: 0025 { 0F8 0 ---  280 0 ---  0F8 0 ---  281 0 --- }
31B1: 0025 { 0F8 0 ---  281 0 ---  0F8 0 ---  281 0 --- }
31B2: 0025 { 282 0 ---  2E0 0 ---  283 0 ---  293 0 --- }
31B3: 0025 { 284 0 ---  294 0 ---  285 0 ---  295 0 --- }
31B4: 0025 { 286 0 ---  296 0 ---  287 0 ---  2E1 0 --- }
31B5: 0025 { 0F8 0 ---  280 0 ---  0F8 0 x--  280 0 x-- }
31B6: 0025 { 0F8 0 ---  281 0 ---  0F8 0 x--  280 0 x-- }
31B7: 0130 { 2F0 0 ---  2A0 0 ---  291 0 ---  2A1 0 --- }
31B8: 0130 { 291 0 ---  2A0 0 ---  291 0 ---  2A1 0 --- }
31B9: 0025 { 281 0 ---  2A0 0 ---  280 0 x--  2A1 0 --- }
31BA: ~
31BB: ~
31BC: ~
31BD: ~
31BE: ~
31BF: ~
31C0: 0130 { 290 0 ---  2A0 0 ---  291 0 ---  2A1 0 --- }
31C1: 0130 { 291 0 ---  2A0 0 ---  291 0 ---  2A1 0 --- }
31C2: 0130 { 2A2 0 ---  2B2 0 ---  2A3 0 ---  2B3 0 --- }
31C3: 0130 { 2A4 0 ---  2B4 0 ---  2A5 0 ---  2B5 0 --- }
31C4: 0130 { 2A6 0 ---  2B6 0 ---  2A7 0 ---  2B7 0 --- }
31C5: 0130 { 290 0 ---  2A0 0 ---  290 0 x--  2A0 0 x-- }
31C6: 0130 { 291 0 ---  2A0 0 ---  290 0 x--  2A1 0 --- }
31C7: 0130 { 280 0 ---  2A0 0 ---  281 0 ---  2A1 0 --- }
31C8: 006E { 2EC 6 ---  2FC 6 ---  2ED 6 ---  2FD 6 --- }
31C9: 0130 { 2A4 0 ---  2B4 0 ---  2A5 0 ---  2B5 0 --- }
31CA: ~
31CB: ~
31CC: ~
31CD: ~
31CE: ~
31CF: ~
31D0: 0130 { 2B0 0 ---  2C1 0 ---  2B1 0 ---  2C1 0 x-- }
31D1: 0130 { 2B0 0 ---  2C1 0 ---  2B1 0 ---  2C1 0 x-- }
31D2: 0130 { 2A0 0 ---  2B0 0 ---  2A1 0 ---  2B1 0 --- }
31D3: 0130 { 2C1 0 ---  2D1 0 ---  2C1 0 x--  2D1 0 x-- }
31D4: 0025 { 0A1 0 ---  0F8 0 x--  0F8 0 x--  0F8 0 x-- }
31D5: 0025 { 0F8 0 x--  0F8 0 x--  0A1 0 x--  0F8 0 x-- }
31D6: 0130 { 2CC 4 ---  2DC 4 ---  2CC 4 x--  2DD 4 --- }
31D7: 0130 { 281 0 ---  2A0 0 ---  281 0 ---  2A1 0 --- }
31D8: 0130 { 2F0 0 ---  2A0 0 ---  291 0 ---  2A1 0 --- }
31D9: 0025 { 0F8 0 ---  280 0 ---  0F8 0 x--  280 0 x-- }
31DA: ~
31DB: ~
31DC: ~
31DD: ~
31DE: ~
31DF: ~
31E0: 0025 { 2D1 0 ---  0F8 0 ---  2D1 0 x--  0F8 0 x-- }
31E1: 0025 { 2D1 0 ---  0F8 0 ---  2D1 0 x--  0F8 0 x-- }
31E2: 0025 { 0A0 0 x--  0A1 0 ---  0A0 0 ---  0F8 0 x-- }
31E3: 0025 { 0A0 0 x--  0F8 0 ---  2D1 0 x--  0F8 0 x-- }
31E4: 0025 { 2D1 0 ---  0F8 0 ---  0A0 0 ---  0F8 0 x-- }
31E5: 0025 { 2D1 0 ---  0A1 0 ---  2D1 0 x--  0F8 0 x-- }
31E6: 0025 { 2D1 0 ---  0F8 0 x--  2D1 0 x--  0A1 0 x-- }
31E7: 0130 { 291 0 ---  2A0 0 ---  2F1 0 ---  2A1 0 --- }
31E8: 0130 { 2F0 0 ---  2A0 0 ---  290 0 x--  2A1 0 --- }
31E9: 0130 { 290 0 ---  2A0 0 ---  2F1 0 ---  2A1 0 --- }
31EA: ~
31EB: ~
31EC: ~
31ED: ~
31EE: ~
31EF: ~
31F0: 0025 { 0A0 0 x--  0A1 0 ---  2D1 0 x--  0F8 0 x-- }
31F1: 0025 { 2D1 0 ---  0F8 0 ---  0A0 0 ---  0A1 0 --- }
31F2: 0130 { 2B0 0 ---  2B0 0 ---  2B1 0 ---  2B1 0 --- }
31F3: 0130 { 2EA 0 ---  2FA 0 ---  2EB 0 ---  2FB 0 --- }
31F4: 0025 { 2B0 0 ---  2C1 0 ---  2B1 0 ---  2C1 0 x-- }
31F5: 0106 { 290 0 ---  2A0 0 ---  291 0 ---  2A1 0 --- }
31F6: 0106 { 291 0 ---  2A0 0 ---  290 0 x--  2A1 0 --- }
31F7: 0025 { 2B0 0 ---  280 0 ---  2B1 0 ---  281 0 --- }
31F8: 0130 { 2B0 0 ---  281 0 ---  2B1 0 ---  280 0 x-- }
31F9: 0106 { 291 0 ---  2A0 0 ---  291 0 ---  2A1 0 --- }
31FA: 0130 { 2A4 0 ---  2B4 0 ---  2A5 0 ---  2B5 0 --- }
31FB: ~
31FC: ~
31FD: ~
31FE: ~
31FF: ~
