1900: 0020 { 0D3 0 x--  0E3 0 x--  0D2 0 x--  0E2 0 x-- }
1901: 0020 { 0D2 0 ---  0E2 0 ---  0D3 0 ---  0E3 0 --- }
1902: 0020 { 0D3 0 x--  0E3 0 x--  0D2 0 x--  0E2 0 x-- }
1903: 0020 { 0D2 0 ---  0E2 0 ---  0D3 0 ---  0E3 0 --- }
1904: 0020 { 0D3 0 x--  0E3 0 x--  0D2 0 x--  0E2 0 x-- }
1905: 0020 { 0D2 0 ---  0E2 0 ---  0D3 0 ---  0E3 0 --- }
1906: 0020 { 0D3 0 x--  0E3 0 x--  0D2 0 x--  0E2 0 x-- }
1907: 0020 { 0D2 0 ---  0E2 0 ---  0D3 0 ---  0E3 0 --- }
1908: 0020 { 0D3 0 x--  0E3 0 x--  0D2 0 x--  0E2 0 x-- }
1909: 0020 { 0D2 0 ---  0E2 0 ---  0D3 0 ---  0E3 0 --- }
190A: 0020 { 0D3 0 x--  0E3 0 x--  0D2 0 x--  0E2 0 x-- }
190B: 0020 { 0D2 0 ---  0E2 0 ---  0D3 0 ---  0E3 0 --- }
190C: 0020 { 0D3 0 x--  0E3 0 x--  0D2 0 x--  0E2 0 x-- }
190D: 0020 { 0D2 0 ---  0E2 0 ---  0D3 0 ---  0E3 0 --- }
190E: 0020 { 0D3 0 x--  0E3 0 x--  0D2 0 x--  0E2 0 x-- }
190F: 0020 { 0D2 0 ---  0E2 0 ---  0D3 0 ---  0E3 0 --- }
1910: 0020 { 0F3 0 x--  0F3 0 xy-  0F2 0 x--  0F2 0 xy- }
1911: 0020 { 0F2 0 ---  0F2 0 -y-  0F3 0 ---  0F3 0 -y- }
1912: 0020 { 0F3 0 x--  0F3 0 xy-  0F2 0 x--  0F2 0 xy- }
1913: 0020 { 0F2 0 ---  0F2 0 -y-  0F3 0 ---  0F3 0 -y- }
1914: 0020 { 0F3 0 x--  0F3 0 xy-  0F2 0 x--  0F2 0 xy- }
1915: 0020 { 0F2 0 ---  0F2 0 -y-  0F3 0 ---  0F3 0 -y- }
1916: 0020 { 0F3 0 x--  0F3 0 xy-  0F2 0 x--  0F2 0 xy- }
1917: 0020 { 0F2 0 ---  0F2 0 -y-  0F3 0 ---  0F3 0 -y- }
1918: 0020 { 0F3 0 x--  0F3 0 xy-  0F2 0 x--  0F2 0 xy- }
1919: 0020 { 0F2 0 ---  0F2 0 -y-  0F3 0 ---  0F3 0 -y- }
191A: 0020 { 0F3 0 x--  0F3 0 xy-  0F2 0 x--  0F2 0 xy- }
191B: 0020 { 0F2 0 ---  0F2 0 -y-  0F3 0 ---  0F3 0 -y- }
191C: 0020 { 0F3 0 x--  0F3 0 xy-  0F2 0 x--  0F2 0 xy- }
191D: 0020 { 0F2 0 ---  0F2 0 -y-  0F3 0 ---  0F3 0 -y- }
191E: 0020 { 0F3 0 x--  0F3 0 xy-  0F2 0 x--  0F2 0 xy- }
191F: 0020 { 0F2 0 ---  0F2 0 -y-  0F3 0 ---  0F3 0 -y- }
1920: 0020 { 0E3 0 xy-  0D3 0 xy-  0E2 0 xy-  0D2 0 xy- }
1921: 0020 { 0E2 0 -y-  0D2 0 -y-  0E3 0 -y-  0D3 0 -y- }
1922: 0020 { 0E3 0 xy-  0D3 0 xy-  0E2 0 xy-  0D2 0 xy- }
1923: 0020 { 0E2 0 -y-  0D2 0 -y-  0E3 0 -y-  0D3 0 -y- }
1924: 0020 { 0E3 0 xy-  0D3 0 xy-  0E2 0 xy-  0D2 0 xy- }
1925: 0020 { 0E2 0 -y-  0D2 0 -y-  0E3 0 -y-  0D3 0 -y- }
1926: 0020 { 0E3 0 xy-  0D3 0 xy-  0E2 0 xy-  0D2 0 xy- }
1927: 0020 { 0E2 0 -y-  0D2 0 -y-  0E3 0 -y-  0D3 0 -y- }
1928: 0020 { 0E3 0 xy-  0D3 0 xy-  0E2 0 xy-  0D2 0 xy- }
1929: 0020 { 0E2 0 -y-  0D2 0 -y-  0E3 0 -y-  0D3 0 -y- }
192A: 0020 { 0E3 0 xy-  0D3 0 xy-  0E2 0 xy-  0D2 0 xy- }
192B: 0020 { 0E2 0 -y-  0D2 0 -y-  0E3 0 -y-  0D3 0 -y- }
192C: 0020 { 0E3 0 xy-  0D3 0 xy-  0E2 0 xy-  0D2 0 xy- }
192D: 0020 { 0E2 0 -y-  0D2 0 -y-  0E3 0 -y-  0D3 0 -y- }
192E: 0020 { 0E3 0 xy-  0D3 0 xy-  0E2 0 xy-  0D2 0 xy- }
192F: 0020 { 0E2 0 -y-  0D2 0 -y-  0E3 0 -y-  0D3 0 -y- }
1930: 0020 { 0D3 0 x--  0E3 0 x--  0D2 0 x--  0E2 0 x-- }
1931: 0020 { 0D2 0 ---  0E2 0 ---  0D3 0 ---  0E3 0 --- }
1932: 0020 { 0D3 0 x--  0E3 0 x--  0D2 0 x--  0E2 0 x-- }
1933: 0020 { 0D2 0 ---  0E2 0 ---  0D3 0 ---  0E3 0 --- }
1934: 0020 { 0D3 0 x--  0E3 0 x--  0D2 0 x--  0E2 0 x-- }
1935: 0020 { 0D2 0 ---  0E2 0 ---  0D3 0 ---  0E3 0 --- }
1936: 0020 { 0D3 0 x--  0E3 0 x--  0D2 0 x--  0E2 0 x-- }
1937: 0020 { 0D2 0 ---  0E2 0 ---  0D3 0 ---  0E3 0 --- }
1938: 0020 { 0D3 0 x--  0E3 0 x--  0D2 0 x--  0E2 0 x-- }
1939: 0020 { 0D2 0 ---  0E2 0 ---  0D3 0 ---  0E3 0 --- }
193A: 0020 { 0D3 0 x--  0E3 0 x--  0D2 0 x--  0E2 0 x-- }
193B: 0020 { 0D2 0 ---  0E2 0 ---  0D3 0 ---  0E3 0 --- }
193C: 0020 { 0D3 0 x--  0E3 0 x--  0D2 0 x--  0E2 0 x-- }
193D: 0020 { 0D2 0 ---  0E2 0 ---  0D3 0 ---  0E3 0 --- }
193E: 0020 { 0D3 0 x--  0E3 0 x--  0D2 0 x--  0E2 0 x-- }
193F: 0020 { 0D2 0 ---  0E2 0 ---  0D3 0 ---  0E3 0 --- }
1940: 0020 { 0F3 0 x--  0F3 0 xy-  0F2 0 x--  0F2 0 xy- }
1941: 0020 { 0F2 0 ---  0F2 0 -y-  0F3 0 ---  0F3 0 -y- }
1942: 0020 { 0F3 0 x--  0F3 0 xy-  0F2 0 x--  0F2 0 xy- }
1943: 0020 { 0F2 0 ---  0F2 0 -y-  0F3 0 ---  0F3 0 -y- }
1944: 0020 { 0F3 0 x--  0F3 0 xy-  0F2 0 x--  0F2 0 xy- }
1945: 0020 { 0F2 0 ---  0F2 0 -y-  0F3 0 ---  0F3 0 -y- }
1946: 0020 { 0F3 0 x--  0F3 0 xy-  0F2 0 x--  0F2 0 xy- }
1947: 0020 { 0F2 0 ---  0F2 0 -y-  0F3 0 ---  0F3 0 -y- }
1948: 0020 { 0F3 0 x--  0F3 0 xy-  0F2 0 x--  0F2 0 xy- }
1949: 0020 { 0F2 0 ---  0F2 0 -y-  0F3 0 ---  0F3 0 -y- }
194A: 0020 { 0F3 0 x--  0F3 0 xy-  0F2 0 x--  0F2 0 xy- }
194B: 0020 { 0F2 0 ---  0F2 0 -y-  0F3 0 ---  0F3 0 -y- }
194C: 0020 { 0F3 0 x--  0F3 0 xy-  0F2 0 x--  0F2 0 xy- }
194D: 0020 { 0F2 0 ---  0F2 0 -y-  0F3 0 ---  0F3 0 -y- }
194E: 0020 { 0F3 0 x--  0F3 0 xy-  0F2 0 x--  0F2 0 xy- }
194F: 0020 { 0F2 0 ---  0F2 0 -y-  0F3 0 ---  0F3 0 -y- }
1950: 0020 { 0E3 0 xy-  0D3 0 xy-  0E2 0 xy-  0D2 0 xy- }
1951: 0020 { 0E2 0 -y-  0D2 0 -y-  0E3 0 -y-  0D3 0 -y- }
1952: 0020 { 0E3 0 xy-  0D3 0 xy-  0E2 0 xy-  0D2 0 xy- }
1953: 0020 { 0E2 0 -y-  0D2 0 -y-  0E3 0 -y-  0D3 0 -y- }
1954: 0020 { 0E3 0 xy-  0D3 0 xy-  0E2 0 xy-  0D2 0 xy- }
1955: 0020 { 0E2 0 -y-  0D2 0 -y-  0E3 0 -y-  0D3 0 -y- }
1956: 0020 { 0E3 0 xy-  0D3 0 xy-  0E2 0 xy-  0D2 0 xy- }
1957: 0020 { 0E2 0 -y-  0D2 0 -y-  0E3 0 -y-  0D3 0 -y- }
1958: 0020 { 0E3 0 xy-  0D3 0 xy-  0E2 0 xy-  0D2 0 xy- }
1959: 0020 { 0E2 0 -y-  0D2 0 -y-  0E3 0 -y-  0D3 0 -y- }
195A: 0020 { 0E3 0 xy-  0D3 0 xy-  0E2 0 xy-  0D2 0 xy- }
195B: 0020 { 0E2 0 -y-  0D2 0 -y-  0E3 0 -y-  0D3 0 -y- }
195C: 0020 { 0E3 0 xy-  0D3 0 xy-  0E2 0 xy-  0D2 0 xy- }
195D: 0020 { 0E2 0 -y-  0D2 0 -y-  0E3 0 -y-  0D3 0 -y- }
195E: 0020 { 0E3 0 xy-  0D3 0 xy-  0E2 0 xy-  0D2 0 xy- }
195F: 0020 { 0E2 0 -y-  0D2 0 -y-  0E3 0 -y-  0D3 0 -y- }
1960: 0020 { 0D3 0 x--  0E3 0 x--  0D2 0 x--  0E2 0 x-- }
1961: 0020 { 0D2 0 ---  0E2 0 ---  0D3 0 ---  0E3 0 --- }
1962: 0020 { 0D3 0 x--  0E3 0 x--  0D2 0 x--  0E2 0 x-- }
1963: 0020 { 0D2 0 ---  0E2 0 ---  0D3 0 ---  0E3 0 --- }
1964: ~
1965: ~
1966: ~
1967: ~
1968: ~
1969: ~
196A: ~
196B: ~
196C: ~
196D: ~
196E: ~
196F: ~
1970: 0020 { 0F3 0 x--  0F3 0 xy-  0F2 0 x--  0F2 0 xy- }
1971: 0020 { 0F2 0 ---  0F2 0 -y-  0F3 0 ---  0F3 0 -y- }
1972: 0020 { 0F3 0 x--  0F3 0 xy-  0F2 0 x--  0F2 0 xy- }
1973: 0020 { 0F2 0 ---  0F2 0 -y-  0F3 0 ---  0F3 0 -y- }
1974: ~
1975: ~
1976: ~
1977: ~
1978: ~
1979: ~
197A: ~
197B: ~
197C: ~
197D: ~
197E: ~
197F: ~
1980: 0020 { 0E3 0 xy-  0D3 0 xy-  0E2 0 xy-  0D2 0 xy- }
1981: 0020 { 0E2 0 -y-  0D2 0 -y-  0E3 0 -y-  0D3 0 -y- }
1982: 0020 { 0E3 0 xy-  0D3 0 xy-  0E2 0 xy-  0D2 0 xy- }
1983: 0020 { 0E2 0 -y-  0D2 0 -y-  0E3 0 -y-  0D3 0 -y- }
1984: ~
1985: ~
1986: ~
1987: ~
1988: ~
1989: ~
198A: ~
198B: ~
198C: ~
198D: ~
198E: ~
198F: ~
1990: ~
1991: ~
1992: ~
1993: ~
1994: ~
1995: ~
1996: ~
1997: ~
1998: ~
1999: ~
199A: ~
199B: ~
199C: ~
199D: ~
199E: ~
199F: ~
19A0: ~
19A1: ~
19A2: ~
19A3: ~
19A4: ~
19A5: ~
19A6: ~
19A7: ~
19A8: ~
19A9: ~
19AA: ~
19AB: ~
19AC: ~
19AD: ~
19AE: ~
19AF: ~
19B0: ~
19B1: ~
19B2: ~
19B3: ~
19B4: ~
19B5: ~
19B6: ~
19B7: ~
19B8: ~
19B9: ~
19BA: ~
19BB: ~
19BC: ~
19BD: ~
19BE: ~
19BF: ~
19C0: ~
19C1: ~
19C2: ~
19C3: ~
19C4: ~
19C5: ~
19C6: ~
19C7: ~
19C8: ~
19C9: ~
19CA: ~
19CB: ~
19CC: ~
19CD: ~
19CE: ~
19CF: ~
19D0: ~
19D1: ~
19D2: ~
19D3: ~
19D4: ~
19D5: ~
19D6: ~
19D7: ~
19D8: ~
19D9: ~
19DA: ~
19DB: ~
19DC: ~
19DD: ~
19DE: ~
19DF: ~
19E0: ~
19E1: ~
19E2: ~
19E3: ~
19E4: ~
19E5: ~
19E6: ~
19E7: ~
19E8: ~
19E9: ~
19EA: ~
19EB: ~
19EC: ~
19ED: ~
19EE: ~
19EF: ~
19F0: ~
19F1: ~
19F2: ~
19F3: ~
19F4: ~
19F5: ~
19F6: ~
19F7: ~
19F8: ~
19F9: ~
19FA: ~
19FB: ~
19FC: ~
19FD: ~
19FE: ~
19FF: 0025 { 0F8 4 ---  0F8 4 ---  0F8 4 ---  0F8 4 --- }
