7900: 0130 { 200 3 ---  216 3 ---  201 3 ---  217 3 --- }
7901: 0130 { 202 1 ---  218 2 ---  203 1 ---  219 1 --- }
7902: 0130 { 204 1 ---  21A 3 ---  205 1 ---  21B 3 --- }
7903: 0130 { 206 1 ---  21C 1 ---  207 1 ---  21D 1 --- }
7904: 0130 { 209 3 ---  21F 3 ---  20A 1 ---  220 3 --- }
7905: 0130 { 20B 1 ---  221 1 ---  20C 1 ---  222 2 --- }
7906: 0130 { 20D 1 ---  223 1 ---  20E 1 ---  224 1 --- }
7907: 0130 { 211 1 ---  227 3 ---  212 3 ---  228 2 --- }
7908: 0130 { 213 3 ---  229 3 ---  211 1 x--  22A 0 --- }
7909: 0130 { 214 1 ---  22B 0 ---  215 1 ---  22C 1 --- }
790A: ~
790B: ~
790C: ~
790D: ~
790E: ~
790F: ~
7910: 0130 { 22D 3 ---  22D 3 ---  22E 3 ---  244 3 --- }
7911: 0130 { 22F 0 ---  245 0 ---  230 2 ---  246 0 --- }
7912: 0130 { 231 3 ---  247 0 ---  232 3 ---  248 1 --- }
7913: 0130 { 233 3 ---  249 1 ---  234 3 ---  24A 3 --- }
7914: 0130 { 236 3 ---  24C 1 ---  237 3 ---  24D 2 --- }
7915: 0130 { 238 2 ---  24E 0 ---  239 2 ---  24F 0 --- }
7916: 0130 { 23A 2 ---  250 0 ---  23B 0 ---  251 3 --- }
7917: 0130 { 23E 3 ---  254 3 ---  23F 3 ---  255 3 --- }
7918: 0130 { 240 3 ---  256 0 ---  241 0 ---  257 0 --- }
7919: 0130 { 242 1 ---  258 0 ---  243 0 ---  259 0 --- }
791A: ~
791B: ~
791C: ~
791D: ~
791E: ~
791F: ~
7920: 0130 { 22D 3 ---  26D 3 ---  25A 3 ---  26E 3 --- }
7921: 0130 { 25B 0 ---  26F 3 ---  25C 0 ---  26F 3 --- }
7922: 0130 { 25D 0 ---  270 3 ---  25E 1 ---  26F 3 --- }
7923: 0130 { 25F 1 ---  26F 3 ---  260 3 ---  271 3 --- }
7924: 0130 { 261 0 ---  26F 3 ---  262 0 ---  26F 3 --- }
7925: 0130 { 263 0 ---  272 3 ---  264 0 ---  26F 3 --- }
7926: 0130 { 265 0 ---  26F 3 ---  266 0 ---  271 3 --- }
7927: 0130 { 267 2 ---  26F 3 ---  268 1 ---  26F 3 --- }
7928: 0130 { 269 0 ---  275 3 ---  26A 0 ---  26F 3 --- }
7929: 0130 { 26B 0 ---  26F 3 ---  26C 0 ---  276 3 --- }
792A: ~
792B: ~
792C: ~
792D: ~
792E: ~
792F: ~
7930: 0130 { 202 3 ---  223 0 ---  203 3 ---  224 3 --- }
7931: 0130 { 204 2 ---  225 3 ---  205 2 ---  226 3 --- }
7932: 0130 { 206 3 ---  227 2 ---  207 3 ---  228 2 --- }
7933: 0130 { 20A 3 ---  22B 3 ---  20B 0 ---  22C 3 --- }
7934: 0130 { 20C 0 ---  22D 2 ---  20D 0 ---  22E 3 --- }
7935: 0130 { 20E 0 ---  22F 3 ---  20F 0 ---  230 3 --- }
7936: 0130 { 212 1 ---  232 1 ---  213 1 ---  233 1 --- }
7937: 0130 { 214 1 ---  234 1 ---  215 0 ---  235 0 --- }
7938: 0130 { 216 3 ---  236 0 ---  217 3 ---  237 3 --- }
7939: 0130 { 218 3 ---  238 2 ---  219 0 ---  239 2 --- }
793A: 0130 { 20C 0 ---  23A 2 ---  20D 0 ---  23B 2 --- }
793B: 0130 { 21A 0 ---  23C 2 ---  20F 0 ---  230 3 --- }
793C: 0130 { 21D 3 ---  23D 2 ---  203 3 ---  23E 2 --- }
793D: 0130 { 21E 2 ---  23F 2 ---  21F 2 ---  240 2 --- }
793E: 0130 { 220 3 ---  241 2 ---  221 3 ---  242 2 --- }
793F: ~
7940: 0130 { 243 1 ---  265 1 ---  244 1 ---  266 1 --- }
7941: 0130 { 245 0 ---  267 0 ---  246 0 ---  268 0 --- }
7942: 0130 { 247 0 ---  269 0 ---  248 3 ---  26A 2 --- }
7943: 0130 { 24B 2 ---  26D 2 ---  24C 2 ---  26E 1 --- }
7944: 0130 { 24D 2 ---  26F 2 ---  24E 2 ---  270 3 --- }
7945: 0130 { 24F 2 ---  271 3 ---  250 2 ---  272 2 --- }
7946: 0130 { 252 2 ---  273 2 ---  253 2 ---  274 2 --- }
7947: 0130 { 254 2 ---  275 0 ---  255 0 ---  276 2 --- }
7948: 0130 { 256 0 ---  277 0 ---  257 2 ---  278 3 --- }
7949: 0130 { 258 2 ---  279 2 ---  259 2 ---  27A 2 --- }
794A: 0130 { 25A 2 ---  27B 2 ---  25B 2 ---  27C 2 --- }
794B: 0130 { 25C 2 ---  27D 0 ---  25D 3 ---  27E 3 --- }
794C: 0130 { 25E 2 ---  27F 0 ---  25F 2 ---  280 0 --- }
794D: 0130 { 260 2 ---  281 3 ---  261 2 ---  282 2 --- }
794E: 0130 { 262 2 ---  283 2 ---  263 2 ---  284 2 --- }
794F: ~
7950: 0130 { 286 0 ---  2AA 3 ---  287 0 ---  2AA 3 --- }
7951: 0130 { 288 0 ---  2AB 3 ---  289 0 ---  2AA 3 --- }
7952: 0130 { 28A 3 ---  2AA 3 ---  28B 2 ---  2AC 3 --- }
7953: 0130 { 28E 3 ---  2AF 3 ---  28F 0 ---  2B0 0 --- }
7954: 0130 { 290 0 ---  2B1 0 ---  291 3 ---  2B2 3 --- }
7955: 0130 { 292 3 ---  2B3 3 ---  293 3 ---  2B4 3 --- }
7956: 0130 { 294 0 ---  2B7 3 ---  295 1 ---  2B8 3 --- }
7957: 0130 { 296 1 ---  2B9 0 ---  297 0 ---  2BA 0 --- }
7958: 0130 { 298 0 ---  2BB 0 ---  299 2 ---  2BC 3 --- }
7959: 0130 { 29C 0 ---  2BF 3 ---  29D 0 ---  2C0 3 --- }
795A: 0130 { 29E 0 ---  2C1 3 ---  29F 3 ---  2C2 3 --- }
795B: 0130 { 2A0 3 ---  2C3 3 ---  2A1 0 ---  2C4 3 --- }
795C: 0130 { 2A2 2 ---  2AA 3 ---  2A3 2 ---  2AA 3 --- }
795D: 0130 { 2A4 2 ---  2C6 3 ---  2A5 2 ---  2AA 3 --- }
795E: 0130 { 2A6 2 ---  2AA 3 ---  2A7 2 ---  2C7 3 --- }
795F: ~
7960: 0130 { 0F8 4 ---  0F8 4 ---  0F8 4 ---  0F8 4 --- }
7961: 0130 { 0F8 4 ---  0F8 4 ---  0F8 4 ---  0F8 4 --- }
7962: 0130 { 208 1 ---  229 1 ---  209 1 ---  22A 1 --- }
7963: 0130 { 0F8 4 ---  0F8 4 ---  0F8 4 ---  0F8 4 --- }
7964: 0130 { 0F8 4 ---  0F8 4 ---  0F8 4 ---  0F8 4 --- }
7965: 0130 { 210 1 ---  231 0 ---  211 1 ---  222 0 --- }
7966: 0130 { 0F8 4 ---  0F8 4 ---  0F8 4 ---  0F8 4 --- }
7967: 0130 { 0F8 4 ---  0F8 4 ---  0F8 4 ---  0F8 4 --- }
7968: 0130 { 208 1 ---  229 1 ---  209 1 ---  22A 1 --- }
7969: 0130 { 0F8 4 ---  0F8 4 ---  0F8 4 ---  0F8 4 --- }
796A: 0130 { 0F8 4 ---  0F8 4 ---  0F8 4 ---  0F8 4 --- }
796B: 0130 { 21B 0 ---  21B 0 ---  21C 3 ---  222 0 --- }
796C: 0130 { 0F8 4 ---  0F8 4 ---  0F8 4 ---  0F8 4 --- }
796D: 0130 { 0F8 4 ---  0F8 4 ---  0F8 4 ---  0F8 4 --- }
796E: 0130 { 200 3 ---  21B 0 ---  201 3 ---  222 0 --- }
796F: ~
7970: 0130 { 0F8 4 ---  0F8 4 ---  0F8 4 ---  0F8 4 --- }
7971: 0130 { 0F8 4 ---  0F8 4 ---  0F8 4 ---  0F8 4 --- }
7972: 0130 { 249 1 ---  26B 1 ---  24A 1 ---  26C 1 --- }
7973: 0130 { 0F8 4 ---  0F8 4 ---  0F8 4 ---  0F8 4 --- }
7974: 0130 { 0F8 4 ---  0F8 4 ---  0F8 4 ---  0F8 4 --- }
7975: 0130 { 231 0 ---  231 0 ---  251 3 ---  251 3 --- }
7976: 0130 { 0F8 4 ---  0F8 4 ---  0F8 4 ---  0F8 4 --- }
7977: 0130 { 0F8 4 ---  0F8 4 ---  0F8 4 ---  0F8 4 --- }
7978: 0130 { 229 1 ---  229 1 ---  0D3 1 ---  0D3 1 --- }
7979: 0130 { 0F8 4 ---  0F8 4 ---  0F8 4 ---  0F8 4 --- }
797A: 0130 { 0F8 4 ---  0F8 4 ---  0F8 4 ---  0F8 4 --- }
797B: 0130 { 21B 0 ---  21B 0 ---  222 0 ---  222 0 --- }
797C: 0130 { 0F8 4 ---  0F8 4 ---  0F8 4 ---  0F8 4 --- }
797D: 0130 { 0F8 4 ---  0F8 4 ---  0F8 4 ---  0F8 4 --- }
797E: 0130 { 21B 0 ---  21B 0 ---  222 0 ---  264 3 --- }
797F: ~
7980: 0130 { 0F8 4 ---  0F8 4 ---  0F8 4 ---  0F8 4 --- }
7981: 0130 { 0F8 4 ---  0F8 4 ---  0F8 4 ---  0F8 4 --- }
7982: 0130 { 28C 1 ---  2AD 1 ---  28D 1 ---  2AE 1 --- }
7983: 0130 { 0F8 4 ---  0F8 4 ---  0F8 4 ---  0F8 4 --- }
7984: 0130 { 0F8 4 ---  0F8 4 ---  0F8 4 ---  0F8 4 --- }
7985: 0130 { 231 0 ---  2B5 1 ---  251 3 ---  2B6 3 --- }
7986: 0130 { 0F8 4 ---  0F8 4 ---  0F8 4 ---  0F8 4 --- }
7987: 0130 { 0F8 4 ---  0F8 4 ---  0F8 4 ---  0F8 4 --- }
7988: 0130 { 29A 1 ---  2BD 1 ---  29B 1 ---  2BE 1 --- }
7989: 0130 { 0F8 4 ---  0F8 4 ---  0F8 4 ---  0F8 4 --- }
798A: 0130 { 0F8 4 ---  0F8 4 ---  0F8 4 ---  0F8 4 --- }
798B: 0130 { 21B 0 ---  2C5 1 ---  285 3 ---  2A9 3 --- }
798C: 0130 { 0F8 4 ---  0F8 4 ---  0F8 4 ---  0F8 4 --- }
798D: 0130 { 0F8 4 ---  0F8 4 ---  0F8 4 ---  0F8 4 --- }
798E: 0130 { 21B 0 ---  2A8 1 ---  285 3 ---  2A9 3 --- }
798F: ~
7990: 0025 { 000 5 --p  036 5 --p  001 5 --p  037 5 --p }
7991: 0025 { 002 5 --p  038 5 --p  003 5 --p  039 5 --p }
7992: 0025 { 004 5 --p  03A 5 --p  005 5 --p  03B 5 --p }
7993: 0025 { 006 5 --p  03C 5 --p  178 0 --p  03D 5 --p }
7994: 0025 { 007 4 --p  03E 4 --p  008 4 --p  03F 4 --p }
7995: 0025 { 009 4 --p  040 4 --p  00A 4 --p  041 4 --p }
7996: 0025 { 00B 4 --p  042 4 --p  00C 4 --p  043 4 --p }
7997: 0025 { 00D 4 --p  044 4 --p  178 0 --p  045 4 --p }
7998: 0025 { 00E 4 --p  046 4 --p  00F 4 --p  047 4 --p }
7999: 0025 { 010 6 --p  048 4 --p  011 4 --p  049 4 --p }
799A: 0025 { 012 4 --p  04A 4 --p  013 4 --p  04B 4 --p }
799B: 0025 { 014 4 --p  04C 4 --p  178 0 --p  178 0 --p }
799C: 0025 { 015 6 --p  04D 6 --p  016 6 --p  04E 6 --p }
799D: 0025 { 017 4 --p  04F 6 --p  018 4 --p  050 6 --p }
799E: 0025 { 019 4 --p  051 6 --p  01A 4 --p  052 4 --p }
799F: ~
79A0: 0105 { 071 4 --p  178 0 --p  072 4 --p  1E3 4 --p }
79A1: 0105 { 073 5 --p  1E4 4 --p  074 5 --p  1E5 4 --p }
79A2: 0105 { 075 5 --p  1E5 4 --p  076 5 --p  1E5 4 --p }
79A3: 0105 { 077 5 --p  1E6 4 --p  078 5 --p  1E7 4 --p }
79A4: 0105 { 079 4 --p  178 0 --p  07A 4 --p  1E3 4 --p }
79A5: 0105 { 07B 4 --p  1E4 4 --p  07C 6 --p  1E5 4 --p }
79A6: 0105 { 07D 4 --p  1E8 4 --p  07E 4 --p  1E9 5 --p }
79A7: 0105 { 07F 4 --p  1E6 4 --p  1C0 4 --p  1EA 4 --p }
79A8: 0105 { 1C1 4 --p  1EB 4 --p  1C2 4 --p  1EC 4 --p }
79A9: 0105 { 1C3 4 --p  1ED 4 --p  1C3 4 --p  1ED 4 --p }
79AA: 0105 { 1C3 4 --p  1ED 4 --p  1C3 4 --p  1ED 4 --p }
79AB: 0105 { 1C3 4 --p  1EE 4 --p  1C4 4 --p  1EF 4 --p }
79AC: 0105 { 1C5 6 --p  1F0 4 --p  1C6 6 --p  1F1 4 --p }
79AD: 0105 { 1C7 6 --p  1F2 4 --p  1C8 6 --p  1F3 4 --p }
79AE: 0105 { 1C9 6 --p  1F4 4 --p  178 0 --p  1F5 4 --p }
79AF: ~
79B0: 0025 { 01B 4 --p  053 4 --p  01C 4 --p  054 4 --p }
79B1: 0025 { 01D 4 --p  055 4 --p  01E 4 --p  056 4 --p }
79B2: 0025 { 01F 4 --p  057 4 --p  020 4 --p  058 4 --p }
79B3: 0025 { 021 4 --p  059 4 --p  178 0 --p  178 0 --p }
79B4: 0025 { 022 4 --p  05A 4 --p  023 4 --p  05B 4 --p }
79B5: 0025 { 024 6 --p  05C 4 --p  025 4 --p  05D 4 --p }
79B6: 0025 { 026 4 --p  05E 4 --p  027 5 --p  05F 5 --p }
79B7: 0025 { 028 5 --p  060 5 --p  178 0 --p  178 0 --p }
79B8: 0025 { 029 6 --p  061 6 --p  02A 6 --p  062 6 --p }
79B9: 0025 { 02B 6 --p  063 6 --p  02C 6 --p  064 6 --p }
79BA: 0025 { 02D 6 --p  065 6 --p  02E 6 --p  066 6 --p }
79BB: 0025 { 178 0 --p  067 6 --p  178 0 --p  068 4 --p }
79BC: 0025 { 02F 5 --p  069 5 --p  030 5 --p  06A 5 --p }
79BD: 0025 { 031 5 --p  06B 5 --p  032 5 --p  06C 5 --p }
79BE: 0025 { 033 5 --p  06D 5 --p  034 5 --p  06E 5 --p }
79BF: 0025 { 035 5 --p  06F 5 --p  178 0 --p  070 5 --p }
79C0: 0025 { 1CA 4 --p  1F6 4 --p  1CB 4 --p  1F7 4 --p }
79C1: 0025 { 1CC 4 --p  1ED 4 --p  1CD 4 --p  1ED 4 --p }
79C2: 0025 { 1CE 4 --p  1ED 4 --p  1CC 4 --p  1ED 4 --p }
79C3: 0025 { 1CF 4 --p  1F8 4 --p  178 0 --p  1F5 4 --p }
79C4: 0025 { 1D0 4 --p  1F9 4 --p  1D1 4 --p  1FA 4 --p }
79C5: 0025 { 1CC 4 --p  1FB 4 --p  1CC 4 --p  1FB 4 --p }
79C6: 0025 { 1CC 4 --p  1FB 4 --p  1CC 4 --p  1FB 4 --p }
79C7: 0025 { 1CC 4 --p  1FB 4 --p  1D2 4 --p  1FC 4 --p }
79C8: 0025 { 1D3 4 --p  178 0 --p  1D4 6 --p  1FD 4 --p }
79C9: 0025 { 1D5 6 --p  1FE 4 --p  1D6 6 --p  1FF 4 --p }
79CA: 0025 { 1D7 6 --p  1FF 4 --p  1D8 6 --p  1FF 4 --p }
79CB: 0025 { 1D9 6 --p  1FF 4 --p  1DA 6 --p  0F0 4 --p }
79CC: 0025 { 1DB 4 --p  178 0 --p  1DC 5 --p  0F1 4 --p }
79CD: 0025 { 1DD 5 --p  0F2 4 --p  1DE 5 --p  0F3 4 --p }
79CE: 0025 { 1DF 5 --p  0F4 4 --p  1E0 5 --p  0F5 4 --p }
79CF: 0025 { 1E1 5 --p  0F6 4 --p  1E2 5 --p  0F7 4 --p }
79D0: ~
79D1: ~
79D2: ~
79D3: ~
79D4: ~
79D5: ~
79D6: ~
79D7: ~
79D8: ~
79D9: ~
79DA: ~
79DB: ~
79DC: ~
79DD: ~
79DE: ~
79DF: ~
79E0: ~
79E1: ~
79E2: ~
79E3: ~
79E4: ~
79E5: ~
79E6: ~
79E7: ~
79E8: ~
79E9: ~
79EA: ~
79EB: ~
79EC: ~
79ED: ~
79EE: ~
79EF: ~
79F0: ~
79F1: ~
79F2: ~
79F3: ~
79F4: ~
79F5: ~
79F6: ~
79F7: ~
79F8: ~
79F9: ~
79FA: ~
79FB: ~
79FC: ~
79FD: ~
79FE: ~
79FF: ~
