0500: 0133 { 000 7 ---  010 7 ---  001 7 ---  011 7 --- }
0501: 0134 { 002 7 ---  012 7 ---  003 7 ---  013 7 --- }
0502: 0135 { 020 7 ---  020 7 ---  021 7 ---  021 7 --- }
0503: 0136 { 022 7 ---  022 7 ---  023 7 ---  023 7 --- }
0504: 0137 { 000 7 ---  010 7 ---  001 7 ---  011 7 --- }
0505: 0138 { 002 7 ---  012 7 ---  003 7 ---  013 7 --- }
0506: 013B { 004 7 ---  014 7 ---  005 7 ---  015 7 --- }
0507: 013C { 024 7 ---  034 7 ---  025 7 ---  035 7 --- }
0508: 013D { 02E 7 ---  03E 7 ---  02E 7 ---  03E 7 --- }
0509: 013E { 02F 7 ---  03F 7 ---  02F 7 ---  03F 7 --- }
050A: 013F { 024 7 ---  034 7 ---  025 7 ---  035 7 --- }
050B: 0133 { 000 5 ---  010 5 ---  001 5 ---  011 5 --- }
050C: 0134 { 002 5 ---  012 5 ---  003 5 ---  013 5 --- }
050D: 0135 { 020 5 ---  020 5 ---  021 5 ---  021 5 --- }
050E: 0136 { 022 5 ---  022 5 ---  023 5 ---  023 5 --- }
050F: 012F { 05E 6 -y-  05C 6 -y-  05F 6 -y-  05D 6 -y- }
0510: 0130 { 240 3 ---  250 3 ---  243 3 ---  253 3 --- }
0511: 0130 { 260 3 ---  270 3 ---  263 3 ---  273 3 --- }
0512: 01AA { 0F8 4 ---  244 3 ---  235 3 ---  245 3 --- }
0513: 01AF { 236 3 ---  246 3 ---  0F8 4 ---  247 3 --- }
0514: 0196 { 0F8 4 ---  258 3 ---  0F8 4 ---  259 3 --- }
0515: 019B { 24A 3 ---  25A 3 ---  24B 3 ---  25B 3 --- }
0516: 01A0 { 24C 3 ---  25C 3 ---  24D 3 ---  25D 3 --- }
0517: 01A5 { 0F8 4 ---  25E 3 ---  0F8 4 ---  25F 3 --- }
0518: 016E { 0F8 4 ---  210 3 ---  0F8 4 ---  211 3 --- }
0519: 0173 { 0F8 4 ---  212 3 ---  0F8 4 ---  213 3 --- }
051A: 0178 { 204 3 ---  214 3 ---  205 3 ---  215 3 --- }
051B: 017D { 206 3 ---  216 3 ---  207 3 ---  217 3 --- }
051C: 0182 { 208 3 ---  218 3 ---  209 3 ---  219 3 --- }
051D: 0187 { 20A 3 ---  21A 3 ---  20B 3 ---  21B 3 --- }
051E: 018C { 0F8 4 ---  21C 3 ---  0F8 4 ---  21D 3 --- }
051F: 018C { 0F8 4 ---  21E 3 ---  0F8 4 ---  21F 3 --- }
0520: 0130 { 240 3 ---  250 3 ---  242 3 ---  252 3 --- }
0521: 0130 { 241 3 ---  251 3 ---  242 3 ---  252 3 --- }
0522: 01E2 { 254 3 ---  271 3 ---  255 3 ---  272 3 --- }
0523: 01E4 { 256 3 ---  271 3 x--  257 3 ---  272 3 x-- }
0524: 01DE { 268 3 ---  278 3 ---  269 3 ---  279 3 --- }
0525: 003F { 26A 3 ---  271 3 ---  26B 3 ---  272 3 --- }
0526: 003F { 26C 3 x--  271 3 ---  26D 3 ---  272 3 --- }
0527: 01E0 { 26E 3 ---  27E 3 ---  26F 3 ---  27F 3 --- }
0528: 01D8 { 220 3 x--  230 3 ---  221 3 ---  231 3 --- }
0529: 01DA { 222 3 x--  271 3 ---  223 3 ---  272 3 --- }
052A: 0135 { 200 5 ---  200 5 ---  021 5 ---  021 5 --- }
052B: 0136 { 022 5 ---  022 5 ---  201 5 ---  201 5 --- }
052C: 0135 { 200 5 ---  202 5 ---  021 5 ---  021 5 --- }
052D: 0136 { 022 5 ---  022 5 ---  201 5 ---  203 5 --- }
052E: 01DB { 22C 3 ---  272 3 ---  22D 3 ---  271 3 --- }
052F: 01DC { 22E 3 ---  272 3 ---  22F 3 ---  271 3 --- }
0530: 0130 { 260 3 ---  270 3 ---  262 3 ---  272 3 --- }
0531: 0130 { 261 3 ---  271 3 ---  262 3 ---  272 3 --- }
0532: 0130 { 241 3 ---  251 3 ---  243 3 ---  253 3 --- }
0533: 0130 { 261 3 ---  271 3 ---  263 3 ---  273 3 --- }
0534: 0153 { 1F4 1 ---  1F6 1 ---  1F5 1 ---  1F7 1 --- }
0535: 0154 { 1F8 1 ---  1F8 1 ---  1F9 1 ---  1F9 1 --- }
0536: 0155 { 1F6 1 -y-  1F4 1 -y-  1F7 1 -y-  1F5 1 -y- }
0537: 0156 { 1FA 1 ---  1FD 1 ---  1FB 1 ---  1FE 1 --- }
0538: 0157 { 1FC 1 ---  1FF 1 ---  1FC 1 ---  1FF 1 --- }
0539: 0158 { 1FB 1 x--  1FE 1 x--  1FA 1 x--  1FD 1 x-- }
053A: ~
053B: ~
053C: ~
053D: ~
053E: ~
053F: ~
0540: 0200 { 1C1 2 --p  1D1 2 --p  1C2 2 --p  1D2 2 --p }
0541: 0200 { 1F2 2 --p  1E2 2 --p  1C3 2 --p  1D3 2 --p }
0542: 0201 { 1C1 2 --p  1D1 2 --p  1C2 2 --p  1D2 2 --p }
0543: 0201 { 1F2 2 --p  1E2 2 --p  1C3 2 --p  1D3 2 --p }
0544: 0202 { 1C1 2 --p  1D1 2 --p  1C2 2 --p  1D2 2 --p }
0545: 0202 { 1F2 2 --p  1E2 2 --p  1C3 2 --p  1D3 2 --p }
0546: 0203 { 1C1 2 --p  1D1 2 --p  1C2 2 --p  1D2 2 --p }
0547: 0203 { 1F2 2 --p  1E2 2 --p  1C3 2 --p  1D3 2 --p }
0548: 0130 { 1C1 2 --p  1D1 2 --p  1C2 2 --p  1D2 2 --p }
0549: 0130 { 1F2 2 --p  1E2 2 --p  1C3 2 --p  1D3 2 --p }
054A: ~
054B: ~
054C: ~
054D: ~
054E: ~
054F: ~
0550: 0200 { 1E1 2 --p  1F1 2 --p  1E2 2 --p  1F2 2 --p }
0551: 0200 { 1C2 2 --p  1D2 2 --p  1E3 2 --p  1F3 2 --p }
0552: 0201 { 1E1 2 --p  1F1 2 --p  1E2 2 --p  1F2 2 --p }
0553: 0201 { 1C2 2 --p  1D2 2 --p  1E3 2 --p  1F3 2 --p }
0554: 0202 { 1E1 2 --p  1F1 2 --p  1E2 2 --p  1F2 2 --p }
0555: 0202 { 1C2 2 --p  1D2 2 --p  1E3 2 --p  1F3 2 --p }
0556: 0203 { 1E1 2 --p  1F1 2 --p  1E2 2 --p  1F2 2 --p }
0557: 0203 { 1C2 2 --p  1D2 2 --p  1E3 2 --p  1F3 2 --p }
0558: 0130 { 1E1 2 --p  1F1 2 --p  1E2 2 --p  1F2 2 --p }
0559: 0130 { 1C2 2 --p  1D2 2 --p  1E3 2 --p  1F3 2 --p }
055A: ~
055B: ~
055C: ~
055D: ~
055E: ~
055F: ~
0560: 0025 { 201 2 -y-  200 2 -y-  201 2 xy-  200 2 xy- }
0561: 0025 { 200 2 ---  201 2 ---  200 2 x--  201 2 x-- }
0562: 012F { 058 5 ---  05A 5 ---  059 5 ---  05B 5 --- }
0563: 0025 { 0F8 7 ---  00E 7 ---  0F8 7 ---  00F 7 --- }
0564: 0025 { 0F8 7 ---  08C 7 ---  0F8 7 ---  00B 7 --- }
0565: 0025 { 01E 7 ---  0F8 5 ---  01F 7 ---  0D5 7 --- }
0566: 0025 { 09C 7 ---  0F8 7 ---  0F8 7 ---  0F8 5 --- }
0567: 0560 { 203 2 -y-  202 2 -y-  201 2 xy-  200 2 xy- }
0568: 0561 { 202 2 ---  203 2 ---  200 2 x--  201 2 x-- }
0569: 0560 { 201 2 -y-  200 2 -y-  205 2 xy-  204 2 xy- }
056A: 0561 { 200 2 ---  201 2 ---  204 2 x--  205 2 x-- }
056B: ~
056C: ~
056D: ~
056E: ~
056F: ~
0570: 01EB { 1D6 5 ---  1D6 5 -y-  1D6 5 ---  1D6 5 -y- }
0571: ~
0572: ~
0573: 0025 { 00E 7 -y-  0F8 7 -y-  00F 7 -y-  0F8 7 -y- }
0574: 0025 { 08C 7 -y-  0F8 7 -y-  00B 7 -y-  0F8 7 -y- }
0575: 0025 { 0F8 5 -y-  01E 7 -y-  0D5 7 -y-  01F 7 -y- }
0576: 0025 { 0F8 7 -y-  09C 7 -y-  0F8 5 -y-  0F8 7 -y- }
0577: ~
0578: ~
0579: ~
057A: ~
057B: ~
057C: ~
057D: ~
057E: ~
057F: ~
0580: ~
0581: ~
0582: ~
0583: ~
0584: ~
0585: ~
0586: ~
0587: ~
0588: ~
0589: ~
058A: ~
058B: ~
058C: ~
058D: ~
058E: ~
058F: ~
0590: ~
0591: ~
0592: ~
0593: ~
0594: ~
0595: ~
0596: ~
0597: ~
0598: ~
0599: ~
059A: ~
059B: ~
059C: ~
059D: ~
059E: ~
059F: ~
05A0: ~
05A1: ~
05A2: ~
05A3: ~
05A4: ~
05A5: ~
05A6: ~
05A7: ~
05A8: ~
05A9: ~
05AA: ~
05AB: ~
05AC: ~
05AD: ~
05AE: ~
05AF: ~
05B0: ~
05B1: ~
05B2: ~
05B3: ~
05B4: ~
05B5: ~
05B6: ~
05B7: ~
05B8: ~
05B9: ~
05BA: ~
05BB: ~
05BC: ~
05BD: ~
05BE: ~
05BF: ~
05C0: ~
05C1: ~
05C2: ~
05C3: ~
05C4: ~
05C5: ~
05C6: ~
05C7: ~
05C8: ~
05C9: ~
05CA: ~
05CB: ~
05CC: ~
05CD: ~
05CE: ~
05CF: ~
05D0: ~
05D1: ~
05D2: ~
05D3: ~
05D4: ~
05D5: ~
05D6: ~
05D7: ~
05D8: ~
05D9: ~
05DA: ~
05DB: ~
05DC: ~
05DD: ~
05DE: ~
05DF: ~
05E0: ~
05E1: ~
05E2: ~
05E3: ~
05E4: ~
05E5: ~
05E6: ~
05E7: ~
05E8: ~
05E9: ~
05EA: ~
05EB: ~
05EC: ~
05ED: ~
05EE: ~
05EF: ~
05F0: ~
05F1: ~
05F2: ~
05F3: ~
05F4: ~
05F5: ~
05F6: ~
05F7: ~
05F8: ~
05F9: ~
05FA: ~
05FB: ~
05FC: ~
05FD: ~
05FE: ~
05FF: ~
