4400: 0130 { 18E 2 ---  1E5 2 ---  18F 2 ---  19F 2 --- }
4401: 0130 { 0F8 2 ---  180 2 ---  0F8 2 ---  181 2 --- }
4402: 0130 { 0F8 2 ---  0F8 2 ---  0F8 2 ---  0F8 2 --- }
4403: 0130 { 0F8 2 ---  0F8 2 ---  0F8 2 ---  0F8 2 --- }
4404: 0130 { 0F8 2 ---  182 2 ---  0F8 2 ---  183 2 --- }
4405: 0130 { 0F8 2 ---  184 2 ---  0F8 2 ---  185 2 --- }
4406: 0130 { 0F8 2 ---  186 2 ---  0F8 2 ---  187 2 --- }
4407: 0130 { 0F8 2 ---  188 2 ---  0F8 2 ---  189 2 --- }
4408: 0130 { 0F8 2 x--  181 2 x--  0F8 2 x--  180 2 x-- }
4409: 0130 { 1E0 2 ---  1F0 2 ---  191 2 ---  1A1 2 --- }
440A: 0130 { 18E 2 ---  19E 2 ---  18F 2 ---  19F 2 --- }
440B: 0130 { 18F 2 x--  19F 2 x--  18E 2 x--  19E 2 x-- }
440C: 0130 { 28F 2 x--  29F 2 x--  28E 2 x--  29E 2 x-- }
440D: 0130 { 28D 2 x--  29D 2 x--  28C 2 x--  29C 2 x-- }
440E: 0130 { 28C 2 ---  29C 2 ---  28D 2 ---  29D 2 --- }
440F: 0130 { 28E 2 ---  29E 2 ---  28F 2 ---  29F 2 --- }
4410: 0130 { 18F 2 x--  19F 2 x--  18E 2 x--  1E5 2 x-- }
4411: 0130 { 190 2 ---  1A0 2 ---  191 2 ---  1A1 2 --- }
4412: 0130 { 19A 2 ---  1AA 2 ---  19B 2 ---  1AB 2 --- }
4413: 0130 { 19C 2 ---  1AC 2 ---  19D 2 ---  1AD 2 --- }
4414: 0130 { 192 2 ---  1A2 2 ---  193 2 ---  1A3 2 --- }
4415: 0130 { 194 2 ---  1A4 2 ---  195 2 ---  1A5 2 --- }
4416: 0130 { 196 2 ---  1A6 2 ---  197 2 ---  1A7 2 --- }
4417: 0130 { 198 2 ---  1A8 2 ---  199 2 ---  1A9 2 --- }
4418: 0130 { 191 2 x--  1A1 2 x--  190 2 x--  1A0 2 x-- }
4419: 0130 { 191 2 x--  1A1 2 x--  1E0 2 x--  1F0 2 x-- }
441A: 0130 { 1AE 2 ---  1BE 2 ---  1AF 2 ---  1BF 2 --- }
441B: 0130 { 1AF 2 x--  1BF 2 x--  1AE 2 x--  1BE 2 x-- }
441C: 0130 { 2AF 2 x--  2BF 2 x--  2AE 2 x--  2BE 2 x-- }
441D: 0130 { 2AD 2 x--  0F8 2 ---  0F8 2 ---  0F8 2 --- }
441E: 0130 { 0F8 2 x--  0F8 2 x--  2AD 2 ---  0F8 2 x-- }
441F: 0130 { 2AE 2 ---  2BE 2 ---  2AF 2 ---  2BF 2 --- }
4420: 0130 { 0F8 2 x--  0F8 2 x--  289 2 ---  299 2 --- }
4421: 0130 { 28A 2 ---  29A 2 ---  28B 2 ---  29B 2 --- }
4422: 0130 { 2C5 2 ---  2D5 2 ---  280 2 ---  297 2 x-- }
4423: 0130 { 1F6 2 ---  1F8 2 ---  1F7 2 ---  1F9 2 --- }
4424: 0130 { 281 2 ---  291 2 ---  282 2 ---  292 2 --- }
4425: 0130 { 283 2 ---  293 2 ---  284 2 ---  294 2 --- }
4426: 0130 { 285 2 ---  295 2 ---  286 2 ---  296 2 --- }
4427: 0130 { 287 2 ---  297 2 ---  288 2 ---  298 2 --- }
4428: 0130 { 28B 2 x--  29B 2 x--  28A 2 x--  29A 2 x-- }
4429: 0130 { 289 2 x--  299 2 x--  0F8 2 ---  0F8 2 --- }
442A: 0130 { 1CE 2 ---  1DE 2 ---  1CF 2 ---  1DF 2 --- }
442B: 0130 { 1CF 2 x--  1DF 2 x--  1CE 2 x--  1DE 2 x-- }
442C: 0130 { 2CF 2 x--  2DF 2 x--  2CE 2 x--  2DE 2 x-- }
442D: 0130 { 2CD 2 x--  2DD 2 x--  0F8 2 ---  2DC 2 x-- }
442E: 0130 { 0F8 2 x--  2DC 2 ---  2CD 2 ---  2DD 2 --- }
442F: 0130 { 2CE 2 ---  2DE 2 ---  2CF 2 ---  2DF 2 --- }
4430: 0130 { 0F8 2 x--  0F8 2 x--  2A9 2 ---  2B9 2 --- }
4431: 0130 { 2AA 2 ---  2BA 2 ---  2AB 2 ---  2BB 2 --- }
4432: 0130 { 2B4 2 xy-  2BC 2 ---  290 2 xy-  291 2 -y- }
4433: 0130 { 2D7 2 -y-  2C7 2 -y-  2D8 2 -y-  2C8 2 -y- }
4434: 0130 { 2D8 2 xy-  2C8 2 xy-  2D7 2 xy-  2C7 2 xy- }
4435: 0130 { 2E5 2 ---  2F6 2 ---  2E6 2 ---  0FB 2 --- }
4436: 0130 { 2E7 2 ---  2F7 2 ---  2E8 2 ---  2F8 2 --- }
4437: 0130 { 2A7 2 ---  2B7 2 ---  2A8 2 ---  2B8 2 --- }
4438: 0130 { 2AB 2 x--  2BB 2 x--  2AA 2 x--  2BA 2 x-- }
4439: 0130 { 2A9 2 x--  2B9 2 x--  0F8 2 ---  0F8 2 --- }
443A: 0130 { 1EE 2 ---  1FE 2 ---  1EF 2 ---  1FF 2 --- }
443B: 0130 { 1EF 2 x--  1FF 2 x--  1EE 2 x--  1FE 2 x-- }
443C: 0130 { 2EF 2 x--  2FF 2 x--  2EE 2 x--  2FE 2 x-- }
443D: 0130 { 2ED 2 x--  2FD 2 x--  2EC 2 x--  2FC 2 x-- }
443E: 0130 { 2EC 2 ---  2FC 2 ---  2ED 2 ---  2FD 2 --- }
443F: 0130 { 2EE 2 ---  2FE 2 ---  2EF 2 ---  2FF 2 --- }
4440: 0130 { 0F8 2 x--  0F8 2 x--  2C9 2 ---  2D9 2 --- }
4441: 0130 { 2CA 2 ---  2DA 2 ---  2CB 2 ---  2DB 2 --- }
4442: 0130 { 2B8 2 xy-  2A8 2 xy-  2B7 2 xy-  2A7 2 xy- }
4443: 0130 { 2C7 2 ---  2D7 2 ---  2C8 2 ---  2D8 2 --- }
4444: 0130 { 2C8 2 x--  2D8 2 x--  2C7 2 x--  2D7 2 x-- }
4445: 0130 { 2A5 2 ---  2B5 2 ---  2A6 2 ---  2B6 2 --- }
4446: 0130 { 2C6 2 ---  0FB 2 ---  2D6 2 ---  2F5 2 --- }
4447: 0130 { 291 2 x--  290 2 ---  2BC 2 xy-  2B4 2 --- }
4448: 0130 { 2CB 2 x--  2DB 2 x--  2CA 2 x--  2DA 2 x-- }
4449: 0130 { 2C9 2 x--  2D9 2 x--  0F8 2 ---  0F8 2 --- }
444A: 0130 { 1B2 2 ---  1C2 2 ---  1B3 2 ---  1C3 2 --- }
444B: 0130 { 1B4 2 ---  1C4 2 ---  1B5 2 ---  1C5 2 --- }
444C: 0130 { 1B6 2 ---  1C6 2 ---  1B7 2 ---  1C7 2 --- }
444D: 0130 { 1B8 2 ---  1C8 2 ---  1B9 2 ---  1C9 2 --- }
444E: 0130 { 1BA 2 ---  1CA 2 ---  1BB 2 ---  1CB 2 --- }
444F: 0130 { 2B3 2 ---  19E 2 ---  2E4 2 ---  2F4 2 --- }
4450: 0130 { 0F8 2 x--  0F8 2 x--  2E9 2 ---  2F9 2 --- }
4451: 0130 { 2EA 2 ---  2FA 2 ---  2EB 2 ---  2FB 2 --- }
4452: 0130 { 298 2 xy-  288 2 xy-  297 2 xy-  287 2 xy- }
4453: 0130 { 296 2 xy-  286 2 xy-  295 2 xy-  285 2 xy- }
4454: 0130 { 294 2 xy-  284 2 xy-  293 2 xy-  283 2 xy- }
4455: 0130 { 292 2 xy-  282 2 xy-  291 2 xy-  281 2 xy- }
4456: 0130 { 1F9 2 xy-  1F7 2 xy-  1F8 2 xy-  1F6 2 xy- }
4457: 0130 { 297 2 -y-  280 2 xy-  2D5 2 xy-  2C5 2 xy- }
4458: 0130 { 2EB 2 x--  2FB 2 x--  2EA 2 x--  2FA 2 x-- }
4459: 0130 { 2E9 2 x--  2F9 2 x--  0F8 2 ---  0F8 2 --- }
445A: 0130 { 1CB 2 xy-  1BB 2 xy-  1CA 2 xy-  1BA 2 xy- }
445B: 0130 { 1C9 2 xy-  1B9 2 xy-  1C8 2 xy-  1B8 2 xy- }
445C: 0130 { 1C7 2 xy-  1B7 2 xy-  1C6 2 xy-  1B6 2 xy- }
445D: 0130 { 1C5 2 xy-  1B5 2 xy-  1C4 2 xy-  1B4 2 xy- }
445E: 0130 { 1C3 2 xy-  1B3 2 xy-  1C2 2 xy-  1B2 2 xy- }
445F: 0130 { 2E4 2 x--  2F4 2 x--  2B3 2 x--  19E 2 x-- }
4460: 0130 { 1F2 2 ---  1F3 2 ---  1AF 2 ---  1BF 2 --- }
4461: 0130 { 1B0 2 ---  1C0 2 ---  1B1 2 ---  1C1 2 --- }
4462: 0130 { 1A9 2 xy-  199 2 xy-  1A8 2 xy-  198 2 xy- }
4463: 0130 { 1A7 2 xy-  197 2 xy-  1A6 2 xy-  196 2 xy- }
4464: 0130 { 1A5 2 xy-  195 2 xy-  1A4 2 xy-  194 2 xy- }
4465: 0130 { 1A3 2 xy-  193 2 xy-  1A2 2 xy-  192 2 xy- }
4466: 0130 { 1AD 2 xy-  19D 2 xy-  1AC 2 xy-  19C 2 xy- }
4467: 0130 { 1AB 2 xy-  19B 2 xy-  1AA 2 xy-  19A 2 xy- }
4468: 0130 { 1B1 2 x--  1C1 2 x--  1B0 2 x--  1C0 2 x-- }
4469: 0130 { 1AF 2 x--  1BF 2 x--  1F2 2 x--  1F3 2 x-- }
446A: 0130 { 0F8 2 ---  18A 2 ---  0F8 2 ---  18B 2 --- }
446B: 0130 { 1F4 2 ---  18C 2 ---  1F5 2 ---  18D 2 --- }
446C: 0130 { 1F5 2 x--  18D 2 x--  1F4 2 x--  18C 2 x-- }
446D: 0130 { 0F8 2 x--  18B 2 x--  0F8 2 x--  18A 2 x-- }
446E: 0130 { 1CD 2 xy-  1BD 2 xy-  1CC 2 xy-  1BC 2 xy- }
446F: 0130 { 1BC 2 ---  1CC 2 ---  1BD 2 ---  1CD 2 --- }
4470: 0130 { 1E1 2 ---  1F1 2 ---  1CF 2 ---  1DF 2 --- }
4471: 0130 { 1D0 2 ---  0F8 2 ---  1D1 2 ---  0F8 2 --- }
4472: 0130 { 189 2 xy-  0F8 2 xy-  188 2 xy-  0F8 2 xy- }
4473: 0130 { 187 2 xy-  0F8 2 xy-  186 2 xy-  0F8 2 xy- }
4474: 0130 { 185 2 xy-  0F8 2 xy-  184 2 xy-  0F8 2 xy- }
4475: 0130 { 183 2 xy-  0F8 2 xy-  182 2 xy-  0F8 2 xy- }
4476: 0130 { 0F8 2 ---  0F8 2 ---  0F8 2 ---  0F8 2 --- }
4477: 0130 { 0F8 2 ---  0F8 2 ---  0F8 2 ---  0F8 2 --- }
4478: 0130 { 1D1 2 x--  0F8 2 x--  1D0 2 x--  0F8 2 x-- }
4479: 0130 { 1CF 2 x--  1DF 2 x--  1E1 2 x--  1F1 2 x-- }
447A: 0130 { 1FA 2 ---  1FC 2 ---  1FB 2 ---  1FD 2 --- }
447B: 0130 { 2A4 2 x--  2D5 2 ---  280 2 ---  297 2 x-- }
447C: 0130 { 287 2 ---  297 2 ---  2A4 2 ---  298 2 --- }
447D: 0130 { 1D8 2 ---  297 2 ---  1D9 2 ---  1E9 2 --- }
447E: 0130 { 1DA 2 ---  1EA 2 ---  1DB 2 ---  1EB 2 --- }
447F: 0130 { 1DC 2 ---  1EC 2 ---  1DD 2 ---  1ED 2 --- }
4480: 0130 { 2A0 5 --p  2B0 5 --p  2A1 5 --p  2B1 5 --p }
4481: 0130 { 2A2 5 --p  2B2 5 --p  2A3 5 --p  2B3 5 --p }
4482: 0130 { 2CC 2 xy-  2BD 2 xy-  282 2 ---  283 2 xy- }
4483: 0130 { 283 2 ---  282 2 xy-  2BD 2 ---  2CC 2 --- }
4484: 0130 { 285 2 ---  1F6 2 -y-  286 2 ---  1F7 2 -y- }
4485: 0130 { 285 2 ---  283 2 -y-  286 2 ---  284 2 -y- }
4486: 0130 { 100 6 ---  110 6 ---  100 6 x--  110 6 x-- }
4487: 0130 { 110 2 -y-  100 2 -y-  110 2 xy-  100 2 xy- }
4488: 0130 { 05E 6 -y-  05C 6 -y-  05F 6 -y-  05D 6 -y- }
4489: 0130 { 106 3 ---  116 3 ---  107 3 ---  117 3 --- }
448A: 0130 { 1D7 2 x--  1E7 2 x--  1D6 2 x--  1E6 2 x-- }
448B: 0130 { 298 2 xy-  2A4 2 xy-  297 2 xy-  287 2 xy- }
448C: 0130 { 297 2 -y-  280 2 xy-  2D5 2 xy-  2A4 2 -y- }
448D: 0130 { 1D6 2 ---  1E6 2 ---  1D7 2 ---  1E7 2 --- }
448E: 0130 { 1BD 2 x--  1CD 2 x--  1BC 2 x--  1CC 2 x-- }
448F: 0130 { 1EB 2 xy-  1DB 2 xy-  1EA 2 xy-  1DA 2 xy- }
4490: 0130 { 2C0 5 --p  2D0 5 --p  2C1 5 --p  2D1 5 --p }
4491: 0130 { 2C2 5 --p  2D2 5 --p  2C3 5 --p  2D3 5 --p }
4492: 0130 { 2AC 2 ---  2BC 2 ---  1E8 2 ---  298 2 --- }
4493: 0130 { 2B4 2 xy-  2BC 2 ---  2A8 2 ---  2B8 2 --- }
4494: 0130 { 0F8 2 ---  0F8 2 ---  245 2 ---  255 2 --- }
4495: 0130 { 206 2 ---  216 2 ---  207 2 ---  217 2 --- }
4496: 0130 { 208 2 ---  218 2 ---  209 2 ---  219 2 --- }
4497: 0130 { 245 2 x--  255 2 x--  0F8 2 x--  0F8 2 x-- }
4498: 0130 { 224 3 ---  234 3 ---  225 3 ---  235 3 --- }
4499: 0130 { 1EA 2 -y-  1DA 2 -y-  1EB 2 -y-  1DB 2 -y- }
449A: 0130 { 1D5 2 x--  0F8 2 ---  1D4 2 x--  1E4 2 x-- }
449B: 0130 { 1D3 2 x--  1E3 2 x--  1D2 2 x--  1E2 2 x-- }
449C: 0130 { 1D2 2 ---  1E2 2 ---  1D3 2 ---  1E3 2 --- }
449D: 0130 { 1D4 2 ---  1E4 2 ---  1D5 2 ---  0F8 2 --- }
449E: 0130 { 1DD 2 x--  1ED 2 x--  1DC 2 x--  1EC 2 x-- }
449F: 0130 { 1DB 2 x--  1EB 2 x--  1DA 2 x--  1EA 2 x-- }
44A0: 0130 { 2E0 5 --p  2F0 5 --p  2E1 5 --p  2F1 5 --p }
44A1: 0130 { 2E2 5 --p  2F2 5 --p  2E3 5 --p  2F3 5 --p }
44A2: 0130 { 298 2 xy-  1E8 2 xy-  2BC 2 xy-  2AC 2 xy- }
44A3: 0130 { 2B8 2 xy-  2A8 2 xy-  2BC 2 xy-  2B4 2 --- }
44A4: 0130 { 0F8 2 ---  265 2 ---  244 2 ---  254 2 --- }
44A5: 0130 { 226 2 ---  236 2 ---  227 2 ---  237 2 --- }
44A6: 0130 { 228 2 ---  238 2 ---  229 2 ---  239 2 --- }
44A7: 0130 { 244 2 x--  254 2 x--  0F8 2 x--  265 2 x-- }
44A8: 0130 { 24C 2 ---  25C 2 ---  24D 2 ---  25D 2 --- }
44A9: 0130 { 24D 2 x--  25D 2 x--  24C 2 x--  25C 2 x-- }
44AA: 0130 { 26C 2 ---  27C 2 ---  26D 2 ---  27D 2 --- }
44AB: 0130 { 248 2 ---  258 2 ---  249 2 ---  259 2 --- }
44AC: 0130 { 2A3 2 x-p  1BC 2 -yp  2A2 2 x-p  2B2 2 x-p }
44AD: 0130 { 2A1 2 x-p  1DA 2 -yp  2A0 2 x-p  2B0 2 x-p }
44AE: 0130 { 2A0 2 --p  2B0 2 --p  2A1 2 --p  1DA 2 xyp }
44AF: 0130 { 2A2 2 --p  2B2 2 --p  2A3 2 --p  1BC 2 xyp }
44B0: 0130 { 2C0 5 --p  2D0 5 --p  2C1 5 --p  2D1 5 --p }
44B1: 0130 { 2C2 5 --p  2D2 5 --p  2C3 5 --p  2D3 5 --p }
44B2: 0130 { 2E0 5 --p  2F0 5 --p  2E1 5 --p  2F1 5 --p }
44B3: 0130 { 2E2 5 --p  2F2 5 --p  2E3 5 --p  2F3 5 --p }
44B4: 0130 { 265 2 -y-  0F8 2 -y-  254 2 -y-  244 2 -y- }
44B5: 0130 { 20A 2 ---  21A 2 ---  20B 2 ---  21B 2 --- }
44B6: 0130 { 20C 2 ---  21C 2 ---  20D 2 ---  21D 2 --- }
44B7: 0130 { 254 2 xy-  244 2 xy-  265 2 xy-  0F8 2 xy- }
44B8: 0130 { 222 2 ---  232 2 ---  223 2 ---  233 2 --- }
44B9: 0130 { 242 2 ---  252 2 ---  243 2 ---  253 2 --- }
44BA: 0130 { 27C 2 -y-  26C 2 -y-  27D 2 -y-  26D 2 -y- }
44BB: 0130 { 268 2 ---  278 2 ---  269 2 ---  279 2 --- }
44BC: 0130 { 1CC 2 -yp  1BC 2 -yp  1CD 2 -yp  1BD 2 -yp }
44BD: 0130 { 124 7 ---  0F8 2 ---  133 7 ---  0F8 2 --- }
44BE: 0130 { 134 7 ---  0F8 2 ---  133 7 ---  0F8 2 --- }
44BF: 0130 { 134 7 ---  0F8 2 ---  125 7 ---  0F8 2 --- }
44C0: 0130 { 0F8 7 x--  00B 7 x--  0F8 7 x--  08C 7 x-- }
44C1: 0130 { 0F8 7 x--  00F 7 x--  0F8 7 x--  00E 7 x-- }
44C2: 0130 { 16C 5 --p  17C 5 --p  16D 5 --p  17D 5 --p }
44C3: 0130 { 16E 5 --p  17E 5 --p  16F 5 --p  17F 5 --p }
44C4: 0130 { 26E 2 ---  27E 2 ---  26F 2 ---  27F 2 --- }
44C5: 0130 { 22A 2 ---  23A 2 ---  22B 2 ---  23B 2 --- }
44C6: 0130 { 22C 2 ---  23C 2 ---  22D 2 ---  23D 2 --- }
44C7: 0130 { 26F 2 x--  27F 2 x--  26E 2 x--  27E 2 x-- }
44C8: 0130 { 200 3 ---  210 3 ---  201 3 ---  211 3 --- }
44C9: 0130 { 202 3 ---  212 3 ---  203 3 ---  213 3 --- }
44CA: 0130 { 204 3 ---  214 3 ---  205 3 ---  215 3 --- }
44CB: 0130 { 108 7 ---  118 7 ---  109 7 ---  119 7 --- }
44CC: 0130 { 10A 7 ---  11A 7 ---  10B 7 ---  11B 7 --- }
44CD: 0130 { 132 7 ---  23A 3 ---  133 7 ---  23B 3 --- }
44CE: 0130 { 134 7 ---  23A 3 ---  133 7 ---  23B 3 --- }
44CF: 0130 { 134 7 ---  23C 3 ---  135 7 ---  23D 3 --- }
44D0: 0130 { 0F8 7 x--  0F8 2 ---  09C 7 x--  0F8 7 x-- }
44D1: 0130 { 01F 7 x--  0D5 7 x--  01E 7 x--  0F8 2 --- }
44D2: 0130 { 16B 5 x-p  17B 5 x-p  16A 5 x-p  17A 5 x-p }
44D3: 0130 { 169 5 x-p  179 5 x-p  168 5 x-p  178 5 x-p }
44D4: 0130 { 24A 2 ---  25A 2 ---  24B 2 ---  25B 2 --- }
44D5: 0130 { 20E 2 ---  21E 2 ---  20F 2 ---  21F 2 --- }
44D6: 0130 { 22E 2 ---  23E 2 ---  22F 2 ---  23F 2 --- }
44D7: 0130 { 24B 2 x--  25B 2 x--  24A 2 x--  25A 2 x-- }
44D8: 0130 { 220 3 ---  230 3 ---  221 3 ---  231 3 --- }
44D9: 0130 { 0F9 3 ---  0F9 3 ---  0F9 3 ---  0F9 3 --- }
44DA: 0130 { 221 3 x--  231 3 x--  220 3 x--  230 3 x-- }
44DB: 0130 { 128 7 ---  138 7 ---  129 7 ---  139 7 --- }
44DC: 0130 { 12A 7 ---  13A 7 ---  12B 7 ---  13B 7 --- }
44DD: 0130 { 120 7 ---  0F8 2 ---  121 7 ---  0F8 2 --- }
44DE: 0130 { 122 7 ---  0F8 2 ---  123 7 ---  0F8 2 --- }
44DF: 0130 { 124 7 ---  0F8 2 ---  125 7 ---  0F8 2 --- }
44E0: 0130 { 108 5 ---  118 5 ---  109 5 ---  119 5 --- }
44E1: 0130 { 10A 5 ---  11A 5 ---  10B 5 ---  11B 5 --- }
44E2: 0130 { 14C 5 --p  15C 5 --p  14D 5 --p  15D 5 --p }
44E3: 0130 { 14E 5 --p  15E 5 --p  14F 5 --p  15F 5 --p }
44E4: 0130 { 26A 2 ---  27A 2 ---  26B 2 ---  27B 2 --- }
44E5: 0130 { 246 2 ---  256 2 ---  247 2 ---  257 2 --- }
44E6: 0130 { 267 2 x--  277 2 x--  266 2 x--  276 2 x-- }
44E7: 0130 { 26B 2 x--  27B 2 x--  26A 2 x--  27A 2 x-- }
44E8: 0130 { 240 3 ---  250 3 ---  241 3 ---  251 3 --- }
44E9: 0130 { 0F9 3 ---  0F9 3 ---  0F9 3 ---  0F9 3 --- }
44EA: 0130 { 241 3 x--  251 3 x--  240 3 x--  250 3 x-- }
44EB: 0130 { 108 6 ---  118 6 ---  109 6 ---  119 6 --- }
44EC: 0130 { 10A 6 ---  11A 6 ---  10B 6 ---  11B 6 --- }
44ED: ~
44EE: 0130 { 10C 0 ---  11C 0 ---  10D 0 ---  11D 0 --- }
44EF: 0130 { 10E 0 ---  11E 0 ---  10F 0 ---  11F 0 --- }
44F0: 0130 { 128 5 ---  138 5 ---  129 5 ---  139 5 --- }
44F1: 0130 { 12A 5 ---  13A 5 ---  12B 5 ---  13B 5 --- }
44F2: 0130 { 14B 5 x-p  15B 5 x-p  14A 5 x-p  15A 5 x-p }
44F3: 0130 { 149 5 x-p  159 5 x-p  148 5 x-p  158 5 x-p }
44F4: 0130 { 24E 2 ---  25E 2 ---  24F 2 ---  25F 2 --- }
44F5: 0130 { 266 2 ---  276 2 ---  267 2 ---  277 2 --- }
44F6: 0130 { 247 2 x--  257 2 x--  246 2 x--  256 2 x-- }
44F7: 0130 { 24F 2 x--  25F 2 x--  24E 2 x--  25E 2 x-- }
44F8: 0130 { 260 3 ---  270 3 ---  261 3 ---  271 3 --- }
44F9: 0130 { 262 3 ---  272 3 ---  263 3 ---  273 3 --- }
44FA: 0130 { 264 3 ---  214 3 ---  215 3 -y-  275 3 --- }
44FB: 0130 { 128 6 ---  138 6 ---  129 6 ---  139 6 --- }
44FC: 0130 { 12A 6 ---  13A 6 ---  12B 6 ---  13B 6 --- }
44FD: 0130 { 126 6 ---  136 6 ---  127 6 ---  137 6 --- }
44FE: 0130 { 12C 0 ---  13C 0 ---  12D 0 ---  13D 0 --- }
44FF: 0130 { 12E 0 ---  13E 0 ---  12F 0 ---  13F 0 --- }
