5600: 010A { 200 3 ---  210 3 ---  201 3 ---  211 3 --- }
5601: 010B { 202 3 ---  212 3 ---  203 3 ---  213 3 --- }
5602: 010B { 204 3 ---  214 3 ---  205 3 ---  215 3 --- }
5603: 010C { 206 3 ---  216 3 ---  207 3 ---  217 3 --- }
5604: 0130 { 220 2 ---  230 2 ---  221 2 ---  231 2 --- }
5605: 0130 { 222 2 ---  232 2 ---  223 2 ---  233 2 --- }
5606: 0130 { 21A 2 ---  21A 2 -y-  21A 2 x--  21A 2 xy- }
5607: 0130 { 22A 4 ---  23A 4 ---  22B 4 ---  23B 4 --- }
5608: 0130 { 22C 4 ---  23C 4 ---  22D 4 ---  23D 4 --- }
5609: 01AA { 0F8 2 ---  196 2 ---  187 2 ---  197 2 --- }
560A: 01AF { 187 2 x--  197 2 x--  0F8 2 ---  196 2 x-- }
560B: 0130 { 22A 4 ---  23A 4 ---  22D 4 ---  23D 4 --- }
560C: 0025 { 0F8 2 ---  0F8 2 ---  244 7 --p  254 7 --p }
560D: 0025 { 245 7 --p  255 7 --p  245 7 x-p  255 7 x-p }
560E: 0025 { 244 7 x-p  254 7 x-p  0F8 2 ---  0F8 2 --- }
560F: 001F { 264 6 ---  274 6 ---  264 6 x--  274 6 x-- }
5610: 0025 { 20A 4 ---  218 4 ---  20B 4 ---  219 4 --- }
5611: 0025 { 20B 4 x--  219 4 x--  20A 4 x--  218 4 x-- }
5612: 0025 { 228 4 ---  238 4 ---  229 4 ---  239 4 --- }
5613: 0106 { 200 3 ---  210 3 ---  207 3 ---  217 3 --- }
5614: 0130 { 20C 2 ---  21C 2 ---  20D 2 ---  21D 2 --- }
5615: 0130 { 20E 2 ---  21E 2 ---  20F 2 ---  21F 2 --- }
5616: 0130 { 224 2 ---  234 2 ---  225 2 ---  235 2 --- }
5617: 0130 { 23D 4 xy-  22D 4 xy-  23C 4 xy-  22C 4 xy- }
5618: 0130 { 23B 4 xy-  22B 4 xy-  23A 4 xy-  22A 4 xy- }
5619: 01E2 { 186 2 ---  192 2 ---  195 2 ---  193 2 --- }
561A: 01E4 { 194 2 ---  192 2 ---  186 2 x--  193 2 --- }
561B: 0130 { 23A 4 ---  23D 4 xy-  23D 4 ---  23A 4 xy- }
561C: 0025 { 0F8 2 -y-  0F8 2 -y-  254 7 -yp  244 7 -yp }
561D: 0025 { 255 7 -yp  245 7 -yp  255 7 xyp  245 7 xyp }
561E: 0025 { 254 7 xyp  244 7 xyp  0F8 2 -y-  0F8 2 -y- }
561F: 0020 { 263 6 ---  273 6 ---  265 6 ---  275 6 --- }
5620: 0025 { 208 4 ---  218 4 ---  209 4 ---  219 4 --- }
5621: 0025 { 209 4 x--  219 4 x--  208 4 x--  218 4 x-- }
5622: 0130 { 200 2 ---  210 2 ---  207 2 ---  217 2 --- }
5623: 0130 { 22A 4 ---  22D 4 xy-  22D 4 ---  22A 4 xy- }
5624: 0130 { 21B 4 x--  21B 4 xy-  21B 4 ---  21B 4 -y- }
5625: 0130 { 24A 6 ---  25A 6 ---  24A 6 x--  25A 6 x-- }
5626: 0130 { 226 2 ---  236 2 ---  227 2 ---  237 2 --- }
5627: 0130 { 22A 4 ---  22D 4 xy-  22B 4 ---  22C 4 xy- }
5628: 0130 { 22B 4 ---  22C 4 xy-  22C 4 ---  22B 4 xy- }
5629: 0130 { 22C 4 ---  22B 4 xy-  22D 4 ---  22A 4 xy- }
562A: 0130 { 192 2 ---  193 2 ---  180 3 ---  192 2 --- }
562B: 0130 { 23D 4 xy-  22D 4 xy-  23A 4 xy-  22A 4 xy- }
562C: 0130 { 0F8 2 ---  0F8 2 ---  244 7 --p  0F8 2 --- }
562D: 0130 { 244 7 x-p  0F8 2 ---  0F8 2 ---  0F8 2 --- }
562E: 0025 { 25B 2 ---  26B 2 ---  25B 2 x--  26B 2 x-- }
562F: 0025 { 27B 2 ---  277 2 ---  277 2 x--  277 2 x-- }
5630: 010A { 200 2 ---  210 2 ---  201 2 ---  211 2 --- }
5631: 010B { 202 2 ---  212 2 ---  203 2 ---  213 2 --- }
5632: 010B { 204 2 ---  214 2 ---  205 2 ---  215 2 --- }
5633: 010C { 206 2 ---  216 2 ---  207 2 ---  217 2 --- }
5634: 008D { 1AD 3 x--  1BD 3 x--  1AC 3 x--  1BC 3 x-- }
5635: 008C { 1AB 3 x--  0F8 2 x--  0F8 2 x--  0F8 2 x-- }
5636: 008C { 0F8 2 ---  0F8 2 ---  1AB 3 ---  0F8 2 --- }
5637: 008D { 1AC 3 ---  1BC 3 ---  1AD 3 ---  1BD 3 --- }
5638: 0025 { 246 7 ---  256 7 ---  247 7 ---  257 7 --- }
5639: 0025 { 2D0 7 ---  2E0 7 ---  2D1 7 ---  2E1 7 --- }
563A: 008E { 0F8 2 xy-  1CD 3 xy-  0F8 2 xy-  1CC 3 xy- }
563B: 0025 { 26A 7 -y-  278 7 -y-  26A 7 xy-  278 7 xy- }
563C: 0130 { 267 7 x--  262 7 x--  266 7 x--  276 7 x-- }
563D: 008E { 0F8 2 -y-  1CC 3 -y-  0F8 2 -y-  1CD 3 -y- }
563E: 0025 { 0F8 2 -y-  0F8 2 -y-  20A 4 ---  218 4 --- }
563F: 0025 { 20B 4 ---  219 4 ---  0F8 2 -y-  0F8 2 -y- }
5640: 0130 { 24C 6 ---  25C 6 ---  24D 6 ---  25D 6 --- }
5641: 0130 { 24E 6 ---  25E 6 ---  24F 6 ---  25F 6 --- }
5642: 0025 { 26E 6 ---  27E 6 ---  26F 6 ---  27F 6 --- }
5643: 0025 { 26F 6 x--  27F 6 x--  26E 6 x--  27E 6 x-- }
5644: 008E { 1CD 3 x--  0F8 2 x--  1CC 3 x--  0F8 2 x-- }
5645: 011C { 260 2 ---  270 2 ---  261 2 ---  271 2 --- }
5646: 0120 { 260 2 ---  270 2 ---  261 2 ---  271 2 --- }
5647: 008E { 1CC 3 ---  0F8 2 ---  1CD 3 ---  0F8 2 --- }
5648: 0025 { 278 7 ---  26A 7 ---  278 7 x--  26A 7 x-- }
5649: 0006 { 2A2 7 ---  2B2 7 ---  2A3 7 ---  2B3 7 --- }
564A: 008D { 1BD 3 xy-  1AD 3 xy-  1BC 3 xy-  1AC 3 xy- }
564B: 008C { 0F8 2 xy-  1AB 3 xy-  0F8 2 xy-  0F8 2 xy- }
564C: 008C { 0F8 2 -y-  0F8 2 -y-  0F8 2 -y-  1AB 3 -y- }
564D: 008D { 1BC 3 -y-  1AC 3 -y-  1BD 3 -y-  1AD 3 -y- }
564E: 0025 { 0F8 2 -y-  0F8 2 -y-  208 4 ---  218 4 --- }
564F: 0025 { 209 4 ---  219 4 ---  0F8 2 -y-  0F8 2 -y- }
5650: 0130 { 24B 6 ---  24F 6 xy-  26C 6 ---  27C 6 --- }
5651: 0130 { 26D 6 ---  27D 6 ---  24B 6 x--  24F 6 -y- }
5652: 0025 { 27E 6 -y-  26E 6 -y-  27F 6 -y-  26F 6 -y- }
5653: 0025 { 27F 6 xy-  26F 6 xy-  27E 6 xy-  26E 6 xy- }
5654: 007A { 0F8 7 ---  185 3 x--  182 3 x--  184 3 x-- }
5655: 007B { 181 3 x--  183 3 x--  180 3 x--  0F8 7 --- }
5656: 007E { 180 3 ---  0F8 7 ---  181 3 ---  183 3 --- }
5657: 007F { 182 3 ---  184 3 ---  0F8 7 ---  185 3 --- }
5658: 0025 { 26A 7 -y-  26A 7 -y-  26A 7 xy-  26A 7 xy- }
5659: 0006 { 2C2 7 ---  2D2 7 ---  2C3 7 ---  2D3 7 --- }
565A: 01AA { 0F8 2 ---  196 2 ---  187 2 ---  197 2 --- }
565B: 01AF { 187 2 x--  197 2 x--  0F8 2 ---  196 2 x-- }
565C: 0025 { 187 2 x--  0F8 2 -yp  0F8 2 -yp  0F8 2 -yp }
565D: 0025 { 0F8 2 xyp  0F8 2 xyp  187 2 ---  0F8 2 xyp }
565E: 012F { 1EC 2 ---  1EC 2 ---  1ED 2 ---  1ED 2 --- }
565F: 0006 { 2A2 7 ---  2B2 7 ---  2A3 7 ---  2B3 7 --- }
5660: 0130 { 264 6 ---  274 6 ---  265 6 ---  275 6 --- }
5661: 0130 { 265 6 x--  275 6 x--  264 6 x--  274 6 x-- }
5662: 0130 { 260 6 ---  270 6 ---  261 6 ---  271 6 --- }
5663: 0130 { 260 2 ---  270 2 ---  261 2 ---  271 2 --- }
5664: 007C { 0F8 7 ---  185 3 x--  185 3 x--  184 3 x-- }
5665: 007D { 184 3 x--  183 3 x--  183 3 x--  0F8 7 --- }
5666: 0080 { 183 3 ---  0F8 7 ---  184 3 ---  183 3 --- }
5667: 0081 { 185 3 ---  184 3 ---  0F8 7 ---  185 3 --- }
5668: 0025 { 256 7 -y-  246 7 -y-  257 7 -y-  247 7 -y- }
5669: 0130 { 27A 4 ---  250 4 ---  27A 4 x--  250 4 x-- }
566A: 01E2 { 186 2 ---  192 2 ---  195 2 ---  193 2 --- }
566B: 01E4 { 194 2 ---  192 2 ---  186 2 x--  193 2 --- }
566C: 0025 { 0F8 2 -yp  243 7 --p  0F8 2 -yp  279 7 --p }
566D: 0025 { 0F8 2 xyp  279 7 x-p  0F8 2 xyp  243 7 x-p }
566E: 012F { 1ED 2 x--  1ED 2 x--  1EC 2 x--  1EC 2 x-- }
566F: 0006 { 2C2 7 ---  2D2 7 ---  2C3 7 ---  2D3 7 --- }
5670: 0130 { 240 4 ---  250 4 ---  241 4 ---  251 4 --- }
5671: 0130 { 241 4 ---  252 4 ---  241 4 ---  253 4 --- }
5672: 0130 { 241 4 x--  253 4 x--  241 4 x--  252 4 x-- }
5673: 0130 { 241 4 x--  251 4 x--  240 4 x--  250 4 x-- }
5674: 0130 { 250 4 ---  250 4 -y-  251 4 ---  251 4 -y- }
5675: 0130 { 252 4 ---  252 4 -y-  252 4 x--  252 4 xy- }
5676: 0130 { 240 4 ---  240 4 -y-  241 4 ---  241 4 -y- }
5677: 0130 { 241 4 ---  241 4 -y-  241 4 x--  241 4 xy- }
5678: 0130 { 241 4 x--  241 4 xy-  240 4 x--  240 4 xy- }
5679: 0130 { 240 4 ---  250 4 ---  240 4 x--  250 4 x-- }
567A: 0025 { 0F8 2 -yp  243 7 --p  0F8 2 -yp  243 7 x-p }
567B: 0025 { 192 2 --p  2C4 7 --p  193 2 --p  2C4 7 x-p }
567C: 0025 { 192 2 ---  192 2 --p  2C5 7 ---  192 2 --p }
567D: 0025 { 2C5 7 x--  192 2 --p  192 2 ---  192 2 --p }
567E: 012F { 1CE 2 ---  1DE 2 ---  1CE 2 ---  1DE 2 --- }
567F: 012F { 1DE 2 -y-  1CE 2 -y-  1DE 2 -y-  1CE 2 -y- }
5680: 0130 { 250 4 -y-  240 4 -y-  251 4 -y-  241 4 -y- }
5681: 0130 { 252 4 -y-  241 4 -y-  253 4 -y-  241 4 -y- }
5682: 0130 { 253 4 xy-  241 4 xy-  252 4 xy-  241 4 xy- }
5683: 0130 { 251 4 xy-  241 4 xy-  250 4 xy-  240 4 xy- }
5684: 0130 { 251 4 x--  251 4 xy-  250 4 x--  250 4 xy- }
5685: 0130 { 241 4 ---  253 4 ---  241 4 x--  253 4 x-- }
5686: 0130 { 242 4 ---  240 4 -y-  241 4 ---  241 4 -y- }
5687: 0130 { 241 4 x--  241 4 xy-  242 4 x--  240 4 xy- }
5688: 0130 { 27A 4 ---  250 4 ---  241 4 ---  251 4 --- }
5689: 0130 { 250 4 -y-  250 4 -y-  250 4 xy-  250 4 xy- }
568A: 0130 { 241 4 x--  251 4 x--  27A 4 x--  250 4 x-- }
568B: 0130 { 250 4 -y-  27A 4 -y-  250 4 xy-  27A 4 xy- }
568C: 0025 { 243 7 -yp  0F8 2 --p  243 7 xyp  0F8 2 --p }
568D: 0025 { 192 2 -yp  192 2 -y-  192 2 -yp  2C5 7 -y- }
568E: 0025 { 192 2 -yp  2C5 7 xy-  192 2 -yp  192 2 -y- }
568F: ~
5690: 0025 { 248 3 ---  1BE 3 ---  19F 3 ---  1AF 3 --- }
5691: 0025 { 19F 3 x--  1AF 3 x--  248 3 x--  1BE 3 x-- }
5692: 0025 { 0F8 4 -y-  0F8 4 -y-  248 4 ---  1BE 4 --- }
5693: 0025 { 19F 4 ---  1AF 4 ---  19F 4 x--  1AF 4 x-- }
5694: 0025 { 248 4 x--  1BE 4 x--  0F8 4 -y-  0F8 4 -y- }
5695: 0025 { 22E 7 ---  2C4 7 --p  22F 7 ---  23F 7 --- }
5696: 0025 { 2E4 7 ---  2F4 7 ---  2E5 7 ---  2F5 7 --- }
5697: 0025 { 2E2 7 ---  2F2 7 ---  2E3 7 ---  2F3 7 --- }
5698: ~
5699: ~
569A: ~
569B: ~
569C: ~
569D: ~
569E: ~
569F: ~
56A0: 0025 { 1BE 3 ---  1BE 3 ---  1BF 3 ---  1CF 3 --- }
56A1: 0025 { 1BF 3 x--  1CF 3 x--  1BE 3 x--  1BE 3 x-- }
56A2: 0025 { 0F8 4 -y-  0F8 4 -y-  1BE 4 ---  1BE 4 --- }
56A3: 0025 { 1BF 4 ---  1CF 4 ---  1BF 4 x--  1CF 4 x-- }
56A4: 0025 { 1BE 4 x--  1BE 4 x--  0F8 4 -y-  0F8 4 -y- }
56A5: 0025 { 193 2 ---  0F8 2 -yp  258 7 ---  268 7 --- }
56A6: 0025 { 259 7 ---  269 7 ---  192 2 ---  192 2 --p }
56A7: 0130 { 2E3 7 x--  2F3 7 x--  2E2 7 x--  2F2 7 x-- }
56A8: ~
56A9: ~
56AA: ~
56AB: ~
56AC: ~
56AD: ~
56AE: ~
56AF: ~
56B0: 0025 { 1BE 3 ---  249 3 ---  1DF 3 ---  1EF 3 --- }
56B1: 0025 { 1DF 3 x--  1EF 3 x--  1BE 3 x--  249 3 x-- }
56B2: 0025 { 0F8 4 -y-  0F8 4 -y-  1BE 4 ---  249 4 --- }
56B3: 0025 { 1DF 4 ---  1EF 4 ---  1DF 4 x--  1EF 4 x-- }
56B4: 0025 { 1BE 4 x--  249 4 x--  0F8 4 -y-  0F8 4 -y- }
56B5: 0130 { 267 7 x--  262 7 x--  266 7 x--  276 7 x-- }
56B6: ~
56B7: ~
56B8: ~
56B9: ~
56BA: ~
56BB: ~
56BC: ~
56BD: ~
56BE: ~
56BF: ~
56C0: 0130 { 24C 6 ---  25C 6 ---  24D 6 ---  25D 6 --- }
56C1: 0130 { 24E 6 ---  25E 6 ---  24F 6 ---  25F 6 --- }
56C2: ~
56C3: ~
56C4: ~
56C5: ~
56C6: ~
56C7: ~
56C8: ~
56C9: ~
56CA: ~
56CB: ~
56CC: ~
56CD: ~
56CE: ~
56CF: ~
56D0: 0130 { 24B 6 ---  24F 6 xy-  26C 6 ---  27C 6 --- }
56D1: 0130 { 26D 6 ---  27D 6 ---  24B 6 x--  24F 6 -y- }
56D2: ~
56D3: ~
56D4: ~
56D5: ~
56D6: ~
56D7: ~
56D8: ~
56D9: ~
56DA: ~
56DB: ~
56DC: ~
56DD: 0130 { 004 4 ---  004 4 ---  19E 3 ---  1AE 3 --- }
56DE: 0130 { 19F 3 ---  1AF 3 ---  19F 3 x--  1AF 3 x-- }
56DF: 0130 { 19E 3 x--  1AE 3 x--  120 3 ---  120 3 -y- }
56E0: 0130 { 26E 6 ---  27E 6 ---  26F 6 ---  27F 6 --- }
56E1: 0130 { 26F 6 x--  27F 6 x--  26E 6 x--  27E 6 x-- }
56E2: ~
56E3: ~
56E4: ~
56E5: ~
56E6: ~
56E7: ~
56E8: ~
56E9: ~
56EA: ~
56EB: ~
56EC: ~
56ED: 0130 { 0F8 7 ---  0F8 7 ---  1BE 3 ---  1BE 3 --- }
56EE: 0130 { 1BF 3 ---  1CF 3 ---  1BF 3 x--  1CF 3 x-- }
56EF: 0130 { 1BE 3 x--  1BE 3 x--  0F8 7 ---  0F8 7 --- }
56F0: 0130 { 27E 6 -y-  26E 6 -y-  27F 6 -y-  26F 6 -y- }
56F1: 0130 { 27F 6 xy-  26F 6 xy-  27E 6 xy-  26E 6 xy- }
56F2: ~
56F3: ~
56F4: ~
56F5: ~
56F6: ~
56F7: ~
56F8: ~
56F9: ~
56FA: ~
56FB: ~
56FC: ~
56FD: 0130 { 18D 3 ---  18C 3 ---  1BE 3 ---  1EE 3 --- }
56FE: 0130 { 1DF 3 ---  1EF 3 ---  1DF 3 x--  1EF 3 x-- }
56FF: 0130 { 1BE 3 x--  1EE 3 x--  18D 3 x--  18C 3 x-- }
