7500: 0025 { 191 5 ---  100 5 ---  191 5 ---  101 5 --- }
7501: 0025 { 191 5 ---  102 5 ---  191 5 ---  101 5 --- }
7502: 0025 { 191 5 x--  101 5 x--  191 5 x--  102 5 x-- }
7503: 0025 { 191 5 x--  101 5 x--  191 5 x--  100 5 x-- }
7504: 0025 { 0F8 6 x--  108 1 ---  0F8 6 x--  109 1 --- }
7505: 0025 { 0F8 6 x--  109 1 ---  0F8 6 x--  109 1 --- }
7506: 0025 { 0F8 6 x--  109 1 ---  0F8 6 x--  10A 1 --- }
7507: 0025 { 0F8 6 x--  10A 1 x--  0F8 6 x--  109 1 x-- }
7508: 0025 { 0F8 6 x--  109 1 x--  0F8 6 x--  109 1 x-- }
7509: 0025 { 0F8 6 x--  109 1 x--  0F8 6 x--  108 1 x-- }
750A: 0130 { 0C6 4 x--  0D6 4 x--  0CA 4 x--  0C7 4 x-- }
750B: 0130 { 0F8 5 x--  0C6 4 x--  0F8 5 x--  0CA 4 x-- }
750C: 0025 { 0F8 6 x--  0F8 6 x--  0F8 6 x--  18C 4 --- }
750D: 0025 { 0F8 6 x--  18D 4 ---  0F8 6 x--  0F8 6 x-- }
750E: 0025 { 0F8 6 x--  24A 1 -y-  0F8 6 x--  25B 6 --- }
750F: 0025 { 0F8 6 x--  268 6 ---  0F8 6 x--  269 6 --- }
7510: 0025 { 110 5 ---  120 5 ---  111 5 ---  121 5 --- }
7511: 0025 { 112 5 ---  122 5 ---  111 5 ---  121 5 --- }
7512: 0025 { 111 5 x--  121 5 x--  112 5 x--  122 5 x-- }
7513: 0025 { 111 5 x--  121 5 x--  110 5 x--  120 5 x-- }
7514: 0025 { 148 1 -y-  178 1 -y-  119 1 ---  129 1 --- }
7515: 0025 { 11A 1 ---  0F8 6 x--  11B 1 ---  0F8 6 x-- }
7516: 0025 { 11B 1 ---  0F8 6 x--  11D 1 ---  12D 1 --- }
7517: 0025 { 11D 1 x--  12D 1 x--  11B 1 x--  0F8 6 x-- }
7518: 0025 { 11B 1 x--  0F8 6 x--  11A 1 x--  0F8 6 x-- }
7519: 0025 { 119 1 x--  129 1 x--  148 1 xy-  178 1 xy- }
751A: 0130 { 0F2 4 x--  0F8 5 x--  0F3 4 x--  0F8 5 x-- }
751B: 0130 { 0CD 4 x--  0F8 5 x--  0CC 4 x--  0B9 4 x-- }
751C: 0025 { 18E 4 ---  194 4 ---  18F 4 ---  195 4 --- }
751D: 0025 { 18F 4 x--  195 4 x--  18E 4 x--  194 4 x-- }
751E: 0025 { 26A 6 ---  24A 1 ---  26B 6 ---  27A 6 --- }
751F: 0025 { 278 6 ---  27B 6 ---  279 6 ---  24A 1 x-- }
7520: 0025 { 130 5 ---  140 5 ---  131 5 ---  141 5 --- }
7521: 0025 { 132 5 ---  142 5 ---  131 5 ---  141 5 --- }
7522: 0025 { 131 5 x--  141 5 x--  132 5 x--  142 5 x-- }
7523: 0025 { 131 5 x--  141 5 x--  130 5 x--  140 5 x-- }
7524: 0025 { 168 1 -y-  158 1 -y-  139 1 ---  149 1 --- }
7525: 0025 { 0F8 6 x--  14A 1 ---  0F8 6 x--  14A 1 --- }
7526: 0025 { 0F8 6 x--  14A 1 ---  12D 1 ---  14D 1 --- }
7527: 0025 { 12D 1 x--  14D 1 x--  0F8 6 x--  14A 1 x-- }
7528: 0025 { 0F8 6 x--  14A 1 x--  0F8 6 x--  14A 1 x-- }
7529: 0025 { 139 1 x--  149 1 x--  168 1 xy-  158 1 xy- }
752A: 0130 { 0F8 5 ---  0CA 4 ---  0F8 5 ---  0F7 4 --- }
752B: 0130 { 0F8 5 x--  0F7 4 x--  0F8 5 x--  0CA 4 x-- }
752C: 0025 { 0F8 6 x--  235 1 ---  0F8 6 x--  236 1 --- }
752D: 0025 { 0F8 6 x--  22E 1 ---  0F8 6 x--  0F8 5 x-- }
752E: 0025 { 23B 1 ---  21F 1 ---  23C 1 ---  22F 1 --- }
752F: 0025 { 23D 1 ---  248 1 ---  0F8 6 x--  249 1 --- }
7530: 0025 { 150 5 ---  160 5 ---  151 5 ---  161 5 --- }
7531: 0025 { 152 5 ---  162 5 ---  151 5 ---  161 5 --- }
7532: 0025 { 151 5 x--  161 5 x--  152 5 x--  162 5 x-- }
7533: 0025 { 151 5 x--  161 5 x--  150 5 x--  160 5 x-- }
7534: 0020 { 114 1 ---  124 1 ---  159 1 ---  169 1 --- }
7535: 0020 { 15A 1 ---  16A 1 ---  15B 1 ---  16A 1 --- }
7536: 0020 { 15C 1 ---  16C 1 ---  15D 1 ---  16D 1 --- }
7537: 0020 { 15D 1 x--  16D 1 x--  15C 1 x--  16C 1 x-- }
7538: 0020 { 15B 1 x--  16A 1 ---  15A 1 x--  16A 1 x-- }
7539: 0020 { 159 1 x--  169 1 x--  115 1 ---  125 1 --- }
753A: 0130 { 0F8 5 x--  17F 0 ---  0F3 4 x--  0F8 5 x-- }
753B: 0130 { 0F3 4 ---  2F6 0 ---  0F8 5 ---  10E 0 --- }
753C: 0025 { 197 4 ---  183 1 ---  220 1 ---  184 1 --- }
753D: 0025 { 25A 1 ---  185 1 ---  182 1 ---  186 1 --- }
753E: 0025 { 24A 1 ---  0F8 6 x--  24B 1 ---  0F8 6 x-- }
753F: 0025 { 258 1 ---  0F8 6 x--  259 1 ---  0F8 6 x-- }
7540: 0025 { 170 5 ---  104 5 ---  171 5 ---  105 5 --- }
7541: 0025 { 172 5 ---  106 5 ---  171 5 ---  105 5 --- }
7542: 0025 { 171 5 x--  105 5 x--  172 5 x--  106 5 x-- }
7543: 0025 { 171 5 x--  105 5 x--  170 5 x--  104 5 x-- }
7544: 0020 { 134 1 ---  144 1 ---  179 1 ---  116 1 --- }
7545: 0020 { 17A 1 ---  117 1 ---  17B 1 ---  118 1 --- }
7546: 0020 { 17C 1 ---  126 1 ---  17D 1 ---  127 1 --- }
7547: 0020 { 17D 1 x--  127 1 x--  17C 1 x--  126 1 x-- }
7548: 0020 { 17B 1 x--  118 1 x--  17A 1 x--  117 1 x-- }
7549: 0020 { 179 1 x--  116 1 x--  135 1 ---  145 1 --- }
754A: 0025 { 187 4 ---  197 4 ---  1AC 4 ---  1AD 4 --- }
754B: 0025 { 1AC 4 x--  1AD 4 x--  187 4 x--  197 4 x-- }
754C: 0025 { 187 4 ---  197 4 ---  188 4 ---  198 4 --- }
754D: 0025 { 189 4 ---  199 4 ---  187 4 x--  197 4 x-- }
754E: 0025 { 0F8 6 x--  0F8 6 x--  0F8 6 x--  229 6 --- }
754F: 0025 { 0F8 6 x--  22A 6 ---  0F8 6 x--  0F8 6 x-- }
7550: 0130 { 0CB 4 x--  0A9 4 ---  0CA 4 x--  0B8 4 --- }
7551: 0025 { 0F8 5 x--  2F6 0 ---  0F8 5 x--  10E 0 --- }
7552: 0025 { 0F8 5 x--  10F 0 ---  0F8 5 x--  136 0 --- }
7553: 0025 { 0F8 5 x--  137 0 ---  0F8 5 x--  17E 0 --- }
7554: 0025 { 0F8 5 x--  17F 0 ---  0F8 5 x--  0F8 5 x-- }
7555: 0025 { 083 2 ---  0BC 4 ---  084 2 ---  0BD 4 --- }
7556: 0130 { 0F8 5 ---  0CA 4 ---  0F8 5 ---  0C6 4 --- }
7557: 0130 { 0CA 4 ---  0C7 4 ---  0C6 4 ---  0D6 4 --- }
7558: 0130 { 0E7 4 ---  0D7 4 ---  0F6 4 ---  0E6 4 --- }
7559: 0130 { 0F6 4 x--  0E6 4 x--  0E7 4 x--  0D7 4 x-- }
755A: 0025 { 1AE 4 ---  0F8 6 x--  1AF 4 ---  0F8 6 x-- }
755B: 0025 { 1AF 4 x--  0F8 6 x--  1AE 4 x--  0F8 6 x-- }
755C: 0025 { 18A 4 ---  0F8 6 x--  18B 4 ---  0F8 6 x-- }
755D: 0025 { 18B 4 x--  0F8 6 x--  18A 4 x--  0F8 6 x-- }
755E: 0025 { 20B 6 ---  0F8 6 x--  239 6 ---  23A 6 --- }
755F: 0025 { 239 6 x--  23A 6 x--  20B 6 x--  0F8 6 x-- }
7560: 0025 { 0F8 5 x--  0B8 4 ---  0F8 5 x--  0B8 4 --- }
7561: 0025 { 2F6 0 -y-  0F8 5 x--  11E 0 ---  12E 0 --- }
7562: 0025 { 11F 0 ---  12F 0 ---  146 0 ---  156 0 --- }
7563: 0025 { 147 0 ---  157 0 ---  10B 0 ---  10D 0 --- }
7564: 0025 { 10C 0 ---  174 0 ---  0F8 5 x--  175 0 --- }
7565: 0130 { 0CA 4 ---  0B8 4 x--  0CB 4 ---  0A9 4 x-- }
7566: 0130 { 0CC 4 ---  0B9 4 ---  0CD 4 ---  0F8 5 --- }
7567: 0130 { 0F3 4 ---  0F8 5 ---  0F2 4 ---  0F8 5 --- }
7568: 0025 { 0F8 5 x--  207 3 ---  0F8 5 x--  208 3 --- }
7569: 0025 { 0F8 5 x--  209 3 ---  0F8 5 x--  20A 3 --- }
756A: 0025 { 0F8 5 x--  208 3 x--  0F8 5 x--  207 3 x-- }
756B: 0025 { 0F8 5 x--  209 3 ---  0F8 5 x--  20A 3 --- }
756C: 0025 { 0F8 5 x--  209 3 ---  0F8 5 x--  20A 3 --- }
756D: 0025 { 0F8 5 x--  208 3 x--  0F8 5 x--  207 3 x-- }
756E: 0025 { 0F8 6 x--  21B 6 ---  20C 6 ---  21C 6 --- }
756F: 0025 { 20D 6 ---  21D 6 ---  20E 6 ---  21E 6 --- }
7570: 0025 { 2CB 0 x--  133 0 ---  12A 0 ---  13A 0 --- }
7571: 0025 { 12B 0 ---  13B 0 ---  13E 0 ---  14E 0 --- }
7572: 0025 { 13F 0 ---  14F 0 ---  166 0 ---  176 0 --- }
7573: 0025 { 167 0 ---  177 0 ---  128 0 ---  11C 0 --- }
7574: 0025 { 138 0 ---  14B 0 ---  113 0 ---  14C 0 --- }
7575: 0025 { 123 0 ---  16B 0 ---  2CB 0 ---  103 0 --- }
7576: 0025 { 0F8 5 x--  0F8 5 x--  0F8 5 x--  0A8 4 --- }
7577: 0025 { 0F8 5 x--  0A9 4 ---  0F8 5 x--  0B8 4 --- }
7578: 0025 { 217 3 ---  0F8 5 x--  218 3 ---  0F8 5 x-- }
7579: 0025 { 219 3 ---  0F8 5 x--  21A 3 ---  0F8 5 x-- }
757A: 0025 { 218 3 x--  0F8 5 x--  217 3 x--  0F8 5 x-- }
757B: 0025 { 219 3 ---  0F8 5 x--  21A 3 ---  24C 1 --- }
757C: 0025 { 219 3 ---  24D 1 ---  21A 3 ---  24E 1 --- }
757D: 0025 { 218 3 x--  24F 1 ---  217 3 x--  0F8 5 x-- }
757E: 0025 { 22B 6 ---  0F8 6 x--  22C 6 ---  0F8 6 x-- }
757F: 0025 { 22D 6 ---  0F8 6 x--  20F 4 ---  0F8 6 x-- }
7580: 0025 { 143 0 ---  173 0 ---  153 0 ---  2E5 0 --- }
7581: 0025 { 163 0 ---  2F5 0 ---  15E 0 ---  16E 0 --- }
7582: 0025 { 15F 0 ---  16F 0 ---  154 0 ---  164 0 --- }
7583: 0025 { 155 0 ---  165 0 ---  12C 0 ---  13C 0 --- }
7584: 0025 { 2BB 0 ---  13D 0 ---  2BC 0 ---  2AF 0 --- }
7585: 0025 { 2BD 0 ---  2BF 0 ---  2BE 0 ---  2B7 0 --- }
7586: 0025 { 0F8 5 ---  0B8 4 x--  0F8 5 ---  0A9 4 x-- }
7587: 0025 { 0F8 5 ---  0A8 4 x--  0F8 5 ---  0F8 5 --- }
7588: 0025 { 180 5 ---  190 5 ---  181 5 ---  191 5 --- }
7589: 0025 { 181 5 ---  192 5 ---  181 5 ---  193 5 --- }
758A: 0025 { 181 5 ---  193 5 ---  181 5 ---  193 5 --- }
758B: 0025 { 181 5 ---  193 5 ---  181 5 x--  193 5 --- }
758C: 0025 { 181 5 x--  193 5 ---  181 5 x--  193 5 --- }
758D: 0025 { 181 5 x--  19A 5 ---  181 5 x--  191 5 --- }
758E: 0025 { 181 5 x--  191 5 ---  181 5 x--  191 5 --- }
758F: 0025 { 181 5 x--  191 5 ---  180 5 x--  190 5 x-- }
7590: 0025 { 0F8 5 x--  0F8 5 x--  223 4 ---  233 4 --- }
7591: 0025 { 224 4 ---  234 4 ---  227 4 ---  237 4 --- }
7592: 0025 { 227 4 ---  237 4 ---  227 4 ---  237 4 --- }
7593: 0025 { 0AC 4 ---  0BC 4 ---  0A7 4 ---  0B7 4 --- }
7594: 0025 { 0F8 5 x--  231 1 ---  230 1 ---  200 6 --- }
7595: 0025 { 232 1 ---  201 6 ---  225 1 -y-  202 6 --- }
7596: 0025 { 225 1 -y-  203 6 ---  225 1 -y-  204 6 --- }
7597: 0025 { 225 1 -y-  205 6 ---  226 1 -y-  206 6 --- }
7598: 0025 { 190 5 ---  1B0 5 ---  191 5 ---  1B1 5 --- }
7599: 0025 { 1A2 5 ---  1B2 5 ---  1A3 5 ---  1B3 5 --- }
759A: 0025 { 1A4 5 ---  1B4 5 ---  1A5 5 ---  1B5 5 --- }
759B: 0025 { 1A6 5 ---  1B6 5 ---  1A7 5 ---  1B7 5 --- }
759C: 0025 { 1A8 5 ---  1B8 5 ---  1A9 5 ---  1B9 5 --- }
759D: 0025 { 1AA 5 ---  1BA 5 ---  191 5 ---  1BB 5 --- }
759E: 0025 { 191 5 ---  1BC 5 ---  191 5 ---  1BD 5 --- }
759F: 0025 { 191 5 ---  1BE 5 ---  190 5 x--  1BF 5 --- }
75A0: 0025 { 264 1 ---  263 1 ---  265 1 ---  255 1 --- }
75A1: 0025 { 253 1 ---  263 1 ---  254 1 ---  264 1 --- }
75A2: 0025 { 255 1 ---  265 1 ---  256 1 ---  266 1 --- }
75A3: 0025 { 0A6 4 ---  0B6 4 ---  0AD 4 ---  0BD 4 --- }
75A4: 0025 { 0F8 5 x--  0F8 5 x--  210 6 ---  23E 1 --- }
75A5: 0025 { 211 6 ---  221 6 ---  212 6 ---  225 1 --- }
75A6: 0025 { 213 6 ---  225 1 ---  214 6 ---  225 1 --- }
75A7: 0025 { 215 6 ---  225 1 ---  216 6 ---  226 1 --- }
75A8: 0025 { 1C0 5 ---  1D0 5 ---  1C1 5 ---  1D1 5 --- }
75A9: 0025 { 1C2 5 ---  1D2 5 ---  1C3 5 ---  1D3 5 --- }
75AA: 0025 { 1C4 5 ---  1D4 5 ---  1C5 5 ---  1D5 5 --- }
75AB: 0025 { 1C6 5 ---  1D6 5 ---  1C7 5 ---  1D7 5 --- }
75AC: 0025 { 1C8 5 ---  1D8 5 ---  1C9 5 ---  1D9 5 --- }
75AD: 0025 { 1CA 5 ---  1DA 5 ---  1CB 5 ---  1DB 5 --- }
75AE: 0025 { 1CC 5 ---  1DC 5 ---  1CD 5 ---  1DD 5 --- }
75AF: 0025 { 1CE 5 ---  1DE 5 ---  1CF 5 ---  1DF 5 --- }
75B0: 0025 { 264 1 ---  254 1 ---  265 1 ---  266 1 --- }
75B1: 0025 { 253 1 ---  263 1 ---  254 1 ---  264 1 --- }
75B2: 0025 { 255 1 ---  265 1 ---  256 1 ---  266 1 --- }
75B3: 0025 { 0AC 4 ---  0BC 4 ---  0AD 4 ---  0BD 4 --- }
75B4: 0025 { 0A6 4 ---  0B6 4 ---  0A7 4 ---  0B7 4 --- }
75B5: 0025 { 0F8 5 x--  0F8 5 x--  0F8 5 x--  24C 1 --- }
75B6: 0025 { 0F8 5 x--  24D 1 ---  0F8 5 x--  24E 1 --- }
75B7: 0025 { 0F8 5 x--  24F 1 ---  0F8 5 x--  0F8 5 x-- }
75B8: 0025 { 1E0 5 ---  1F0 5 ---  1E1 5 ---  1F1 5 --- }
75B9: 0025 { 1E2 5 ---  1F2 5 ---  1E3 5 ---  1F3 5 --- }
75BA: 0025 { 1E4 5 ---  1F4 5 ---  1E5 5 ---  1F5 5 --- }
75BB: 0025 { 1E6 5 ---  1F6 5 ---  1E7 5 ---  1F7 5 --- }
75BC: 0025 { 1E8 5 ---  1F8 5 ---  1E9 5 ---  1F9 5 --- }
75BD: 0025 { 1EA 5 ---  1FA 5 ---  1EB 5 ---  1FB 5 --- }
75BE: 0025 { 1EC 5 ---  1FC 5 ---  1ED 5 ---  1FD 5 --- }
75BF: 0025 { 1EE 5 ---  1FE 5 ---  1EF 5 ---  1FF 5 --- }
75C0: 0025 { 191 5 x--  191 5 x--  191 5 x--  191 5 x-- }
75C1: 0025 { 253 1 ---  263 1 ---  254 1 ---  264 1 --- }
75C2: 0025 { 255 1 ---  265 1 ---  256 1 ---  266 1 --- }
75C3: 0025 { 227 4 x--  237 4 x--  224 4 x--  234 4 x-- }
75C4: 0025 { 223 4 x--  233 4 x--  0F8 5 ---  0F8 5 --- }
75C5: 0025 { 0F8 5 x--  23E 1 ---  25C 1 ---  26C 1 --- }
75C6: 0025 { 25D 1 ---  26D 1 ---  25E 1 ---  26E 1 --- }
75C7: 0025 { 25F 1 ---  26F 1 ---  0F8 5 x--  23F 1 --- }
75C8: 0025 { 180 5 ---  190 5 ---  181 5 ---  191 5 x-- }
75C9: 0025 { 181 5 ---  191 5 x--  181 5 ---  191 5 x-- }
75CA: 0025 { 181 5 ---  191 5 x--  181 5 ---  19A 5 x-- }
75CB: 0025 { 181 5 ---  193 5 x--  181 5 ---  193 5 x-- }
75CC: 0025 { 181 5 ---  193 5 x--  181 5 x--  193 5 x-- }
75CD: 0025 { 181 5 x--  193 5 x--  181 5 x--  193 5 x-- }
75CE: 0025 { 181 5 x--  193 5 x--  181 5 x--  192 5 x-- }
75CF: 0025 { 181 5 x--  191 5 x--  180 5 x--  190 5 x-- }
75D0: 0025 { 264 1 ---  254 1 ---  265 1 ---  255 1 --- }
75D1: 0025 { 253 1 ---  263 1 ---  254 1 ---  264 1 --- }
75D2: 0025 { 255 1 ---  265 1 ---  256 1 ---  266 1 --- }
75D3: 0025 { 228 4 x--  238 4 x--  227 4 x--  237 4 x-- }
75D4: 0025 { 227 4 ---  237 4 ---  228 4 ---  238 4 --- }
75D5: 0025 { 0F8 5 x--  0F8 5 x--  27C 1 ---  0F8 5 x-- }
75D6: 0025 { 27D 1 ---  0F8 5 x--  27E 1 ---  0F8 5 x-- }
75D7: 0025 { 27F 1 ---  0F8 5 x--  0F8 5 x--  0F8 5 x-- }
75D8: 0025 { 190 5 ---  1BF 5 x--  191 5 x--  1BE 5 x-- }
75D9: 0025 { 191 5 x--  1BD 5 x--  191 5 x--  1BC 5 x-- }
75DA: 0025 { 191 5 x--  1BB 5 x--  1AA 5 x--  1BA 5 x-- }
75DB: 0025 { 1A9 5 x--  1B9 5 x--  1A8 5 x--  1B8 5 x-- }
75DC: 0025 { 1A7 5 x--  1B7 5 x--  1A6 5 x--  1B6 5 x-- }
75DD: 0025 { 1A5 5 x--  1B5 5 x--  1A4 5 x--  1B4 5 x-- }
75DE: 0025 { 1A3 5 x--  1B3 5 x--  1A2 5 x--  1B2 5 x-- }
75DF: 0025 { 191 5 x--  1B1 5 x--  190 5 x--  1B0 5 x-- }
75E0: 0025 { 0F8 5 x--  0F8 5 x--  240 1 ---  250 1 --- }
75E1: 0025 { 241 1 ---  251 1 ---  242 1 ---  252 1 --- }
75E2: 0025 { 243 1 ---  251 1 ---  244 1 ---  252 1 --- }
75E3: 0025 { 245 1 ---  251 1 ---  246 1 ---  252 1 --- }
75E4: 0025 { 247 1 ---  257 1 ---  0F8 5 x--  0F8 5 x-- }
75E5: 0025 { 0F8 5 x--  0F8 5 x--  24C 1 ---  25C 1 --- }
75E6: 0025 { 24D 1 ---  25D 1 ---  24E 1 ---  25E 1 --- }
75E7: 0025 { 24F 1 ---  25F 1 ---  0F8 5 x--  0F8 5 x-- }
75E8: 0025 { 1CF 5 x--  1DF 5 x--  1CE 5 x--  1DE 5 x-- }
75E9: 0025 { 1CD 5 x--  1DD 5 x--  1CC 5 x--  1DC 5 x-- }
75EA: 0025 { 1CB 5 x--  1DB 5 x--  1CA 5 x--  1DA 5 x-- }
75EB: 0025 { 1C9 5 x--  1D9 5 x--  1C8 5 x--  1D8 5 x-- }
75EC: 0025 { 1C7 5 x--  1D7 5 x--  1C6 5 x--  1D6 5 x-- }
75ED: 0025 { 1C5 5 x--  1D5 5 x--  1C4 5 x--  1D4 5 x-- }
75EE: 0025 { 1C3 5 x--  1D3 5 x--  1C2 5 x--  1D2 5 x-- }
75EF: 0025 { 1C1 5 x--  1D1 5 x--  1C0 5 x--  1D0 5 x-- }
75F0: 0025 { 0F8 5 x--  0F8 5 x--  260 1 ---  270 1 --- }
75F1: 0025 { 261 1 ---  271 1 ---  262 1 ---  272 1 --- }
75F2: 0025 { 261 1 ---  273 1 ---  262 1 ---  274 1 --- }
75F3: 0025 { 261 1 ---  275 1 ---  262 1 ---  276 1 --- }
75F4: 0025 { 267 1 ---  277 1 ---  0F8 5 x--  0F8 5 x-- }
75F5: 0025 { 23E 1 ---  0F8 5 x--  26C 1 ---  27C 1 --- }
75F6: 0025 { 26D 1 ---  27D 1 ---  26E 1 ---  27E 1 --- }
75F7: 0025 { 26F 1 ---  27F 1 ---  23F 1 ---  0F8 5 x-- }
75F8: 0025 { 1EF 5 x--  1FF 5 x--  1EE 5 x--  1FE 5 x-- }
75F9: 0025 { 1ED 5 x--  1FD 5 x--  1EC 5 x--  1FC 5 x-- }
75FA: 0025 { 1EB 5 x--  1FB 5 x--  1EA 5 x--  1FA 5 x-- }
75FB: 0025 { 1E9 5 x--  1F9 5 x--  1E8 5 x--  1F8 5 x-- }
75FC: 0025 { 1E7 5 x--  1F7 5 x--  1E6 5 x--  1F6 5 x-- }
75FD: 0025 { 1E5 5 x--  1F5 5 x--  1E4 5 x--  1F4 5 x-- }
75FE: 0025 { 1E3 5 x--  1F3 5 x--  1E2 5 x--  1F2 5 x-- }
75FF: 0025 { 1E1 5 x--  1F1 5 x--  1E0 5 x--  1F0 5 x-- }
