5400: 0025 { 208 2 x--  190 5 ---  181 5 ---  191 5 --- }
5401: 0130 { 182 5 ---  192 5 ---  183 5 ---  193 5 --- }
5402: 0025 { 184 5 ---  194 5 ---  185 5 ---  195 5 --- }
5403: 0025 { 086 5 ---  086 5 ---  086 5 ---  096 5 --- }
5404: 0025 { 087 5 ---  097 5 ---  088 5 ---  098 5 --- }
5405: 0025 { 089 5 ---  099 5 ---  08A 5 ---  09A 5 --- }
5406: 0025 { 08B 5 ---  09B 5 ---  08C 5 ---  09C 5 --- }
5407: 0025 { 08D 5 ---  09D 5 ---  086 5 ---  096 5 --- }
5408: 0025 { 087 5 ---  097 5 ---  086 5 ---  086 5 --- }
5409: 0100 { 20B 2 ---  200 2 ---  20B 2 ---  200 2 --- }
540A: 0100 { 18D 3 ---  19B 3 ---  18E 3 ---  19C 3 --- }
540B: 0100 { 18F 3 ---  2A2 2 ---  18F 3 ---  2A3 2 --- }
540C: 0100 { 1AD 3 ---  19B 3 ---  1AE 3 ---  19C 3 --- }
540D: ~
540E: ~
540F: ~
5410: 0025 { 1A0 5 ---  1B0 5 ---  1A1 5 ---  1B1 5 --- }
5411: 0130 { 1A2 5 ---  1B2 5 ---  1A3 5 ---  1B3 5 --- }
5412: 0025 { 1A4 5 ---  1B4 5 ---  1A5 5 ---  1B5 5 --- }
5413: 0025 { 086 5 ---  086 5 ---  0A6 5 ---  0B6 5 --- }
5414: 0025 { 0A7 5 ---  0B7 5 ---  0A8 5 ---  0B8 5 --- }
5415: 0025 { 0A9 5 ---  0B9 5 ---  0AA 5 ---  0BA 5 --- }
5416: 0025 { 0AB 5 ---  0BB 5 ---  0AC 5 ---  0BC 5 --- }
5417: 0025 { 0AD 5 ---  0BD 5 ---  086 5 ---  0BE 5 --- }
5418: 0025 { 086 5 ---  0BF 5 ---  086 5 ---  086 5 --- }
5419: 0025 { 201 2 ---  0F8 2 ---  201 2 ---  0F8 2 --- }
541A: ~
541B: ~
541C: ~
541D: ~
541E: ~
541F: ~
5420: 0025 { 1C0 5 ---  1D0 5 ---  1C1 5 ---  1D1 5 --- }
5421: 0130 { 1C2 5 ---  1D2 5 ---  1C3 5 ---  1D3 5 --- }
5422: 0025 { 1C4 5 ---  1D4 5 ---  1C5 5 ---  1D5 5 --- }
5423: 0025 { 086 5 ---  086 5 ---  0C6 5 ---  0D6 5 --- }
5424: 0025 { 0C7 5 ---  0D7 5 ---  0C8 5 ---  0D8 5 --- }
5425: 0025 { 0C9 5 ---  0D9 5 ---  0CA 5 ---  08E 5 --- }
5426: 0025 { 0CB 5 ---  08F 5 ---  0CC 5 ---  09E 5 --- }
5427: 0025 { 0CD 5 ---  09F 5 ---  0CE 5 ---  0DE 5 --- }
5428: 0025 { 0CF 5 ---  0DF 5 ---  086 5 ---  086 5 --- }
5429: ~
542A: ~
542B: ~
542C: ~
542D: ~
542E: ~
542F: ~
5430: 0025 { 1D0 5 --p  27A 2 --p  1D1 5 --p  201 2 --p }
5431: 0130 { 1C1 5 ---  1D1 5 ---  1C1 5 ---  1D1 5 --- }
5432: 0025 { 1C0 5 --p  1D0 5 --p  1C1 5 --p  1D1 5 --p }
5433: 0025 { 086 5 ---  096 5 ---  087 5 ---  097 5 --- }
5434: 0025 { 088 5 ---  098 5 ---  089 5 ---  099 5 --- }
5435: 0025 { 08A 5 ---  09A 5 ---  08B 5 ---  09B 5 --- }
5436: 0025 { 08C 5 ---  09C 5 ---  08D 5 ---  09D 5 --- }
5437: 0025 { 086 5 ---  096 5 ---  087 5 ---  097 5 --- }
5438: 0130 { 0D1 5 ---  2B7 2 ---  0D1 5 ---  2B8 2 --- }
5439: ~
543A: ~
543B: ~
543C: ~
543D: ~
543E: ~
543F: ~
5440: 0025 { 1C1 5 --p  1D1 5 --p  1C1 5 --p  1D1 5 --p }
5441: 0130 { 1C1 5 --p  1D1 5 --p  1C1 5 --p  1D1 5 --p }
5442: 0130 { 1C0 5 --p  1D0 5 --p  1C1 5 --p  1D1 5 --p }
5443: 0025 { 0A6 5 ---  0B6 5 ---  0A7 5 ---  0B7 5 --- }
5444: 0025 { 0A8 5 ---  0B8 5 ---  0A9 5 ---  0B9 5 --- }
5445: 0025 { 0AA 5 ---  0BA 5 ---  0AB 5 ---  0BB 5 --- }
5446: 0025 { 0AC 5 ---  0BC 5 ---  0AD 5 ---  0BD 5 --- }
5447: 0025 { 086 5 ---  0BE 5 ---  086 5 ---  0BF 5 --- }
5448: 0025 { 2C7 2 ---  2D7 2 ---  2C8 2 ---  2D8 2 --- }
5449: ~
544A: ~
544B: ~
544C: ~
544D: ~
544E: ~
544F: ~
5450: 0025 { 2E9 5 ---  2C1 5 ---  1D1 5 ---  2EA 5 --- }
5451: 0130 { 2DD 5 ---  2C1 5 ---  2BE 5 ---  2ED 5 --- }
5452: 0025 { 2BF 5 ---  2C1 5 ---  1D1 5 ---  2EA 5 --- }
5453: 0025 { 0C6 5 ---  0D6 5 ---  0C7 5 ---  0D7 5 --- }
5454: 0025 { 0C8 5 ---  0D8 5 ---  0C9 5 ---  0D9 5 --- }
5455: 0025 { 0CA 5 ---  08E 5 ---  0CB 5 ---  08F 5 --- }
5456: 0025 { 0CC 5 ---  09E 5 ---  0CD 5 ---  09F 5 --- }
5457: 0025 { 0CE 5 ---  0DE 5 ---  0CF 5 ---  0DF 5 --- }
5458: 0204 { 2C7 2 ---  2B9 2 ---  2D8 2 ---  2BA 2 --- }
5459: ~
545A: ~
545B: ~
545C: ~
545D: ~
545E: ~
545F: ~
5460: 0025 { 0D0 5 ---  0D0 5 ---  0D1 5 ---  0D1 5 --- }
5461: 0025 { 0D0 5 --p  0D0 5 --p  0D0 5 x-p  0D0 5 x-p }
5462: 0130 { 0D0 5 --p  0D0 5 --p  0D0 5 x-p  0D0 5 x-p }
5463: 0025 { 0D0 5 --p  27A 2 --p  0D0 5 x-p  27A 2 x-p }
5464: 0025 { 0D1 5 --p  0D1 5 --p  0D1 5 --p  0D1 5 --p }
5465: 0130 { 0D1 5 --p  0D1 5 --p  0D1 5 --p  0D1 5 --p }
5466: 0130 { 0D1 5 ---  0D1 5 ---  0D1 5 ---  0D1 5 --- }
5467: 0130 { 0D1 5 ---  2B7 2 ---  0D1 5 ---  2B8 2 --- }
5468: ~
5469: ~
546A: ~
546B: ~
546C: ~
546D: ~
546E: ~
546F: ~
5470: 0025 { 282 2 ---  200 2 ---  0D1 5 ---  283 2 --- }
5471: 0130 { 284 2 ---  200 2 ---  2BE 5 ---  285 2 --- }
5472: 0025 { 283 2 ---  200 2 ---  0D1 5 ---  283 2 --- }
5473: 0025 { 2A3 2 ---  2A4 2 ---  2A2 2 ---  2A3 2 --- }
5474: 0130 { 2A3 2 ---  2A4 2 ---  2A4 2 ---  2A3 2 --- }
5475: 0025 { 208 2 x--  1B8 4 x--  208 2 x--  208 2 x-- }
5476: 0025 { 208 2 x--  208 2 x--  208 2 x--  1B8 4 --- }
5477: 0025 { 24C 2 ---  20B 2 ---  0D0 5 ---  282 2 --- }
5478: ~
5479: ~
547A: ~
547B: ~
547C: ~
547D: ~
547E: ~
547F: ~
5480: 0025 { 2A5 2 ---  2A4 2 ---  0D1 5 ---  2A5 2 --- }
5481: 0130 { 295 2 ---  2A4 2 ---  2BE 5 ---  286 2 --- }
5482: 0025 { 2A5 2 ---  2A4 2 ---  0D1 5 ---  2A5 2 --- }
5483: 0025 { 201 2 ---  2A2 2 ---  201 2 ---  2A3 2 --- }
5484: 0025 { 2A3 2 ---  2A4 2 ---  2A4 2 ---  2A3 2 --- }
5485: 0025 { 24C 2 ---  2A2 2 ---  0D0 5 ---  2A5 2 --- }
5486: 0025 { 24C 2 ---  24C 2 ---  0D0 5 ---  0D0 5 --- }
5487: ~
5488: ~
5489: ~
548A: ~
548B: ~
548C: ~
548D: ~
548E: ~
548F: ~
5490: 0025 { 0F8 7 ---  0F8 7 ---  24E 7 ---  25E 7 --- }
5491: 0025 { 24F 7 ---  25F 7 ---  0F8 7 ---  25B 7 --- }
5492: ~
5493: ~
5494: ~
5495: ~
5496: ~
5497: ~
5498: ~
5499: ~
549A: ~
549B: ~
549C: ~
549D: ~
549E: ~
549F: ~
54A0: 0025 { 0F8 7 ---  0F8 7 ---  254 7 ---  25A 7 --- }
54A1: 0025 { 255 7 ---  0F8 7 ---  0F8 7 ---  0F8 7 --- }
54A2: ~
54A3: ~
54A4: ~
54A5: ~
54A6: ~
54A7: ~
54A8: ~
54A9: ~
54AA: ~
54AB: ~
54AC: ~
54AD: ~
54AE: ~
54AF: ~
54B0: 0025 { 010 7 ---  013 7 ---  011 7 ---  014 7 --- }
54B1: 0025 { 012 7 ---  015 7 ---  086 5 ---  086 5 --- }
54B2: ~
54B3: ~
54B4: ~
54B5: ~
54B6: ~
54B7: ~
54B8: ~
54B9: ~
54BA: ~
54BB: ~
54BC: ~
54BD: ~
54BE: ~
54BF: ~
54C0: 0025 { 016 7 ---  019 7 ---  017 7 ---  01A 7 --- }
54C1: 0025 { 018 7 ---  0F8 7 ---  201 2 ---  0F8 2 --- }
54C2: ~
54C3: ~
54C4: ~
54C5: ~
54C6: ~
54C7: ~
54C8: ~
54C9: ~
54CA: ~
54CB: ~
54CC: ~
54CD: ~
54CE: ~
54CF: ~
54D0: ~
54D1: ~
54D2: ~
54D3: ~
54D4: ~
54D5: ~
54D6: ~
54D7: ~
54D8: ~
54D9: ~
54DA: ~
54DB: ~
54DC: ~
54DD: ~
54DE: ~
54DF: ~
54E0: ~
54E1: ~
54E2: ~
54E3: ~
54E4: ~
54E5: ~
54E6: ~
54E7: ~
54E8: ~
54E9: ~
54EA: ~
54EB: ~
54EC: ~
54ED: ~
54EE: ~
54EF: ~
54F0: ~
54F1: ~
54F2: ~
54F3: ~
54F4: ~
54F5: ~
54F6: ~
54F7: ~
54F8: ~
54F9: ~
54FA: ~
54FB: ~
54FC: ~
54FD: ~
54FE: ~
54FF: ~
