3800: 009A { 180 2 ---  190 2 ---  181 2 ---  191 2 --- }
3801: 009B { 182 2 ---  192 2 ---  183 2 ---  193 2 --- }
3802: 0025 { 189 2 ---  199 2 ---  199 2 ---  189 2 --- }
3803: 0025 { 18C 2 ---  19C 2 ---  18D 2 ---  19D 2 --- }
3804: 0025 { 18E 2 ---  19E 2 ---  18F 2 ---  19F 2 --- }
3805: 0025 { 1E0 3 ---  1F0 3 ---  1E1 3 ---  1F1 3 --- }
3806: 0025 { 1E2 3 ---  1F2 3 ---  1E3 3 ---  1F3 3 --- }
3807: 0025 { 1E1 3 x--  1F1 3 x--  1E0 3 x--  1F0 3 x-- }
3808: 0025 { 200 3 ---  210 3 ---  201 3 ---  211 3 --- }
3809: 0025 { 201 3 -y-  201 3 -y-  201 3 ---  201 3 --- }
380A: 0025 { 201 3 -y-  212 3 ---  202 3 ---  224 3 x-- }
380B: 0130 { 1C2 3 ---  1D2 3 ---  1C3 3 ---  1D3 3 --- }
380C: 0130 { 1C4 3 ---  1D4 3 ---  1C5 3 ---  1D5 3 --- }
380D: 0100 { 24A 5 ---  25A 5 ---  24B 5 ---  25B 5 --- }
380E: 0100 { 24C 5 ---  25C 5 ---  24D 5 ---  25D 5 --- }
380F: 0100 { 24E 5 ---  25E 5 ---  24F 5 ---  25F 5 --- }
3810: 009C { 1A0 2 ---  1B0 2 ---  1A1 2 ---  1B1 2 --- }
3811: 009C { 1A2 2 ---  1B2 2 ---  1A3 2 ---  1B3 2 --- }
3812: 0130 { 1CA 2 ---  1DA 2 ---  1CB 2 ---  1DB 2 --- }
3813: 0025 { 1AC 2 ---  1BC 2 ---  1AD 2 ---  1BD 2 --- }
3814: 0025 { 1AE 2 ---  1BE 2 ---  1AF 2 ---  1BF 2 --- }
3815: 0025 { 1E4 3 ---  1F4 3 ---  1E5 3 ---  1F5 3 --- }
3816: 0025 { 1A4 2 ---  1B4 2 ---  1A5 2 ---  1B5 2 --- }
3817: 0025 { 1E5 3 x--  1F5 3 x--  1E4 3 x--  1F4 3 x-- }
3818: 0025 { 210 3 x--  210 3 ---  210 3 x--  210 3 --- }
3819: 0025 { 223 3 ---  222 3 ---  222 3 ---  223 3 --- }
381A: 0025 { 224 3 ---  224 3 x--  224 3 ---  224 3 x-- }
381B: 0130 { 1D2 3 -y-  1C2 3 -y-  1D3 3 -y-  1C3 3 -y- }
381C: 0130 { 1D4 3 -y-  1C4 3 -y-  1D5 3 -y-  1C5 3 -y- }
381D: 0025 { 26A 5 ---  27A 5 ---  26B 5 ---  27B 5 --- }
381E: 0025 { 26C 5 ---  27C 5 ---  26D 5 ---  27D 5 --- }
381F: 0025 { 26E 5 ---  27E 5 ---  26F 5 ---  27F 5 --- }
3820: 0130 { 1A8 2 ---  1B8 2 ---  1A9 2 ---  1B9 2 --- }
3821: 0130 { 1AA 2 ---  1BA 2 ---  1AB 2 ---  1BB 2 --- }
3822: 0025 { 1A8 2 ---  1B8 2 ---  1AB 2 ---  1BB 2 --- }
3823: 0025 { 1CC 2 ---  1DC 2 ---  1CD 2 ---  1DD 2 --- }
3824: 0025 { 1CE 2 ---  1DE 2 ---  1CF 2 ---  1DF 2 --- }
3825: 0025 { 1F0 3 -y-  1E0 3 -y-  1F1 3 -y-  1E1 3 -y- }
3826: 0025 { 1F2 3 -y-  1E2 3 -y-  1F3 3 -y-  1E3 3 -y- }
3827: 0025 { 1F1 3 xy-  1E1 3 xy-  1F0 3 xy-  1E0 3 xy- }
3828: 0025 { 210 3 x--  230 3 ---  220 3 ---  231 3 -y- }
3829: 0025 { 231 3 x--  231 3 ---  231 3 -y-  231 3 -y- }
382A: 0025 { 232 3 ---  231 3 ---  224 3 ---  221 3 --- }
382B: 0130 { 1C6 3 ---  1D6 3 ---  1C7 3 ---  1D7 3 --- }
382C: 0130 { 1C7 3 x--  1D7 3 x--  1C6 3 x--  1D6 3 x-- }
382D: 0025 { 248 5 ---  258 5 ---  249 5 ---  259 5 --- }
382E: 0100 { 22B 6 ---  23B 6 ---  22C 6 ---  23C 6 --- }
382F: 0100 { 20B 7 ---  21B 7 ---  20C 7 ---  21C 7 --- }
3830: 0025 { 1E6 2 ---  1F6 2 ---  1E7 2 ---  1F7 2 --- }
3831: 0025 { 1E8 2 ---  1F8 2 ---  1E8 2 ---  1F8 2 --- }
3832: 0025 { 1E9 2 ---  1E9 2 ---  1F9 2 ---  1F9 2 --- }
3833: 0130 { 208 3 ---  218 3 ---  209 3 ---  219 3 --- }
3834: 0130 { 20A 3 ---  21A 3 ---  203 3 ---  268 3 --- }
3835: 0130 { 203 3 ---  269 3 ---  20D 3 ---  21D 3 --- }
3836: 0130 { 20E 3 ---  21E 3 ---  20F 3 ---  21F 3 --- }
3837: 0100 { 184 2 ---  194 2 ---  185 2 ---  195 2 --- }
3838: 0100 { 186 2 ---  196 2 ---  186 2 ---  196 2 --- }
3839: 0100 { 187 2 ---  197 2 ---  188 2 ---  198 2 --- }
383A: 0006 { 19A 2 ---  19A 2 ---  19B 2 ---  19B 2 --- }
383B: 0130 { 1C8 3 ---  1D8 3 ---  1C9 3 ---  1D9 3 --- }
383C: 0130 { 1C9 3 x--  1D9 3 x--  1C8 3 x--  1D8 3 x-- }
383D: 0100 { 204 7 ---  214 7 ---  205 7 ---  215 7 --- }
383E: 0100 { 206 7 ---  216 7 ---  205 7 ---  215 7 --- }
383F: 0100 { 206 7 ---  216 7 ---  207 7 ---  217 7 --- }
3840: 0025 { 1E6 3 ---  1F6 3 ---  1E7 3 ---  1F7 3 --- }
3841: 0025 { 1E8 3 ---  1F8 3 ---  1E8 3 ---  1F8 3 --- }
3842: 0025 { 1E9 3 ---  1E9 3 ---  1F9 3 ---  1F9 3 --- }
3843: 0130 { 228 3 ---  238 3 ---  229 3 ---  239 3 --- }
3844: 0130 { 22A 3 ---  23A 3 ---  278 3 ---  213 3 --- }
3845: 0130 { 279 3 ---  213 3 ---  22D 3 ---  23D 3 --- }
3846: 0130 { 22E 3 ---  23E 3 ---  22F 3 ---  23F 3 --- }
3847: 0130 { 1C0 3 ---  1D0 3 ---  1C1 3 ---  1D1 3 --- }
3848: 0025 { 1A6 3 ---  1B6 3 ---  1A7 3 ---  1B7 3 --- }
3849: 0100 { 1EA 3 ---  1FA 3 ---  1EB 3 ---  1FB 3 --- }
384A: 0025 { 1EC 2 ---  1ED 2 ---  1ED 2 ---  1EC 2 --- }
384B: 0025 { 280 4 ---  290 4 ---  281 4 ---  291 4 --- }
384C: 0025 { 282 4 ---  292 4 ---  283 4 ---  293 4 --- }
384D: 0025 { 284 4 ---  294 4 ---  285 4 ---  295 4 --- }
384E: 0025 { 286 4 ---  296 4 ---  2C6 4 ---  2D6 4 --- }
384F: ~
3850: 009B { 183 2 x--  193 2 x--  182 2 x--  192 2 x-- }
3851: 009A { 181 2 x--  191 2 x--  180 2 x--  190 2 x-- }
3852: 013B { 180 2 ---  190 2 ---  181 2 ---  191 2 --- }
3853: 009B { 182 2 ---  192 2 ---  183 2 ---  193 2 --- }
3854: ~
3855: ~
3856: ~
3857: ~
3858: ~
3859: ~
385A: ~
385B: 0025 { 2A0 4 ---  2B0 4 ---  2A1 4 ---  2B1 4 --- }
385C: 0025 { 2A2 4 ---  2B2 4 ---  2A3 4 ---  2B3 4 --- }
385D: 0025 { 2A4 4 ---  2B4 4 ---  2A5 4 ---  2B5 4 --- }
385E: 0025 { 2A6 4 ---  2B6 4 ---  2C6 4 ---  2D6 4 --- }
385F: ~
3860: 009C { 1A3 2 x--  1B3 2 x--  1A2 2 x--  1B2 2 x-- }
3861: 009C { 1A1 2 x--  1B1 2 x--  1A0 2 x--  1B0 2 x-- }
3862: 013F { 1A0 2 ---  1B0 2 ---  1A1 2 ---  1B1 2 --- }
3863: 009C { 1A2 2 ---  1B2 2 ---  1A3 2 ---  1B3 2 --- }
3864: ~
3865: ~
3866: ~
3867: ~
3868: ~
3869: ~
386A: ~
386B: 0025 { 2C0 4 ---  2D0 4 ---  2C1 4 ---  2D1 4 --- }
386C: 0025 { 2C2 4 ---  2D2 4 ---  2C3 4 ---  2D3 4 --- }
386D: 0025 { 2C4 4 ---  2D4 4 ---  2C5 4 ---  2D5 4 --- }
386E: 0025 { 2C6 4 ---  2D6 4 ---  2C6 4 ---  2D6 4 --- }
386F: ~
3870: ~
3871: ~
3872: ~
3873: ~
3874: ~
3875: ~
3876: ~
3877: ~
3878: ~
3879: ~
387A: ~
387B: 0025 { 289 5 x--  299 5 x--  288 5 x--  298 5 x-- }
387C: 0025 { 28B 6 x--  29B 6 x--  28A 6 x--  29A 6 x-- }
387D: 0025 { 28D 7 x--  29D 7 x--  28C 7 x--  29C 7 x-- }
387E: 0025 { 28F 7 x--  29F 7 x--  28E 7 x--  29E 7 x-- }
387F: ~
3880: ~
3881: ~
3882: ~
3883: ~
3884: ~
3885: ~
3886: ~
3887: ~
3888: ~
3889: ~
388A: ~
388B: ~
388C: ~
388D: ~
388E: ~
388F: ~
3890: ~
3891: ~
3892: ~
3893: ~
3894: ~
3895: ~
3896: ~
3897: ~
3898: ~
3899: ~
389A: ~
389B: ~
389C: ~
389D: ~
389E: ~
389F: ~
38A0: ~
38A1: ~
38A2: ~
38A3: ~
38A4: ~
38A5: ~
38A6: ~
38A7: ~
38A8: ~
38A9: ~
38AA: ~
38AB: ~
38AC: ~
38AD: ~
38AE: ~
38AF: ~
38B0: ~
38B1: ~
38B2: ~
38B3: ~
38B4: 012F { 244 2 ---  254 2 ---  245 2 ---  255 2 --- }
38B5: 012F { 254 2 -y-  244 2 -y-  255 2 -y-  245 2 -y- }
38B6: 0025 { 22A 2 ---  23A 2 ---  22B 2 ---  23B 2 --- }
38B7: 0025 { 268 2 ---  278 2 ---  269 2 ---  279 2 --- }
38B8: ~
38B9: ~
38BA: ~
38BB: ~
38BC: ~
38BD: ~
38BE: ~
38BF: ~
38C0: 0130 { 208 2 ---  218 2 ---  209 2 ---  219 2 --- }
38C1: 0130 { 20A 2 ---  21A 2 ---  20B 2 ---  21B 2 --- }
38C2: 0130 { 24C 2 --p  25C 2 --p  24D 2 --p  25D 2 --p }
38C3: 0130 { 24E 2 --p  25E 2 --p  24F 2 --p  25F 2 --p }
38C4: 012F { 265 2 x--  275 2 x--  264 2 x--  274 2 x-- }
38C5: 012F { 264 2 ---  274 2 ---  265 2 ---  275 2 --- }
38C6: 0025 { 246 2 ---  234 2 ---  247 2 ---  235 2 --- }
38C7: 0025 { 246 2 ---  236 2 ---  247 2 ---  237 2 --- }
38C8: ~
38C9: ~
38CA: ~
38CB: ~
38CC: ~
38CD: ~
38CE: ~
38CF: ~
38D0: 0025 { 200 2 ---  210 2 ---  201 2 ---  211 2 --- }
38D1: 0025 { 202 2 ---  212 2 ---  203 2 ---  213 2 --- }
38D2: 0130 { 26C 2 --p  27C 2 --p  26D 2 --p  27D 2 --p }
38D3: 0130 { 26E 2 --p  27E 2 --p  26F 2 --p  27F 2 --p }
38D4: 0006 { 24A 2 ---  25A 2 ---  24B 2 ---  25B 2 --- }
38D5: 0130 { 228 2 ---  238 2 ---  229 2 ---  239 2 --- }
38D6: 0025 { 246 2 ---  204 2 ---  247 2 ---  205 2 --- }
38D7: 0025 { 246 2 ---  206 2 ---  247 2 ---  207 2 --- }
38D8: ~
38D9: ~
38DA: ~
38DB: ~
38DC: ~
38DD: ~
38DE: ~
38DF: ~
38E0: 0025 { 220 2 ---  230 2 ---  221 2 ---  231 2 --- }
38E1: 0025 { 222 2 ---  232 2 ---  223 2 ---  233 2 --- }
38E2: 0025 { 20C 2 --p  21C 2 --p  20D 2 --p  21D 2 --p }
38E3: 0025 { 20E 2 --p  21E 2 --p  20F 2 --p  21F 2 --p }
38E4: 0006 { 26A 2 ---  26A 2 ---  26B 2 ---  26B 2 --- }
38E5: 0130 { 248 2 ---  258 2 ---  249 2 ---  259 2 --- }
38E6: 0106 { 208 2 ---  0F8 2 -y-  209 2 ---  0F8 2 -y- }
38E7: 0106 { 20A 2 ---  0F8 2 -y-  20B 2 ---  0F8 2 -y- }
38E8: 0025 { 256 2 ---  266 2 ---  257 2 ---  267 2 --- }
38E9: 0098 { 247 7 ---  247 7 ---  268 7 ---  269 7 xy- }
38EA: 0099 { 269 7 ---  268 7 xy-  247 7 ---  247 7 --- }
38EB: 0096 { 247 7 ---  268 7 ---  247 7 ---  269 7 --- }
38EC: ~
38ED: ~
38EE: 0130 { 214 2 ---  224 2 ---  215 2 ---  225 2 --- }
38EF: 38EE { 216 2 ---  226 2 ---  217 2 ---  227 2 --- }
38F0: 0130 { 21A 2 -y-  20A 2 -y-  21B 2 -y-  20B 2 -y- }
38F1: 0130 { 218 2 -y-  208 2 -y-  219 2 -y-  209 2 -y- }
38F2: 0025 { 22C 2 --p  23C 2 --p  22D 2 --p  23D 2 --p }
38F3: 0025 { 22E 2 --p  23E 2 --p  22F 2 --p  23F 2 --p }
38F4: 0006 { 26A 2 ---  27A 2 ---  26B 2 ---  27B 2 --- }
38F5: 0130 { 260 2 ---  270 2 ---  261 2 ---  271 2 --- }
38F6: 0106 { 208 2 ---  204 2 ---  209 2 ---  205 2 --- }
38F7: 0106 { 20A 2 ---  206 2 ---  20B 2 ---  207 2 --- }
38F8: 0025 { 276 2 ---  276 2 ---  277 2 ---  277 2 --- }
38F9: ~
38FA: ~
38FB: 0097 { 269 7 xy-  247 7 ---  268 7 xy-  247 7 --- }
38FC: ~
38FD: ~
38FE: 38EE { 216 2 ---  226 2 ---  217 2 ---  227 2 --- }
38FF: 38EE { 214 2 ---  224 2 ---  215 2 ---  225 2 --- }
