7200: 0025 { 104 0 --p  104 0 --p  104 0 --p  104 0 --p }
7201: 0025 { 104 0 --p  104 0 --p  104 0 --p  114 0 x-p }
7202: 0130 { 103 0 x-p  113 0 x-p  102 0 x-p  112 0 x-p }
7203: 0025 { 101 0 x-p  111 0 x-p  100 0 x-p  110 0 x-p }
7204: 0025 { 100 0 --p  110 0 --p  101 0 --p  111 0 --p }
7205: 0130 { 102 0 --p  112 0 --p  103 0 --p  113 0 --p }
7206: 0025 { 104 0 --p  114 0 --p  104 0 --p  104 0 --p }
7207: 0025 { 104 0 --p  104 0 --p  104 0 --p  104 0 --p }
7208: 0025 { 16E 0 ---  16E 0 -y-  16F 0 ---  16F 0 -y- }
7209: 0025 { 16F 0 x--  16F 0 xy-  16E 0 x--  16E 0 xy- }
720A: 0025 { 15F 0 ---  104 0 --p  104 0 --p  17D 0 --- }
720B: 0025 { 104 0 --p  104 0 --p  104 0 --p  15F 0 xy- }
720C: 0025 { 17D 0 -y-  104 0 --p  104 0 --p  104 0 --p }
720D: 0025 { 104 0 --p  104 0 --p  104 0 --p  126 0 --- }
720E: 0025 { 104 0 x-p  126 0 x--  104 0 x-p  104 0 x-p }
720F: 0025 { 17E 0 ---  104 0 --p  17E 0 x--  104 0 --p }
7210: 0025 { 104 0 --p  104 0 --p  104 0 --p  104 0 --p }
7211: 0025 { 104 0 --p  135 0 x-p  124 0 x-p  134 0 x-p }
7212: 0130 { 123 0 x-p  133 0 x-p  122 0 x-p  132 0 x-p }
7213: 0025 { 121 0 x-p  131 0 x-p  120 0 x-p  130 0 x-p }
7214: 0025 { 120 0 --p  130 0 --p  121 0 --p  131 0 --p }
7215: 0130 { 122 0 --p  132 0 --p  123 0 --p  133 0 --p }
7216: 0025 { 124 0 --p  134 0 --p  104 0 --p  135 0 --p }
7217: 0025 { 104 0 --p  104 0 --p  104 0 --p  104 0 --p }
7218: 0025 { 104 0 --p  104 0 --p  117 0 ---  127 0 --- }
7219: 0025 { 117 0 x--  127 0 x--  104 0 x-p  104 0 x-p }
721A: 0130 { 104 0 --p  104 0 --p  104 0 --p  104 0 --p }
721B: ~
721C: ~
721D: ~
721E: ~
721F: ~
7220: 0025 { 104 0 --p  157 0 x-p  146 0 x-p  156 0 x-p }
7221: 0130 { 145 0 x-p  155 0 x-p  144 0 x-p  154 0 x-p }
7222: 0130 { 143 0 x-p  153 0 x-p  142 0 x-p  152 0 x-p }
7223: 0025 { 141 0 x-p  151 0 x-p  140 0 x-p  150 0 x-p }
7224: 0025 { 140 0 --p  150 0 --p  141 0 --p  151 0 --p }
7225: 0130 { 142 0 --p  152 0 --p  143 0 --p  153 0 --p }
7226: 0130 { 144 0 --p  154 0 --p  145 0 --p  155 0 --p }
7227: 0025 { 146 0 --p  156 0 --p  104 0 --p  157 0 --p }
7228: 0025 { 104 0 --p  104 0 --p  137 0 ---  147 0 --- }
7229: 0025 { 137 0 x--  147 0 x--  104 0 x-p  104 0 x-p }
722A: ~
722B: 0025 { 004 4 ---  004 4 ---  004 4 ---  004 4 --- }
722C: ~
722D: ~
722E: ~
722F: ~
7230: 0025 { 167 0 x-p  177 0 x-p  166 0 x-p  176 0 x-p }
7231: 0130 { 165 0 x-p  175 0 x-p  164 0 x-p  174 0 x-p }
7232: 0130 { 163 0 x-p  173 0 x-p  162 0 x-p  172 0 x-p }
7233: 0025 { 161 0 x-p  171 0 x-p  160 0 x-p  170 0 x-p }
7234: 0025 { 160 0 --p  170 0 --p  161 0 --p  171 0 --p }
7235: 0130 { 162 0 --p  172 0 --p  163 0 --p  173 0 --p }
7236: 0130 { 164 0 --p  174 0 --p  165 0 --p  175 0 --p }
7237: 0025 { 166 0 --p  176 0 --p  167 0 --p  177 0 --p }
7238: 0025 { 104 0 --p  104 0 --p  115 0 ---  104 0 --p }
7239: 0025 { 116 0 ---  104 0 --p  104 0 --p  104 0 --p }
723A: ~
723B: 01C2 { 004 4 ---  004 4 ---  004 4 ---  004 4 --- }
723C: ~
723D: ~
723E: ~
723F: ~
7240: 0025 { 10F 0 x-p  11F 0 x-p  10E 0 x-p  11E 0 x-p }
7241: 0130 { 10D 0 x-p  11D 0 x-p  10C 0 x-p  11C 0 x-p }
7242: 0130 { 10B 0 x-p  11B 0 x-p  10A 0 x-p  11A 0 x-p }
7243: 0025 { 109 0 x-p  119 0 x-p  108 0 x-p  118 0 x-p }
7244: 0025 { 108 0 --p  118 0 --p  109 0 --p  119 0 --p }
7245: 0130 { 10A 0 --p  11A 0 --p  10B 0 --p  11B 0 --p }
7246: 0130 { 10C 0 --p  11C 0 --p  10D 0 --p  11D 0 --p }
7247: 0025 { 10E 0 --p  11E 0 --p  10F 0 --p  11F 0 --p }
7248: ~
7249: ~
724A: 01C2 { 004 4 ---  004 4 ---  004 4 ---  004 4 --- }
724B: ~
724C: ~
724D: ~
724E: ~
724F: ~
7250: 0025 { 12F 0 x-p  13F 0 x-p  12E 0 x-p  13E 0 x-p }
7251: 0130 { 12D 0 x-p  13D 0 x-p  12C 0 x-p  13C 0 x-p }
7252: 0130 { 12B 0 x-p  13B 0 x-p  12A 0 x-p  13A 0 x-p }
7253: 0025 { 129 0 x-p  139 0 x-p  128 0 x-p  138 0 x-p }
7254: 0025 { 128 0 --p  138 0 --p  129 0 --p  139 0 --p }
7255: 0130 { 12A 0 --p  13A 0 --p  12B 0 --p  13B 0 --p }
7256: 0130 { 12C 0 --p  13C 0 --p  12D 0 --p  13D 0 --p }
7257: 0025 { 12E 0 --p  13E 0 --p  12F 0 --p  13F 0 --p }
7258: ~
7259: ~
725A: 01AF { 004 4 ---  004 4 ---  004 4 ---  004 4 --- }
725B: ~
725C: 01AA { 004 4 ---  004 4 ---  004 4 ---  004 4 --- }
725D: ~
725E: ~
725F: ~
7260: 0025 { 14F 0 x-p  104 0 --p  14E 0 x-p  15E 0 x-p }
7261: 0025 { 14D 0 x-p  15D 0 x-p  14C 0 x-p  15C 0 x-p }
7262: 0130 { 14B 0 x-p  15B 0 x-p  14A 0 x-p  15A 0 x-p }
7263: 0025 { 149 0 x-p  159 0 x-p  148 0 x-p  158 0 x-p }
7264: 0025 { 148 0 --p  158 0 --p  149 0 --p  159 0 --p }
7265: 0130 { 14A 0 --p  15A 0 --p  14B 0 --p  15B 0 --p }
7266: 0025 { 14C 0 --p  15C 0 --p  14D 0 --p  15D 0 --p }
7267: 0025 { 14E 0 --p  15E 0 --p  14F 0 --p  104 0 --p }
7268: ~
7269: ~
726A: ~
726B: ~
726C: ~
726D: ~
726E: ~
726F: ~
7270: 0025 { 104 0 --p  104 0 --p  104 0 --p  104 0 --p }
7271: 0025 { 16D 0 x-p  104 0 --p  16C 0 x-p  17C 0 x-p }
7272: 0025 { 16B 0 x-p  17B 0 x-p  16A 0 x-p  17A 0 x-p }
7273: 0130 { 169 0 x-p  179 0 x-p  168 0 x-p  178 0 x-p }
7274: 0130 { 168 0 --p  178 0 --p  169 0 --p  179 0 --p }
7275: 0025 { 16A 0 --p  17A 0 --p  16B 0 --p  17B 0 --p }
7276: 0025 { 16C 0 --p  17C 0 --p  16D 0 --p  104 0 --p }
7277: 0025 { 104 0 --p  104 0 --p  104 0 --p  104 0 --p }
7278: ~
7279: ~
727A: ~
727B: ~
727C: ~
727D: ~
727E: ~
727F: ~
7280: 0130 { 104 0 --p  104 0 --p  104 0 --p  104 0 --p }
7281: 0130 { 104 0 --p  104 0 --p  104 0 --p  104 0 --p }
7282: 0130 { 104 0 --p  104 0 --p  107 0 x-p  104 0 --p }
7283: 0130 { 106 0 x-p  104 0 --p  105 0 x-p  104 0 --p }
7284: 0130 { 105 0 --p  104 0 --p  106 0 --p  104 0 --p }
7285: 0130 { 107 0 --p  104 0 --p  104 0 --p  104 0 --p }
7286: 0130 { 104 0 --p  104 0 --p  104 0 --p  104 0 --p }
7287: 0130 { 104 0 --p  104 0 --p  104 0 --p  104 0 --p }
7288: ~
7289: ~
728A: ~
728B: ~
728C: ~
728D: ~
728E: ~
728F: ~
7290: 0130 { 104 0 --p  104 0 --p  104 0 --p  104 0 --p }
7291: 0130 { 104 0 --p  104 0 --p  104 0 --p  104 0 --p }
7292: 0130 { 104 0 --p  104 0 --p  104 0 --p  104 0 --p }
7293: 0130 { 104 0 --p  104 0 --p  104 0 --p  104 0 --p }
7294: 0130 { 104 0 --p  104 0 --p  104 0 --p  104 0 --p }
7295: 0130 { 104 0 --p  104 0 --p  104 0 --p  104 0 --p }
7296: 0130 { 104 0 --p  104 0 --p  104 0 --p  104 0 --p }
7297: 0130 { 104 0 --p  104 0 --p  104 0 --p  104 0 --p }
7298: 01E4 { 004 4 ---  004 4 ---  004 4 ---  004 4 --- }
7299: 01E2 { 004 4 ---  004 4 ---  004 4 ---  004 4 --- }
729A: ~
729B: ~
729C: ~
729D: ~
729E: ~
729F: ~
72A0: ~
72A1: ~
72A2: ~
72A3: ~
72A4: ~
72A5: ~
72A6: ~
72A7: ~
72A8: ~
72A9: ~
72AA: ~
72AB: ~
72AC: ~
72AD: ~
72AE: ~
72AF: ~
72B0: ~
72B1: ~
72B2: ~
72B3: ~
72B4: ~
72B5: ~
72B6: ~
72B7: ~
72B8: ~
72B9: ~
72BA: ~
72BB: ~
72BC: ~
72BD: ~
72BE: ~
72BF: ~
72C0: ~
72C1: ~
72C2: ~
72C3: ~
72C4: ~
72C5: ~
72C6: ~
72C7: ~
72C8: ~
72C9: ~
72CA: ~
72CB: ~
72CC: ~
72CD: ~
72CE: ~
72CF: ~
72D0: ~
72D1: ~
72D2: ~
72D3: ~
72D4: ~
72D5: ~
72D6: ~
72D7: ~
72D8: ~
72D9: ~
72DA: ~
72DB: ~
72DC: ~
72DD: ~
72DE: ~
72DF: ~
72E0: ~
72E1: ~
72E2: ~
72E3: ~
72E4: ~
72E5: ~
72E6: ~
72E7: ~
72E8: ~
72E9: ~
72EA: ~
72EB: ~
72EC: ~
72ED: ~
72EE: ~
72EF: ~
72F0: ~
72F1: ~
72F2: ~
72F3: ~
72F4: ~
72F5: ~
72F6: ~
72F7: ~
72F8: ~
72F9: ~
72FA: ~
72FB: ~
72FC: ~
72FD: ~
72FE: ~
72FF: ~
