3900: 0130 { 280 4 ---  290 4 ---  281 4 ---  291 4 --- }
3901: 0130 { 282 4 ---  292 4 ---  283 4 ---  293 4 --- }
3902: 0130 { 284 4 ---  294 4 ---  285 4 ---  295 4 --- }
3903: 0130 { 286 4 ---  296 4 ---  287 4 ---  297 4 --- }
3904: 0130 { 2C8 2 ---  2D8 2 ---  2C9 2 ---  2D9 2 --- }
3905: 0130 { 2CA 2 ---  2DA 2 ---  2CB 2 ---  2DB 2 --- }
3906: 0130 { 2C9 2 ---  2D9 2 ---  2CA 2 ---  2DA 2 --- }
3907: 0130 { 2D8 2 ---  2E8 2 ---  2D9 2 ---  2E9 2 --- }
3908: 0130 { 2E9 2 -y-  2EA 2 x--  2EA 2 ---  2E9 2 x-- }
3909: 0130 { 2C8 2 ---  2F8 2 ---  2C9 2 ---  2F9 2 --- }
390A: 0130 { 2C8 2 ---  2D8 2 ---  2CB 2 ---  2DB 2 --- }
390B: 0025 { 0D0 3 -y-  0C0 3 -y-  0D1 3 -y-  0C1 3 -y- }
390C: 0025 { 0A0 3 ---  0B0 3 ---  0A1 3 ---  0B1 3 --- }
390D: 0130 { 28D 5 ---  29D 5 ---  28E 5 ---  29E 5 --- }
390E: 0130 { 28F 5 ---  29F 5 ---  28E 5 ---  29E 5 --- }
390F: 0130 { 28F 5 ---  29F 5 ---  28D 5 x--  29D 5 x-- }
3910: 0130 { 2A0 4 ---  2B0 4 ---  2A1 4 ---  2B1 4 --- }
3911: 0130 { 2A2 4 ---  2B2 4 ---  2A3 4 ---  2B3 4 --- }
3912: 0130 { 2A4 4 ---  2B4 4 ---  2A5 4 ---  2B5 4 --- }
3913: 0130 { 2A6 4 ---  2B6 4 ---  2A7 4 ---  2B7 4 --- }
3914: 0130 { 2E8 2 ---  2F8 2 ---  2E9 2 ---  2F9 2 --- }
3915: 0130 { 2EA 2 ---  2FA 2 ---  2EB 2 ---  2FB 2 --- }
3916: 0130 { 2E9 2 ---  2F9 2 ---  2EA 2 ---  2FA 2 --- }
3917: 0130 { 2DA 2 ---  2EA 2 ---  2DB 2 ---  2EB 2 --- }
3918: 0130 { 2C8 2 ---  2F8 2 ---  2CB 2 ---  2FB 2 --- }
3919: 0130 { 2D8 2 ---  2E8 2 ---  2EA 2 ---  2E9 2 x-- }
391A: 0130 { 2D8 2 ---  2E8 2 ---  2DB 2 ---  2EB 2 --- }
391B: 0025 { 0B0 3 -y-  0A0 3 -y-  0B1 3 -y-  0A1 3 -y- }
391C: 0025 { 0C0 3 ---  0D0 3 ---  0C1 3 ---  0D1 3 --- }
391D: 0130 { 2AD 5 ---  2BD 5 ---  2AE 5 ---  2BE 5 --- }
391E: 0130 { 2AF 5 ---  2BF 5 ---  2AE 5 ---  2BE 5 --- }
391F: 0130 { 2AF 5 ---  2BF 5 ---  2AD 5 x--  2BD 5 x-- }
3920: 0130 { 2A0 4 ---  2B0 4 ---  2A1 4 ---  2B1 4 --- }
3921: 0130 { 2A2 4 ---  2B2 4 ---  2A3 4 ---  2B3 4 --- }
3922: 0130 { 2A4 4 ---  2B4 4 ---  2A5 4 ---  2B5 4 --- }
3923: 0130 { 2C6 4 ---  2D6 4 ---  2C7 4 ---  2D7 4 --- }
3924: 0025 { 2C2 3 ---  2D2 3 ---  2C3 3 ---  2D3 3 --- }
3925: 001F { 20C 2 ---  21C 2 ---  20D 2 ---  21D 2 --- }
3926: 0025 { 0F8 3 ---  24D 5 ---  0F8 3 ---  24D 5 x-- }
3927: 0130 { 2C9 2 ---  2F9 2 ---  2CA 2 ---  2FA 2 --- }
3928: 0130 { 2E9 2 -y-  2EA 2 x--  2EA 2 ---  2E9 2 x-- }
3929: 0130 { 2E9 2 -y-  2EA 2 x--  2DB 2 ---  2EB 2 --- }
392A: 0130 { 2E8 2 ---  2F8 2 ---  2EB 2 ---  2FB 2 --- }
392B: 0130 { 2CA 2 ---  2FA 2 ---  2CB 2 ---  2FB 2 --- }
392C: 0025 { 20A 5 ---  21A 5 ---  20B 5 ---  21B 5 --- }
392D: 0130 { 29D 5 -y-  28D 5 -y-  29E 5 -y-  28E 5 -y- }
392E: 0130 { 29F 5 -y-  28F 5 -y-  29E 5 -y-  28E 5 -y- }
392F: 0130 { 29F 5 -y-  28F 5 -y-  29D 5 xy-  28D 5 xy- }
3930: 0130 { 2E0 4 ---  2F0 4 ---  2E1 4 ---  2F1 4 --- }
3931: 0130 { 2E2 4 ---  2F2 4 ---  2E3 4 ---  2F3 4 --- }
3932: 0130 { 2E4 4 ---  2F4 4 ---  2E5 4 ---  2F5 4 --- }
3933: 0130 { 2E6 4 ---  2F6 4 ---  2E7 4 ---  2F7 4 --- }
3934: 0025 { 2C4 3 ---  2D4 3 ---  2C5 3 ---  2D5 3 --- }
3935: 0020 { 278 2 ---  27A 2 ---  279 2 ---  27B 2 --- }
3936: 0025 { 24E 5 ---  0F8 3 ---  24E 5 x--  0F8 3 --- }
3937: 0025 { 0F8 3 ---  0F8 3 ---  26C 3 ---  26C 3 --- }
3938: 0025 { 27C 3 ---  27C 3 ---  25D 3 ---  25D 3 --- }
3939: 0025 { 24F 3 ---  24F 3 ---  0F8 3 ---  0F8 3 --- }
393A: 0025 { 224 3 ---  234 3 ---  225 3 ---  235 3 --- }
393B: 0025 { 244 3 ---  254 3 ---  245 3 ---  255 3 --- }
393C: 0025 { 0A2 5 ---  0F8 3 ---  0A2 5 x--  0F8 3 --- }
393D: 01F0 { 224 3 ---  234 3 ---  225 3 ---  235 3 --- }
393E: 01F0 { 244 3 ---  254 3 ---  245 3 ---  255 3 --- }
393F: 0025 { 08E 3 ---  09E 3 ---  08F 3 ---  09F 3 --- }
3940: 0130 { 2CC 7 ---  2DC 7 ---  2CD 7 ---  2DD 7 --- }
3941: 0130 { 2CE 7 ---  2DE 7 ---  2CF 7 ---  2DF 7 --- }
3942: 0130 { 2CC 7 ---  2DC 7 ---  2CF 7 ---  2DF 7 --- }
3943: 0025 { 20E 2 ---  21E 2 ---  20F 2 ---  21F 2 --- }
3944: 0025 { 2D2 3 -y-  2C2 3 -y-  2D3 3 -y-  2C3 3 -y- }
3945: 0130 { 17C 2 ---  2EA 2 x--  17D 2 ---  2E9 2 x-- }
3946: 0130 { 17E 2 ---  2EA 2 x--  17F 2 ---  2E9 2 x-- }
3947: 0130 { 2C9 2 ---  17C 2 ---  2CA 2 ---  17D 2 --- }
3948: 0130 { 2C9 2 ---  17E 2 ---  2CA 2 ---  17F 2 --- }
3949: 0130 { 2EA 2 x--  17C 2 ---  2E9 2 x--  17D 2 --- }
394A: 0130 { 2EA 2 x--  17E 2 ---  2E9 2 x--  17F 2 --- }
394B: 0130 { 17C 2 ---  2F9 2 ---  17D 2 ---  2FA 2 --- }
394C: 0130 { 17E 2 ---  2F9 2 ---  17F 2 ---  2FA 2 --- }
394D: 0130 { 2D8 2 ---  2E8 2 ---  13C 2 ---  14C 2 --- }
394E: 0130 { 13D 2 ---  14D 2 ---  2DB 2 ---  2EB 2 --- }
394F: ~
3950: 0025 { 0F8 5 ---  25E 3 ---  26D 5 ---  27D 5 --- }
3951: 0025 { 0F8 5 ---  25E 3 ---  0F8 5 ---  25F 3 --- }
3952: 0025 { 25F 3 xy-  0F8 5 ---  26D 5 ---  27D 5 --- }
3953: 0025 { 22E 2 ---  23E 2 ---  22F 2 ---  23F 2 --- }
3954: ~
3955: ~
3956: ~
3957: ~
3958: ~
3959: ~
395A: ~
395B: ~
395C: ~
395D: 0130 { 2D8 2 ---  2E8 2 ---  15C 2 ---  16C 2 --- }
395E: 0130 { 15D 2 ---  16D 2 ---  2DB 2 ---  2EB 2 --- }
395F: ~
3960: 0025 { 0F8 5 ---  0F8 5 ---  26D 5 ---  27D 5 --- }
3961: 012F { 26E 5 ---  27E 5 ---  26F 5 ---  27F 5 --- }
3962: 0025 { 26D 5 x--  27D 5 x--  0F8 5 x--  0F8 5 x-- }
3963: 0130 { 13E 2 ---  14E 2 ---  13F 2 ---  14F 2 --- }
3964: 0130 { 13C 2 ---  14C 2 ---  13D 2 ---  14D 2 --- }
3965: ~
3966: ~
3967: ~
3968: ~
3969: ~
396A: ~
396B: ~
396C: ~
396D: ~
396E: ~
396F: ~
3970: 0025 { 26D 5 x--  27D 5 x--  0F8 5 x--  25F 3 --- }
3971: 0025 { 25E 3 -y-  0F8 5 -y-  25F 3 -y-  0F8 5 -y- }
3972: 0025 { 26D 5 x--  27D 5 x--  25F 3 -y-  0F8 5 x-- }
3973: 0130 { 15E 2 ---  16E 2 ---  15F 2 ---  16F 2 --- }
3974: 0130 { 15C 2 ---  16C 2 ---  15D 2 ---  16D 2 --- }
3975: ~
3976: ~
3977: ~
3978: ~
3979: ~
397A: ~
397B: ~
397C: ~
397D: ~
397E: ~
397F: ~
3980: 0106 { 204 3 ---  214 3 ---  243 3 ---  253 3 --- }
3981: 0106 { 242 3 ---  252 3 ---  243 3 ---  253 3 --- }
3982: 0106 { 242 3 ---  252 3 ---  207 3 ---  217 3 --- }
3983: 0130 { 240 3 ---  250 3 ---  241 3 ---  251 3 --- }
3984: 0130 { 241 3 x--  251 3 x--  240 3 x--  250 3 x-- }
3985: 0130 { 261 3 x--  271 3 x--  260 3 x--  270 3 x-- }
3986: ~
3987: ~
3988: ~
3989: ~
398A: ~
398B: ~
398C: ~
398D: ~
398E: ~
398F: ~
3990: 0130 { 252 3 -y-  242 3 -y-  253 3 -y-  243 3 -y- }
3991: 0130 { 250 3 -y-  240 3 -y-  251 3 -y-  241 3 -y- }
3992: 0130 { 251 3 xy-  241 3 xy-  250 3 xy-  240 3 xy- }
3993: 0130 { 208 3 ---  218 3 ---  209 3 ---  219 3 --- }
3994: 0130 { 209 3 x--  219 3 x--  208 3 x--  218 3 x-- }
3995: 0130 { 240 3 ---  240 3 -y-  243 3 ---  243 3 -y- }
3996: ~
3997: ~
3998: ~
3999: ~
399A: ~
399B: ~
399C: ~
399D: ~
399E: ~
399F: ~
39A0: 0025 { 224 3 ---  234 3 ---  225 3 ---  235 3 --- }
39A1: 0130 { 208 3 ---  218 3 ---  208 3 x--  218 3 x-- }
39A2: 0130 { 270 3 -y-  260 3 -y-  270 3 xy-  260 3 xy- }
39A3: 0130 { 260 3 ---  270 3 ---  261 3 ---  271 3 --- }
39A4: 0130 { 261 3 x--  271 3 x--  260 3 x--  270 3 x-- }
39A5: 0130 { 242 3 ---  252 3 ---  243 3 ---  253 3 --- }
39A6: ~
39A7: ~
39A8: ~
39A9: ~
39AA: 0025 { 0F8 4 ---  0F8 4 ---  0F8 4 ---  0F8 4 --- }
39AB: 0025 { 0F8 4 ---  0F8 4 ---  0F8 4 ---  0F8 4 --- }
39AC: 0025 { 0F8 4 ---  0F8 4 ---  0F8 4 ---  0F8 4 --- }
39AD: 0025 { 0F8 4 ---  0F8 4 ---  0F8 4 ---  0F8 4 --- }
39AE: 0025 { 0F8 4 ---  0F8 4 ---  0F8 4 ---  0F8 4 --- }
39AF: 0025 { 0F8 4 ---  0F8 4 ---  0F8 4 ---  0F8 4 --- }
39B0: 0025 { 244 3 ---  254 3 ---  245 3 ---  255 3 --- }
39B1: 0130 { 208 3 ---  240 3 -y-  208 3 x--  240 3 xy- }
39B2: 0130 { 214 3 -y-  204 3 -y-  217 3 -y-  207 3 -y- }
39B3: 0130 { 270 3 -y-  260 3 -y-  271 3 -y-  261 3 -y- }
39B4: 0130 { 271 3 xy-  261 3 xy-  270 3 xy-  260 3 xy- }
39B5: 0130 { 242 3 ---  241 3 -y-  243 3 ---  241 3 xy- }
39B6: ~
39B7: ~
39B8: ~
39B9: ~
39BA: 0025 { 0F8 4 ---  0F8 4 ---  0F8 4 ---  0F8 4 --- }
39BB: 0025 { 28A 4 ---  29A 4 ---  28B 4 ---  23D 2 --- }
39BC: 0025 { 2B8 4 ---  23D 2 ---  2B8 4 ---  23D 2 --- }
39BD: 0025 { 2B8 4 ---  23D 2 ---  2B8 4 ---  23D 2 --- }
39BE: 0025 { 28B 4 x--  23D 2 ---  28A 4 x--  29B 4 x-- }
39BF: 0025 { 0F8 4 ---  0F8 4 ---  0F8 4 ---  0F8 4 --- }
39C0: 0025 { 264 3 ---  274 3 ---  265 3 ---  275 3 --- }
39C1: 0025 { 266 3 ---  276 3 ---  267 3 ---  277 3 --- }
39C2: 0025 { 277 3 ---  277 3 ---  274 3 -y-  277 3 --- }
39C3: 0025 { 274 3 xy-  277 3 x--  277 3 x--  277 3 x-- }
39C4: 0130 { 240 3 ---  208 3 -y-  240 3 x--  208 3 xy- }
39C5: 0130 { 242 3 ---  260 3 -y-  243 3 ---  271 3 xy- }
39C6: ~
39C7: ~
39C8: ~
39C9: ~
39CA: 0025 { 0F8 4 ---  0F8 4 ---  0F8 4 ---  0F8 4 --- }
39CB: 0025 { 29B 4 ---  29B 4 ---  228 2 ---  238 2 --- }
39CC: 0025 { 229 2 ---  239 2 ---  23D 2 ---  23A 2 --- }
39CD: 0025 { 22B 2 ---  23B 2 ---  22C 2 ---  23C 2 --- }
39CE: 0025 { 22D 2 ---  23D 2 ---  29B 4 x--  29B 4 x-- }
39CF: 0025 { 0F8 4 ---  0F8 4 ---  0F8 4 ---  0F8 4 --- }
39D0: 0025 { 267 3 x--  277 3 x--  266 3 x--  276 3 x-- }
39D1: 0025 { 265 3 x--  275 3 x--  264 3 x--  274 3 x-- }
39D2: 0130 { 214 3 -y-  204 3 -y-  253 3 -y-  243 3 -y- }
39D3: 0130 { 252 3 -y-  242 3 -y-  217 3 -y-  207 3 -y- }
39D4: ~
39D5: ~
39D6: ~
39D7: ~
39D8: ~
39D9: ~
39DA: 0025 { 0F8 4 ---  0F8 4 ---  0F8 4 ---  0F8 4 --- }
39DB: 0025 { 29B 4 ---  29B 4 ---  248 2 ---  258 2 --- }
39DC: 0025 { 249 2 ---  259 2 ---  24A 2 ---  25A 2 --- }
39DD: 0025 { 24B 2 ---  25B 2 ---  24C 2 ---  25C 2 --- }
39DE: 0025 { 23D 2 ---  23D 2 ---  29B 4 x--  29B 4 x-- }
39DF: 0025 { 0F8 4 ---  0F8 4 ---  0F8 4 ---  0F8 4 --- }
39E0: ~
39E1: ~
39E2: ~
39E3: ~
39E4: ~
39E5: ~
39E6: ~
39E7: ~
39E8: ~
39E9: ~
39EA: 0025 { 0F8 4 ---  0F8 4 ---  0F8 4 ---  0F8 4 --- }
39EB: 0025 { 29B 4 ---  29A 4 -y-  268 2 ---  23D 2 --- }
39EC: 0025 { 269 2 ---  23D 2 ---  26A 2 ---  23D 2 --- }
39ED: 0025 { 26B 2 ---  23D 2 ---  23D 2 ---  23D 2 --- }
39EE: 0025 { 23D 2 ---  23D 2 ---  29B 4 x--  29A 4 xy- }
39EF: 0025 { 0F8 4 ---  0F8 4 ---  0F8 4 ---  0F8 4 --- }
39F0: ~
39F1: ~
39F2: ~
39F3: ~
39F4: ~
39F5: ~
39F6: ~
39F7: ~
39F8: ~
39F9: ~
39FA: 0025 { 0F8 4 ---  0F8 4 ---  0F8 4 ---  0F8 4 --- }
39FB: 0025 { 28A 4 -y-  0F8 4 ---  28B 4 -y-  0F8 4 --- }
39FC: 0025 { 2B8 4 -y-  0F8 4 ---  2B8 4 -y-  0F8 4 --- }
39FD: 0025 { 2B8 4 -y-  0F8 4 ---  2B8 4 -y-  0F8 4 --- }
39FE: 0025 { 28B 4 xy-  0F8 4 ---  28A 4 xy-  0F8 4 --- }
39FF: 0025 { 0F8 4 ---  0F8 4 ---  0F8 4 ---  0F8 4 --- }
