1600: 0130 { 200 3 ---  210 3 ---  201 3 ---  211 3 --- }
1601: 0130 { 280 2 ---  290 2 ---  281 2 ---  291 2 --- }
1602: 0130 { 282 2 ---  292 2 ---  283 2 ---  293 2 --- }
1603: 0130 { 284 2 ---  294 2 ---  285 2 ---  295 2 --- }
1604: 0130 { 286 2 ---  296 2 ---  287 2 ---  297 2 --- }
1605: 0130 { 288 2 ---  298 2 ---  289 2 ---  299 2 --- }
1606: 0130 { 28A 2 ---  29A 2 ---  28B 2 ---  29B 2 --- }
1607: 0130 { 28C 2 ---  29C 2 ---  28D 2 ---  29D 2 --- }
1608: 0130 { 28E 2 ---  29E 2 ---  28F 2 ---  29F 2 --- }
1609: 0153 { 182 7 ---  182 6 xy-  182 7 xy-  182 6 --- }
160A: ~
160B: ~
160C: ~
160D: ~
160E: ~
160F: ~
1610: 0130 { 000 5 ---  010 5 ---  001 5 ---  011 5 --- }
1611: 0130 { 002 5 ---  012 5 ---  003 5 ---  013 5 --- }
1612: 0130 { 024 5 ---  034 5 ---  025 5 ---  035 5 --- }
1613: 0130 { 004 5 ---  014 5 ---  005 5 ---  015 5 --- }
1614: 1610 { 000 3 ---  010 3 ---  001 3 ---  011 3 --- }
1615: 1611 { 002 3 ---  012 3 ---  003 3 ---  013 3 --- }
1616: ~
1617: ~
1618: ~
1619: ~
161A: ~
161B: ~
161C: ~
161D: ~
161E: ~
161F: ~
1620: 0130 { 1AC 1 ---  1BC 1 ---  1AD 1 ---  1BD 1 --- }
1621: 0130 { 1AD 1 x--  1BD 1 x--  1AC 1 x--  1BC 1 x-- }
1622: 0130 { 1CC 1 ---  1DC 6 ---  1CD 1 ---  1DD 6 --- }
1623: 0130 { 1CD 1 x--  1DE 6 ---  1CC 1 x--  1DF 6 --- }
1624: ~
1625: ~
1626: ~
1627: ~
1628: ~
1629: ~
162A: ~
162B: ~
162C: ~
162D: ~
162E: ~
162F: ~
1630: 0025 { 200 7 ---  210 7 ---  201 7 ---  211 7 --- }
1631: 0025 { 202 7 ---  212 7 ---  203 7 ---  213 7 --- }
1632: 0025 { 204 7 ---  214 7 ---  205 7 ---  215 7 --- }
1633: ~
1634: ~
1635: ~
1636: ~
1637: ~
1638: ~
1639: ~
163A: ~
163B: ~
163C: ~
163D: ~
163E: ~
163F: ~
1640: 0025 { 220 7 ---  230 7 ---  221 7 ---  231 7 --- }
1641: 0025 { 222 7 ---  232 7 ---  223 7 ---  233 7 --- }
1642: 0130 { 224 7 ---  234 7 ---  225 7 ---  235 7 --- }
1643: 0130 { 226 7 ---  236 7 ---  227 7 ---  237 7 --- }
1644: 0130 { 228 7 ---  238 7 ---  229 7 ---  239 7 --- }
1645: ~
1646: ~
1647: ~
1648: ~
1649: ~
164A: ~
164B: ~
164C: ~
164D: ~
164E: ~
164F: ~
1650: 01E2 { 192 2 -y-  186 2 -y-  193 2 -y-  195 2 -y- }
1651: 01E4 { 192 2 -y-  194 2 -y-  193 2 -y-  186 2 xy- }
1652: 0025 { 0F8 7 ---  0F8 7 -y-  0F8 7 x--  0F8 7 xy- }
1653: 0025 { 0F8 7 ---  0F8 7 -y-  0F8 7 x--  0F8 7 xy- }
1654: 0025 { 0F8 7 ---  0F8 7 -y-  0F8 7 x--  0F8 7 xy- }
1655: ~
1656: ~
1657: ~
1658: ~
1659: ~
165A: ~
165B: ~
165C: ~
165D: ~
165E: ~
165F: ~
1660: 015D { 184 7 xy-  182 7 xy-  185 7 xy-  182 7 --- }
1661: 0153 { 182 7 ---  182 7 xy-  182 7 xy-  182 7 --- }
1662: 0154 { 182 7 ---  184 7 ---  182 7 xy-  185 7 --- }
1663: 015C { 187 7 xy-  188 7 xy-  182 7 xy-  182 7 --- }
1664: 0155 { 182 7 ---  182 7 xy-  187 7 ---  188 7 --- }
1665: 0073 { 182 7 ---  182 7 xy-  182 7 xy-  183 7 --- }
1666: 0074 { 182 7 ---  186 7 ---  182 7 xy-  182 7 --- }
1667: 0075 { 182 7 ---  182 7 xy-  189 7 ---  182 7 --- }
1668: 0076 { 18A 7 ---  182 7 xy-  182 7 xy-  182 7 --- }
1669: 0130 { 182 7 ---  184 7 ---  187 7 ---  1FD 7 --- }
166A: 0130 { 187 7 xy-  18B 7 ---  182 7 xy-  185 7 --- }
166B: 0130 { 18C 7 ---  188 7 xy-  185 7 xy-  182 7 --- }
166C: 0130 { 184 7 xy-  182 7 xy-  18D 7 ---  188 7 --- }
166D: ~
166E: ~
166F: ~
1670: 0066 { 0F8 7 ---  00E 7 ---  0F8 7 ---  00F 7 --- }
1671: 0067 { 0F8 7 ---  08C 7 ---  0F8 7 ---  00B 7 --- }
1672: 0068 { 01E 7 ---  0F8 5 ---  01F 7 ---  0D5 7 --- }
1673: 0069 { 09C 7 ---  0F8 7 ---  0F8 7 ---  0F8 5 --- }
1674: ~
1675: ~
1676: ~
1677: ~
1678: ~
1679: ~
167A: ~
167B: ~
167C: ~
167D: ~
167E: ~
167F: ~
1680: 0316 { 182 7 ---  184 7 ---  182 7 xy-  185 7 --- }
1681: 0317 { 182 7 ---  184 7 ---  182 7 xy-  185 7 --- }
1682: ~
1683: ~
1684: ~
1685: ~
1686: ~
1687: ~
1688: ~
1689: ~
168A: ~
168B: ~
168C: ~
168D: ~
168E: ~
168F: ~
1690: 0025 { 0F8 4 ---  0F8 4 ---  0F8 4 ---  0F8 4 --- }
1691: ~
1692: ~
1693: ~
1694: ~
1695: ~
1696: ~
1697: ~
1698: ~
1699: ~
169A: ~
169B: ~
169C: ~
169D: ~
169E: ~
169F: ~
16A0: ~
16A1: ~
16A2: ~
16A3: ~
16A4: ~
16A5: ~
16A6: ~
16A7: ~
16A8: ~
16A9: ~
16AA: ~
16AB: ~
16AC: ~
16AD: ~
16AE: ~
16AF: ~
16B0: ~
16B1: ~
16B2: ~
16B3: ~
16B4: ~
16B5: ~
16B6: ~
16B7: ~
16B8: ~
16B9: ~
16BA: ~
16BB: ~
16BC: ~
16BD: ~
16BE: ~
16BF: ~
16C0: ~
16C1: ~
16C2: ~
16C3: ~
16C4: ~
16C5: ~
16C6: ~
16C7: ~
16C8: ~
16C9: ~
16CA: ~
16CB: ~
16CC: ~
16CD: ~
16CE: ~
16CF: ~
16D0: ~
16D1: ~
16D2: ~
16D3: ~
16D4: ~
16D5: ~
16D6: ~
16D7: ~
16D8: ~
16D9: ~
16DA: ~
16DB: ~
16DC: ~
16DD: ~
16DE: ~
16DF: ~
16E0: ~
16E1: ~
16E2: ~
16E3: ~
16E4: ~
16E5: ~
16E6: ~
16E7: ~
16E8: ~
16E9: ~
16EA: ~
16EB: ~
16EC: ~
16ED: ~
16EE: ~
16EF: ~
16F0: ~
16F1: ~
16F2: ~
16F3: ~
16F4: ~
16F5: ~
16F6: ~
16F7: ~
16F8: ~
16F9: ~
16FA: ~
16FB: ~
16FC: ~
16FD: ~
16FE: ~
16FF: ~
