6E00: 0025 { 0F8 3 ---  0F8 3 ---  1D0 3 ---  0F8 3 --- }
6E01: 0025 { 1E0 3 ---  0F8 3 ---  1F0 3 ---  0F8 3 --- }
6E02: 0025 { 0F8 3 ---  0F8 3 ---  1E1 3 ---  1F1 3 --- }
6E03: 0025 { 1E2 3 ---  1F2 3 ---  1E3 3 ---  1F3 3 --- }
6E04: ~
6E05: ~
6E06: 0130 { 0F8 5 ---  11C 5 ---  0F8 5 ---  11D 5 --- }
6E07: ~
6E08: 0025 { 0F8 5 ---  0F8 5 ---  0F8 5 ---  280 5 --- }
6E09: 0025 { 0F8 5 ---  281 5 ---  0F8 5 ---  282 5 --- }
6E0A: 0025 { 0F8 5 ---  283 5 ---  0F8 5 ---  284 5 --- }
6E0B: ~
6E0C: ~
6E0D: ~
6E0E: ~
6E0F: ~
6E10: 0025 { 0F8 5 ---  130 5 ---  0F8 5 ---  131 5 --- }
6E11: 0025 { 0F8 5 ---  132 5 ---  0F8 5 ---  133 5 --- }
6E12: 0025 { 0F8 5 ---  134 5 ---  0F8 5 ---  0F8 5 --- }
6E13: 0025 { 0F8 5 ---  136 5 ---  0F8 5 ---  137 5 --- }
6E14: 0025 { 0F8 5 ---  138 5 ---  0F8 5 ---  139 5 --- }
6E15: 0025 { 12A 5 ---  13A 5 ---  12B 5 ---  13B 5 --- }
6E16: 0025 { 12C 5 ---  13C 5 ---  12D 5 ---  13D 5 --- }
6E17: 0025 { 12E 5 ---  13E 5 ---  0F8 5 ---  13F 5 --- }
6E18: 0025 { 0F8 5 ---  0F8 5 ---  290 5 ---  0F8 5 --- }
6E19: 0025 { 291 5 ---  0F8 5 ---  292 5 ---  2A2 5 --- }
6E1A: 0025 { 293 5 ---  2A3 5 ---  294 5 ---  2A4 5 --- }
6E1B: 0025 { 295 5 ---  2A5 5 ---  296 5 ---  2A6 5 --- }
6E1C: 0025 { 297 5 ---  2A7 5 ---  298 5 ---  2A8 5 --- }
6E1D: ~
6E1E: ~
6E1F: ~
6E20: 0025 { 140 5 ---  150 5 ---  141 5 ---  151 5 --- }
6E21: 0025 { 142 5 ---  152 5 ---  143 5 ---  153 5 --- }
6E22: 0025 { 144 5 ---  154 5 ---  145 5 ---  155 5 --- }
6E23: 0025 { 146 5 ---  156 5 ---  147 5 ---  157 5 --- }
6E24: 0025 { 148 5 ---  158 5 ---  149 5 ---  159 5 --- }
6E25: 0025 { 14A 5 ---  15A 5 ---  14B 5 ---  15B 5 --- }
6E26: 0025 { 14C 5 ---  15C 5 ---  14D 5 ---  15D 5 --- }
6E27: 0025 { 14E 5 ---  15E 5 ---  14F 5 ---  15F 5 --- }
6E28: ~
6E29: ~
6E2A: 0025 { 0F8 1 ---  0F8 1 ---  0F8 1 ---  009 4 --- }
6E2B: 0025 { 0F8 2 ---  017 4 ---  026 4 x--  018 4 --- }
6E2C: 0025 { 021 4 ---  031 4 ---  022 4 ---  032 4 --- }
6E2D: 0025 { 023 4 ---  033 4 ---  024 4 ---  034 4 --- }
6E2E: 0025 { 025 4 ---  035 4 ---  026 4 ---  036 4 --- }
6E2F: ~
6E30: 0025 { 160 5 ---  170 5 ---  161 5 ---  171 5 --- }
6E31: 0025 { 162 5 ---  172 5 ---  163 5 ---  173 5 --- }
6E32: 0025 { 164 5 ---  164 5 ---  164 5 ---  164 5 --- }
6E33: 0025 { 164 5 ---  164 5 ---  164 5 ---  177 5 --- }
6E34: 0025 { 168 5 ---  178 5 ---  169 5 ---  179 5 --- }
6E35: 0025 { 16A 5 ---  17A 5 ---  16B 5 ---  17B 5 --- }
6E36: 0025 { 16C 5 ---  17C 5 ---  16D 5 ---  17D 5 --- }
6E37: 0025 { 16E 5 ---  17E 5 ---  16F 5 ---  17F 5 --- }
6E38: ~
6E39: 0025 { 0F8 1 ---  1BF 4 ---  0F8 1 ---  1DE 4 --- }
6E3A: 0025 { 1CF 4 ---  1DF 4 ---  1EE 4 ---  1FE 4 --- }
6E3B: 0025 { 1EF 4 ---  1FF 4 ---  000 4 ---  010 4 --- }
6E3C: 0025 { 001 4 ---  011 4 ---  002 4 ---  012 4 --- }
6E3D: 0025 { 003 4 ---  013 4 ---  004 4 ---  014 4 --- }
6E3E: 0025 { 005 4 ---  015 4 ---  006 4 ---  016 4 --- }
6E3F: ~
6E40: 0025 { 100 5 ---  10D 5 ---  101 5 ---  10E 5 --- }
6E41: 0025 { 102 5 ---  10E 5 ---  103 5 ---  10E 5 --- }
6E42: 0025 { 103 5 ---  10E 5 ---  103 5 ---  10E 5 --- }
6E43: 0025 { 104 5 ---  10E 5 ---  105 5 ---  10E 5 --- }
6E44: 0025 { 106 5 ---  10E 5 ---  107 5 ---  10E 5 --- }
6E45: 0025 { 103 5 ---  10E 5 ---  108 5 ---  10E 5 --- }
6E46: 0025 { 109 5 ---  10E 5 ---  10A 5 ---  10E 5 --- }
6E47: 0025 { 10B 5 ---  10E 5 ---  10C 5 ---  10F 5 --- }
6E48: 0025 { 200 4 ---  210 4 ---  201 4 ---  211 4 --- }
6E49: 0025 { 202 4 ---  212 4 ---  203 4 ---  213 4 --- }
6E4A: 0025 { 204 4 ---  214 4 ---  205 4 ---  215 4 --- }
6E4B: 0025 { 206 4 ---  216 4 ---  207 4 ---  217 4 --- }
6E4C: 0025 { 208 4 ---  218 4 ---  209 4 ---  219 4 --- }
6E4D: 0025 { 20A 4 ---  21A 4 ---  20B 4 ---  21B 4 --- }
6E4E: 0025 { 20C 4 ---  21C 4 ---  20D 4 ---  21D 4 --- }
6E4F: 0025 { 20E 4 ---  21E 4 ---  200 4 x--  21F 4 --- }
6E50: 0025 { 110 5 ---  120 5 ---  111 5 ---  121 5 --- }
6E51: 0025 { 28E 6 ---  29E 6 ---  28F 6 ---  29F 6 --- }
6E52: ~
6E53: 0025 { 111 5 x--  121 5 x--  110 5 x--  120 5 x-- }
6E54: 0025 { 112 5 ---  122 5 ---  113 5 ---  123 5 --- }
6E55: 0025 { 114 5 ---  124 5 ---  115 5 ---  125 5 --- }
6E56: 0025 { 116 5 ---  126 5 ---  117 5 ---  127 5 --- }
6E57: 0025 { 110 5 ---  120 5 ---  111 5 ---  121 5 --- }
6E58: 0025 { 220 4 ---  230 4 ---  221 4 ---  231 4 --- }
6E59: 0025 { 222 4 ---  232 4 ---  223 4 ---  233 4 --- }
6E5A: 0025 { 224 4 ---  234 4 ---  225 4 ---  235 4 --- }
6E5B: 0025 { 226 4 ---  236 4 ---  227 4 ---  237 4 --- }
6E5C: 0025 { 228 4 ---  238 4 ---  229 4 ---  239 4 --- }
6E5D: 0025 { 22A 4 ---  23A 4 ---  22B 4 ---  23B 4 --- }
6E5E: 0025 { 22C 4 ---  23C 4 ---  22D 4 ---  23D 4 --- }
6E5F: 0025 { 22E 4 ---  23E 4 ---  22F 4 ---  23F 4 --- }
6E60: 0025 { 120 5 ---  120 5 ---  121 5 ---  121 5 --- }
6E61: 0025 { 29E 6 ---  2AE 6 ---  29F 6 ---  2AF 6 --- }
6E62: ~
6E63: 0025 { 121 5 x--  121 5 x--  120 5 x--  120 5 x-- }
6E64: 0025 { 118 5 ---  128 5 ---  119 5 ---  129 5 --- }
6E65: 0025 { 11A 5 ---  11B 5 ---  11E 5 ---  11F 5 --- }
6E66: 0025 { 12F 5 ---  165 5 ---  135 5 ---  166 5 --- }
6E67: 0025 { 120 5 ---  120 5 ---  121 5 ---  121 5 --- }
6E68: 0025 { 240 4 ---  250 4 ---  241 4 ---  251 4 --- }
6E69: 0025 { 242 4 ---  252 4 ---  243 4 ---  253 4 --- }
6E6A: 0025 { 244 4 ---  253 4 ---  245 4 ---  255 4 --- }
6E6B: 0025 { 246 4 ---  256 4 ---  247 4 ---  257 4 --- }
6E6C: 0025 { 248 4 ---  258 4 ---  249 4 ---  253 4 --- }
6E6D: 0025 { 24A 4 ---  253 4 ---  24B 4 ---  253 4 --- }
6E6E: 0025 { 24C 4 ---  253 4 ---  24D 4 ---  25D 4 --- }
6E6F: 0025 { 24E 4 ---  25E 4 ---  24F 4 ---  25F 4 --- }
6E70: 0025 { 120 5 ---  110 5 -y-  121 5 ---  111 5 -y- }
6E71: 0025 { 2BF 6 x--  2BF 6 x--  2BE 6 x--  2BE 6 x-- }
6E72: ~
6E73: 0025 { 121 5 x--  287 5 ---  167 5 ---  288 5 --- }
6E74: 0025 { 174 5 ---  289 5 ---  175 5 ---  28A 5 --- }
6E75: 0025 { 175 5 ---  28A 5 ---  175 5 ---  28A 5 --- }
6E76: 0025 { 175 5 ---  28A 5 ---  176 5 ---  28B 5 --- }
6E77: 0025 { 286 5 ---  28C 5 ---  121 5 ---  111 5 -y- }
6E78: 0025 { 260 4 ---  270 4 ---  261 4 ---  271 4 --- }
6E79: 0025 { 180 3 ---  190 3 ---  181 3 ---  191 3 --- }
6E7A: 0025 { 182 3 ---  192 3 ---  183 3 ---  193 3 --- }
6E7B: 0025 { 266 4 ---  276 4 ---  267 4 ---  277 4 --- }
6E7C: 0025 { 268 4 ---  278 4 ---  269 4 ---  279 4 --- }
6E7D: 0025 { 26A 4 ---  27A 4 ---  26B 4 ---  27B 4 --- }
6E7E: 0025 { 26C 4 ---  27C 4 ---  26D 4 ---  27D 4 --- }
6E7F: 0025 { 26E 4 ---  27E 4 ---  26F 4 ---  27F 4 --- }
6E80: ~
6E81: ~
6E82: 0025 { 0F8 1 ---  0F8 1 ---  0F8 1 ---  195 1 --- }
6E83: 0025 { 186 1 ---  196 1 ---  187 1 ---  197 1 --- }
6E84: 0025 { 187 1 x--  197 1 x--  186 1 x--  196 1 x-- }
6E85: 0025 { 0F8 1 ---  195 1 x--  0F8 1 ---  0F8 1 --- }
6E86: ~
6E87: ~
6E88: 0025 { 262 4 ---  272 4 ---  263 4 ---  273 4 --- }
6E89: 0025 { 1A0 3 ---  1B0 3 ---  1A1 3 ---  1B1 3 --- }
6E8A: 0025 { 1A2 3 ---  1B2 3 ---  1A3 3 ---  1B3 3 --- }
6E8B: 0025 { 2D9 4 ---  2E9 4 ---  2DA 4 ---  2EA 4 --- }
6E8C: 0025 { 2DB 4 ---  2EB 4 ---  2DC 4 ---  2EC 4 --- }
6E8D: 0025 { 2DD 4 ---  2ED 4 ---  2DE 4 ---  2EE 4 --- }
6E8E: 0025 { 2DF 4 ---  2EF 4 ---  2F0 4 ---  2F1 4 --- }
6E8F: 0025 { 2F2 4 ---  2F7 4 ---  2F6 4 ---  2F8 4 --- }
6E90: 0025 { 1A0 1 ---  1B0 1 ---  1A1 1 ---  1B1 1 --- }
6E91: ~
6E92: 0025 { 0F8 1 ---  0F8 1 ---  1A5 1 ---  1B5 1 --- }
6E93: 0025 { 1A6 1 ---  1B6 1 ---  1A7 1 ---  1B7 1 --- }
6E94: 0025 { 1A7 1 x--  1B7 1 x--  1A6 1 x--  1B6 1 x-- }
6E95: 0025 { 1A5 1 x--  1B5 1 x--  0F8 1 ---  0F8 1 --- }
6E96: ~
6E97: 0025 { 1A1 1 x--  1B1 1 x--  1A0 1 x--  1B0 1 x-- }
6E98: 0025 { 264 4 ---  274 4 ---  265 4 ---  275 4 --- }
6E99: 0025 { 1C0 3 ---  0F8 3 ---  1C1 3 ---  1D1 3 --- }
6E9A: 0025 { 1C2 3 ---  1D2 3 ---  1C3 3 ---  1D3 3 --- }
6E9B: 0025 { 2F9 4 ---  28D 4 ---  2FA 4 ---  299 4 --- }
6E9C: 0025 { 2FB 4 ---  29A 4 ---  2FC 4 ---  29B 4 --- }
6E9D: 0025 { 2FD 4 ---  29C 4 ---  2FE 4 ---  29D 4 --- }
6E9E: 0025 { 2FF 4 ---  2A9 4 ---  2CE 4 ---  2AA 4 --- }
6E9F: 0025 { 2CF 4 ---  2AB 4 ---  285 4 ---  2AC 4 --- }
6EA0: 0025 { 1C0 1 ---  1D0 1 ---  1C1 1 ---  1D1 1 --- }
6EA1: 0025 { 1C2 1 ---  1D2 1 ---  1C3 1 ---  1D3 1 --- }
6EA2: 0025 { 1C4 1 ---  1D4 1 ---  1C5 1 ---  1D5 1 --- }
6EA3: 0025 { 1C6 1 ---  1D6 1 ---  1C7 1 ---  1D7 1 --- }
6EA4: 0025 { 1C7 1 x--  1D7 1 x--  1C6 1 x--  1D6 1 x-- }
6EA5: 0025 { 1C5 1 x--  1D5 1 x--  1C4 1 x--  1D4 1 x-- }
6EA6: 0025 { 1C3 1 x--  1D3 1 x--  1C2 1 x--  1D2 1 x-- }
6EA7: 0025 { 1C1 1 x--  1D1 1 x--  1C0 1 x--  1D0 1 x-- }
6EA8: ~
6EA9: ~
6EAA: 0025 { 0F8 1 ---  2A1 5 x--  0F8 1 ---  2A1 5 --- }
6EAB: ~
6EAC: ~
6EAD: ~
6EAE: ~
6EAF: ~
6EB0: 0025 { 1E0 1 ---  1F0 1 ---  1E1 1 ---  1F1 1 --- }
6EB1: 0025 { 1E2 1 ---  1F2 1 ---  1E1 1 ---  1F3 1 --- }
6EB2: 0025 { 1E4 1 ---  1F4 1 ---  1E1 1 ---  1F1 1 --- }
6EB3: 0025 { 1E2 1 ---  1F2 1 ---  1E7 1 ---  1F3 1 --- }
6EB4: 0025 { 1E7 1 x--  1F3 1 x--  1E2 1 x--  1F2 1 x-- }
6EB5: 0025 { 1E1 1 x--  1F1 1 x--  1E4 1 x--  1F4 1 x-- }
6EB6: 0025 { 1E1 1 x--  1F3 1 x--  1E2 1 x--  1F2 1 x-- }
6EB7: 0025 { 1E1 1 x--  1F1 1 x--  1E0 1 x--  1F0 1 x-- }
6EB8: 0025 { 0F8 1 ---  0F8 1 ---  2B0 1 ---  2C0 1 --- }
6EB9: 0025 { 2B1 1 ---  2C1 1 ---  2B2 1 ---  2C2 1 --- }
6EBA: 0025 { 2B3 1 ---  2C3 1 ---  2B4 1 ---  2C4 1 --- }
6EBB: 0025 { 2B5 1 ---  2C5 1 ---  0F8 1 ---  2C6 1 --- }
6EBC: 0025 { 0F8 1 ---  2C7 1 ---  2B8 1 ---  2C8 1 --- }
6EBD: 0025 { 2B9 1 ---  2C9 1 ---  2BA 1 ---  2CA 1 --- }
6EBE: 0025 { 2BB 1 ---  2CB 1 ---  2BC 1 ---  2CC 1 --- }
6EBF: 0025 { 2BD 1 ---  2CD 1 ---  0F8 1 ---  0F8 1 --- }
6EC0: 0025 { 1E5 1 ---  1F5 1 ---  1F6 1 ---  1E6 1 --- }
6EC1: 0025 { 1F7 1 ---  1FA 1 ---  1F8 1 ---  1E3 1 --- }
6EC2: 0025 { 1F9 1 ---  1E3 1 x--  1F6 1 ---  1FA 1 --- }
6EC3: 0025 { 1F7 1 ---  1A4 1 ---  1F8 1 ---  1B4 1 --- }
6EC4: 0025 { 1F8 1 x--  1B4 1 x--  1F7 1 x--  1A4 1 x-- }
6EC5: 0025 { 1F6 1 x--  1FA 1 x--  1F9 1 x--  1E3 1 --- }
6EC6: 0025 { 1F8 1 x--  1E3 1 x--  1F7 1 x--  1FA 1 x-- }
6EC7: 0025 { 1F6 1 x--  1E6 1 x--  1E5 1 x--  1F5 1 x-- }
6EC8: 0025 { 0F8 1 ---  0F8 1 ---  2D0 4 ---  2E0 4 --- }
6EC9: 0025 { 2D1 4 ---  2E1 4 ---  2D2 4 ---  2E2 4 --- }
6ECA: 0025 { 2D3 4 ---  2E3 4 ---  2D4 4 ---  2E4 4 --- }
6ECB: 0025 { 2D5 4 ---  2E5 4 ---  2D6 4 ---  2E6 4 --- }
6ECC: 0025 { 2D7 4 ---  2E7 4 ---  2D8 4 ---  2E8 4 --- }
6ECD: 0025 { 0F8 1 ---  0A6 4 ---  0F8 1 ---  0A7 4 --- }
6ECE: 0025 { 0CA 5 ---  0A8 4 ---  0CB 5 ---  0A8 4 x-- }
6ECF: 0025 { 0F8 1 ---  0A7 4 x--  0F8 1 ---  0A6 4 x-- }
6ED0: 0025 { 181 1 x--  191 1 x--  180 1 x--  190 1 x-- }
6ED1: 0130 { 180 3 ---  194 3 ---  181 3 ---  195 3 --- }
6ED2: 0130 { 182 3 ---  196 3 ---  0F8 3 ---  197 3 --- }
6ED3: 0025 { 188 1 ---  198 1 ---  189 1 ---  199 1 --- }
6ED4: 0025 { 1A8 1 ---  1B8 1 ---  1A9 1 ---  1B9 1 --- }
6ED5: 0025 { 1AA 1 ---  1BA 1 ---  1AB 1 ---  1BB 1 --- }
6ED6: 0025 { 1AC 1 ---  1BC 1 ---  1AD 1 ---  1BD 1 --- }
6ED7: 0025 { 180 1 ---  190 1 ---  181 1 ---  191 1 --- }
6ED8: 0130 { 1E4 3 ---  1F4 3 ---  1E5 3 ---  1F5 3 --- }
6ED9: 0130 { 1E6 3 ---  1F6 3 ---  1E7 3 ---  1F7 3 --- }
6EDA: 0025 { 2F3 4 ---  0F8 1 ---  2F4 4 ---  0F8 1 --- }
6EDB: 0025 { 2F5 4 ---  0F8 1 ---  0F8 1 ---  0F8 1 --- }
6EDC: ~
6EDD: 0025 { 0B6 4 ---  0F8 1 ---  0B7 4 ---  0F8 1 --- }
6EDE: 0025 { 0B8 4 ---  0A9 1 ---  0B8 4 x--  0E6 1 --- }
6EDF: 0025 { 0B7 4 x--  0F8 1 ---  0B6 4 x--  0F8 1 --- }
6EE0: 0025 { 183 1 x--  193 1 x--  182 1 x--  192 1 x-- }
6EE1: 0130 { 1A4 3 ---  1B4 3 ---  1A5 3 ---  1B5 3 --- }
6EE2: 0130 { 1A6 3 ---  1B6 3 ---  1A7 3 ---  1B7 3 --- }
6EE3: 0025 { 18A 1 ---  19A 1 ---  18B 1 ---  19B 1 --- }
6EE4: 0025 { 1C8 1 ---  1D8 1 ---  1C9 1 ---  1D9 1 --- }
6EE5: 0025 { 1CA 1 ---  1DA 1 ---  1CB 1 ---  1DB 1 --- }
6EE6: 0025 { 1CC 1 ---  1DC 1 ---  1CD 1 ---  1DD 1 --- }
6EE7: 0025 { 182 1 ---  192 1 ---  183 1 ---  193 1 --- }
6EE8: 0025 { 0F8 3 ---  0F8 3 ---  183 3 ---  0F8 3 --- }
6EE9: 0025 { 184 3 ---  186 3 ---  185 3 ---  187 3 --- }
6EEA: 0025 { 004 4 ---  004 4 ---  004 4 ---  004 4 --- }
6EEB: 0025 { 004 4 ---  004 4 ---  004 4 ---  004 4 --- }
6EEC: 0025 { 004 4 ---  004 4 ---  004 4 ---  004 4 --- }
6EED: 0025 { 004 4 ---  004 4 ---  004 4 ---  004 4 --- }
6EEE: 0025 { 0B9 1 ---  0B9 1 ---  0F6 1 ---  0F6 1 --- }
6EEF: ~
6EF0: 0025 { 1A3 1 x--  1B3 1 x--  184 1 ---  194 1 --- }
6EF1: 0130 { 1C4 3 ---  1D4 3 ---  1C5 3 ---  1D5 3 --- }
6EF2: 0130 { 1C6 3 ---  1D6 3 ---  1C7 3 ---  1D7 3 --- }
6EF3: 0025 { 18C 1 ---  19C 1 ---  18D 1 ---  19D 1 --- }
6EF4: 0025 { 1E8 1 ---  1FD 1 x--  1E9 1 ---  1FC 1 x-- }
6EF5: 0025 { 1EA 1 ---  1FB 1 x--  1EB 1 ---  1FB 1 --- }
6EF6: 0025 { 1EC 1 ---  1FC 1 ---  1ED 1 ---  1FD 1 --- }
6EF7: 0025 { 1A2 1 ---  1B2 1 ---  1A3 1 ---  1B3 1 --- }
6EF8: 0025 { 220 5 ---  222 5 ---  221 5 ---  223 5 --- }
6EF9: 0025 { 230 5 ---  232 5 ---  231 5 ---  233 5 --- }
6EFA: 0025 { 240 5 ---  242 5 ---  241 5 ---  243 5 --- }
6EFB: 0025 { 250 5 ---  252 5 ---  251 5 ---  253 5 --- }
6EFC: 0025 { 260 5 ---  262 5 ---  261 5 ---  263 5 --- }
6EFD: 0025 { 270 5 ---  272 5 ---  271 5 ---  273 5 --- }
6EFE: 0025 { 0C6 1 ---  0D6 1 ---  0C6 1 x--  0D6 1 x-- }
6EFF: ~
