6900: 0025 { 180 4 ---  190 4 ---  181 4 ---  191 4 --- }
6901: 0025 { 182 4 ---  192 4 ---  183 4 ---  193 4 --- }
6902: 0025 { 184 4 ---  191 4 ---  182 4 ---  192 4 --- }
6903: 0025 { 183 4 ---  193 4 ---  184 4 ---  191 4 --- }
6904: 0025 { 182 4 ---  192 4 ---  183 4 ---  193 4 --- }
6905: 0025 { 184 4 ---  191 4 ---  182 4 ---  192 4 --- }
6906: 0025 { 183 4 ---  193 4 ---  184 4 ---  191 4 --- }
6907: 0025 { 18E 4 ---  192 4 ---  180 4 x--  190 4 x-- }
6908: 0025 { 100 5 ---  110 5 ---  101 5 ---  111 5 --- }
6909: 0025 { 102 5 ---  112 5 ---  103 5 ---  113 5 --- }
690A: 0025 { 104 5 ---  114 5 ---  105 5 ---  115 5 --- }
690B: 0025 { 106 5 ---  116 5 ---  107 5 ---  117 5 --- }
690C: 0025 { 108 5 ---  118 5 ---  109 5 ---  119 5 --- }
690D: 0025 { 106 5 ---  116 5 ---  107 5 ---  11B 5 --- }
690E: 0025 { 108 5 ---  11C 5 ---  109 5 ---  11D 5 --- }
690F: 0025 { 106 5 ---  11E 5 ---  100 5 x--  11F 5 --- }
6910: 0025 { 1A0 4 ---  1B0 4 ---  1A1 4 ---  1B1 4 --- }
6911: 0025 { 193 4 ---  192 4 ---  191 4 ---  193 4 --- }
6912: 0025 { 192 4 ---  191 4 ---  193 4 ---  192 4 --- }
6913: 0025 { 191 4 ---  193 4 ---  192 4 ---  191 4 --- }
6914: 0025 { 193 4 ---  192 4 ---  191 4 ---  193 4 --- }
6915: 0025 { 192 4 ---  191 4 ---  193 4 ---  192 4 --- }
6916: 0025 { 191 4 ---  193 4 ---  192 4 ---  191 4 --- }
6917: 0025 { 1AE 4 ---  1BE 4 ---  1A0 4 x--  1B0 4 x-- }
6918: 0025 { 120 5 ---  130 5 ---  121 5 ---  131 5 --- }
6919: 0025 { 122 5 ---  132 5 ---  123 5 ---  133 5 --- }
691A: 0025 { 124 5 ---  134 5 ---  125 5 ---  135 5 --- }
691B: 0025 { 126 5 ---  136 5 ---  127 5 ---  137 5 --- }
691C: 0025 { 128 5 ---  138 5 ---  129 5 ---  139 5 --- }
691D: 0025 { 12A 5 ---  13A 5 ---  12B 5 ---  13B 5 --- }
691E: 0025 { 12C 5 ---  13C 5 ---  12D 5 ---  13D 5 --- }
691F: 0025 { 12E 5 ---  13E 5 ---  12F 5 ---  13F 5 --- }
6920: 0025 { 1C0 4 ---  1D0 4 ---  1C1 4 ---  1D1 4 --- }
6921: 0025 { 1C2 4 ---  1D2 4 ---  1C3 4 ---  1D3 4 --- }
6922: 0025 { 1C4 4 ---  1D0 4 ---  1C2 4 ---  1D1 4 --- }
6923: 0025 { 1C3 4 ---  1D2 4 ---  1C4 4 ---  1D3 4 --- }
6924: 0025 { 1C2 4 ---  1D8 4 ---  1C3 4 ---  1D9 4 --- }
6925: 0025 { 1C4 4 ---  1DA 4 ---  1C2 4 ---  1DB 4 --- }
6926: 0025 { 1C3 4 ---  1DC 4 ---  1C4 4 ---  1DD 4 --- }
6927: 0025 { 1CE 4 ---  1D1 4 x--  1C0 4 x--  1D0 4 x-- }
6928: 0025 { 140 5 ---  150 5 ---  141 5 ---  151 5 --- }
6929: 0025 { 142 5 ---  152 5 ---  143 5 ---  153 5 --- }
692A: 0025 { 141 5 ---  154 5 ---  141 5 ---  155 5 --- }
692B: 0025 { 141 5 ---  156 5 ---  147 5 ---  157 5 --- }
692C: 0025 { 148 5 ---  158 5 ---  149 5 ---  159 5 --- }
692D: 0025 { 14A 5 ---  15A 5 ---  14B 5 ---  15B 5 --- }
692E: 0025 { 14C 5 ---  15C 5 ---  14D 5 ---  15D 5 --- }
692F: 0025 { 14E 5 ---  15E 5 ---  14F 5 ---  15F 5 --- }
6930: 0025 { 1EE 4 ---  1FE 4 ---  1EF 4 ---  1FF 4 --- }
6931: 0025 { 0F8 5 ---  0F8 5 ---  0F8 5 ---  265 1 --- }
6932: 0025 { 256 1 ---  266 1 ---  257 1 ---  267 1 --- }
6933: 0025 { 1EF 4 x--  1FF 4 x--  1EE 4 x--  1FE 4 x-- }
6934: 0025 { 1E8 4 ---  1F8 4 ---  1E9 4 ---  1F9 4 --- }
6935: 0025 { 1EA 4 ---  1FA 4 ---  1EB 4 ---  1FB 4 --- }
6936: 0025 { 1EC 4 ---  1FC 4 ---  1ED 4 ---  1FD 4 --- }
6937: 0025 { 1EE 4 ---  1FE 4 ---  1EF 4 ---  1FF 4 --- }
6938: 0025 { 16E 5 ---  17E 5 ---  16F 5 ---  17F 5 --- }
6939: 0025 { 087 2 ---  0A5 2 x--  087 2 ---  089 2 x-- }
693A: 0025 { 087 2 x--  082 2 -y-  087 2 x--  082 2 -y- }
693B: 0025 { 16F 5 x--  17F 5 x--  16E 5 x--  17E 5 x-- }
693C: 0025 { 168 5 ---  178 5 ---  169 5 ---  179 5 --- }
693D: 0025 { 16A 5 ---  17A 5 ---  16B 5 ---  17B 5 --- }
693E: 0025 { 16C 5 ---  17C 5 ---  168 5 x--  178 5 x-- }
693F: 0025 { 16E 5 ---  17E 5 ---  16F 5 ---  17F 5 --- }
6940: 0025 { 1A2 4 ---  1B2 4 ---  1A3 4 ---  1B3 4 --- }
6941: 0025 { 0F8 2 x--  0F8 2 x--  0F8 2 x--  252 1 x-- }
6942: 0025 { 263 1 x--  251 1 x--  0F8 2 x--  250 1 x-- }
6943: 0025 { 1A3 4 x--  1B3 4 x--  1A2 4 x--  1B2 4 x-- }
6944: 0025 { 1E0 4 ---  1F0 4 ---  1E1 4 ---  1F1 4 --- }
6945: 0025 { 1E2 4 ---  1F2 4 ---  1E1 4 ---  1F1 4 --- }
6946: 0025 { 1E2 4 ---  1F2 4 ---  1E3 4 ---  1F3 4 --- }
6947: 0025 { 1A2 4 ---  1B2 4 ---  1A3 4 ---  1B3 4 --- }
6948: 0025 { 160 5 ---  170 5 ---  161 5 ---  171 5 --- }
6949: 0025 { 0B1 2 ---  096 2 ---  082 2 ---  0A5 2 --- }
694A: 0025 { 088 2 x--  098 2 x--  087 2 x--  089 2 x-- }
694B: 0025 { 161 5 x--  171 5 x--  160 5 x--  170 5 x-- }
694C: 0025 { 10A 5 ---  10F 5 ---  10B 5 ---  11A 5 --- }
694D: 0025 { 10C 5 ---  144 5 ---  10D 5 ---  145 5 --- }
694E: 0025 { 10E 5 ---  146 5 ---  10A 5 x--  16D 5 --- }
694F: 0025 { 160 5 ---  170 5 ---  161 5 ---  171 5 --- }
6950: 0025 { 1A4 4 ---  1B4 4 ---  1A5 4 ---  1B5 4 --- }
6951: 0025 { 0F8 2 x--  273 1 x--  262 1 x--  272 1 x-- }
6952: 0025 { 261 1 x--  271 1 x--  260 1 x--  270 1 x-- }
6953: 0025 { 1A5 4 x--  1B5 4 x--  1A4 4 x--  1B4 4 x-- }
6954: 0025 { 1E4 4 ---  1F4 4 ---  1E5 4 ---  1F5 4 --- }
6955: 0025 { 1E6 4 ---  1F6 4 ---  1E7 4 ---  1F7 4 --- }
6956: 0025 { 1A6 4 ---  1B6 4 ---  1A7 4 ---  1B7 4 --- }
6957: 0025 { 1A4 4 ---  1B4 4 ---  1A5 4 ---  1B5 4 --- }
6958: 0025 { 162 5 ---  172 5 ---  163 5 ---  173 5 --- }
6959: 0025 { 087 2 ---  089 2 ---  088 2 ---  098 2 --- }
695A: 0025 { 092 2 -y-  082 2 -y-  092 2 -y-  082 2 -y- }
695B: 0025 { 163 5 x--  173 5 x--  162 5 x--  172 5 x-- }
695C: 0025 { 164 5 ---  174 5 ---  165 5 ---  175 5 --- }
695D: 0025 { 166 5 ---  176 5 ---  167 5 ---  177 5 --- }
695E: 0025 { 280 5 ---  282 5 ---  281 5 ---  28B 5 --- }
695F: 0025 { 162 5 ---  172 5 ---  163 5 ---  173 5 --- }
6960: 0025 { 200 1 ---  210 1 ---  201 1 ---  211 1 --- }
6961: 0025 { 202 1 ---  212 1 ---  203 1 ---  213 1 --- }
6962: 0025 { 204 1 ---  214 1 ---  205 1 ---  215 1 --- }
6963: 0025 { 206 1 ---  216 1 ---  207 1 ---  217 1 --- }
6964: 0025 { 207 1 x--  218 1 ---  206 1 x--  219 1 --- }
6965: 0025 { 20A 1 ---  21A 1 ---  20B 1 ---  21B 1 --- }
6966: 0025 { 20C 1 ---  21C 1 ---  20D 1 ---  21D 1 --- }
6967: 0025 { 20E 1 ---  21E 1 ---  20F 1 ---  220 1 x-- }
6968: 0025 { 0B1 2 ---  0B1 2 ---  0B1 2 ---  0B1 2 --- }
6969: 0025 { 096 2 ---  096 2 ---  098 2 ---  098 2 --- }
696A: 0025 { 098 2 x--  098 2 x--  096 2 x--  096 2 x-- }
696B: 0025 { 0AE 6 ---  0BE 6 ---  0AF 6 ---  0BF 6 --- }
696C: 0025 { 0CE 6 ---  0CE 6 ---  0CF 6 ---  0CF 6 --- }
696D: 0025 { 0CE 6 ---  0DE 6 ---  0CF 6 ---  0DF 6 --- }
696E: 0025 { 0EE 6 ---  0FE 6 ---  0EF 6 ---  0FF 6 --- }
696F: 0025 { 08E 2 ---  09E 2 ---  08F 2 ---  09F 2 --- }
6970: 0025 { 220 1 ---  210 1 ---  221 1 ---  231 1 --- }
6971: 0025 { 222 1 ---  232 1 ---  223 1 ---  233 1 --- }
6972: 0025 { 224 1 ---  234 1 ---  225 1 ---  235 1 --- }
6973: 0025 { 226 1 ---  236 1 ---  227 1 ---  237 1 --- }
6974: 0025 { 228 1 ---  238 1 ---  229 1 ---  239 1 --- }
6975: 0025 { 22A 1 ---  23A 1 ---  22B 1 ---  23B 1 --- }
6976: 0025 { 22C 1 ---  23C 1 ---  22D 1 ---  23D 1 --- }
6977: 0025 { 22E 1 ---  23E 1 ---  210 1 x--  220 1 x-- }
6978: 0025 { 082 2 ---  092 2 ---  082 2 ---  092 2 --- }
6979: 0025 { 099 2 ---  092 2 ---  098 2 ---  097 2 --- }
697A: 0025 { 098 2 x--  097 2 x--  099 2 x--  092 2 x-- }
697B: 0025 { 0AF 6 x--  0BF 6 x--  0AE 6 x--  0BE 6 x-- }
697C: 0025 { 0EF 6 x--  0FF 6 x--  0EE 6 x--  0FE 6 x-- }
697D: 0025 { 0CF 6 x--  0DF 6 x--  0CE 6 x--  0DE 6 x-- }
697E: 0025 { 0CF 6 x--  0CF 6 x--  0CE 6 x--  0CE 6 x-- }
697F: 0025 { 08C 2 ---  09C 2 ---  08D 2 ---  09D 2 --- }
6980: 0025 { 220 1 ---  25F 1 x--  241 1 ---  25E 1 x-- }
6981: 0025 { 242 1 ---  21F 1 ---  243 1 ---  21F 1 --- }
6982: 0025 { 244 1 ---  21F 1 ---  245 1 ---  21F 1 --- }
6983: 0025 { 246 1 ---  21F 1 ---  247 1 ---  21F 1 --- }
6984: 0025 { 248 1 ---  21F 1 ---  249 1 ---  21F 1 --- }
6985: 0025 { 24A 1 ---  21F 1 ---  24B 1 ---  21F 1 --- }
6986: 0025 { 24C 1 ---  21F 1 ---  24D 1 ---  21F 1 --- }
6987: 0025 { 24E 1 ---  25E 1 ---  210 1 x--  25F 1 --- }
6988: 0130 { 086 2 ---  086 2 ---  086 2 ---  086 2 --- }
6989: 0130 { 087 2 x--  087 2 -y-  087 2 x--  087 2 -y- }
698A: 0130 { 085 2 ---  0A4 2 ---  085 2 ---  0A4 2 --- }
698B: 0025 { 000 7 ---  010 7 ---  001 7 ---  011 7 --- }
698C: 0025 { 002 7 ---  012 7 ---  003 7 ---  013 7 --- }
698D: 0130 { 0A2 2 ---  086 2 ---  0A2 2 ---  086 2 --- }
698E: 0025 { 0F8 5 ---  0F8 5 ---  275 1 ---  253 1 --- }
698F: 0025 { 08A 2 ---  09A 2 ---  08B 2 ---  09B 2 --- }
6990: 0025 { 26E 1 ---  27E 1 ---  26E 1 x--  27E 1 x-- }
6991: 0025 { 257 1 x--  267 1 x--  258 1 ---  264 1 --- }
6992: 0025 { 0F8 5 x--  274 1 ---  0F8 5 ---  0F8 5 --- }
6993: 0025 { 22F 1 ---  27E 1 ---  22F 1 x--  27E 1 x-- }
6994: 0025 { 268 1 ---  278 1 ---  269 1 ---  279 1 --- }
6995: 0025 { 26A 1 ---  27A 1 ---  26B 1 ---  27B 1 --- }
6996: 0025 { 26C 1 ---  27C 1 ---  26D 1 ---  27D 1 --- }
6997: 0025 { 26E 1 ---  27E 1 ---  26E 1 x--  27E 1 x-- }
6998: 0130 { 083 2 ---  084 2 ---  084 2 ---  094 2 --- }
6999: 0025 { 0B1 2 ---  0B1 2 ---  0B1 2 ---  0A0 2 --- }
699A: 0025 { 0B1 2 ---  0A1 2 ---  0B1 2 ---  0A1 2 --- }
699B: 0025 { 0B1 2 ---  0A0 2 x--  0B1 2 ---  0B1 2 --- }
699C: 0025 { 099 2 ---  092 2 ---  098 2 ---  097 2 --- }
699D: 0025 { 0A6 7 ---  0B6 7 ---  0A7 7 ---  0B7 7 --- }
699E: 0025 { 0A8 7 ---  0B8 7 ---  0A9 7 ---  0B9 7 --- }
699F: 0025 { 0B1 2 ---  08A 2 ---  0B1 2 ---  08B 2 --- }
69A0: 0025 { 27F 1 x--  27E 1 -y-  27F 1 ---  27E 1 xy- }
69A1: 0025 { 0F8 2 ---  250 1 ---  263 1 ---  251 1 --- }
69A2: 0025 { 0F8 2 ---  252 1 ---  0F8 2 ---  0F8 2 --- }
69A3: 0025 { 27F 1 x--  27E 1 -y-  27F 1 ---  27E 1 xy- }
69A4: 0025 { 189 1 ---  199 1 ---  18A 1 ---  19A 1 --- }
69A5: 0025 { 18B 1 ---  19B 1 ---  18C 1 ---  19C 1 --- }
69A6: 0025 { 1A9 1 ---  1B9 1 ---  1AA 1 ---  1BA 1 --- }
69A7: 0025 { 27F 1 x--  27E 1 -y-  27F 1 ---  27E 1 xy- }
69A8: 0130 { 085 2 ---  095 2 ---  085 2 ---  095 2 --- }
69A9: 0025 { 0B1 2 ---  0B1 2 -y-  0B0 2 ---  0B0 2 --- }
69AA: 0025 { 0F8 2 ---  0F8 2 ---  0F8 2 ---  0F8 2 --- }
69AB: 0025 { 0B0 2 x--  0B0 2 x--  0B1 2 ---  0B1 2 --- }
69AC: 0025 { 098 2 x--  097 2 x--  099 2 x--  092 2 x-- }
69AD: 0025 { 0C6 7 ---  0D6 7 ---  0C7 7 ---  0D7 7 --- }
69AE: 0025 { 276 1 ---  254 1 ---  277 1 ---  255 1 --- }
69AF: 0025 { 09A 2 ---  0B1 2 ---  09B 2 ---  0B1 2 --- }
69B0: 0025 { 27F 1 x--  24F 1 ---  27F 1 ---  24F 1 x-- }
69B1: 0025 { 260 1 ---  270 1 ---  261 1 ---  271 1 --- }
69B2: 0025 { 262 1 ---  272 1 ---  0F8 2 ---  273 1 --- }
69B3: 0025 { 27F 1 x--  25D 1 x--  23F 1 x--  25C 1 x-- }
69B4: 0025 { 230 1 ---  25B 1 x--  240 1 ---  25A 1 x-- }
69B5: 0025 { 26F 1 ---  259 1 x--  208 1 ---  259 1 --- }
69B6: 0025 { 209 1 ---  25A 1 ---  1C6 1 ---  25B 1 --- }
69B7: 0025 { 23F 1 ---  25C 1 ---  27F 1 ---  25D 1 --- }
69B8: 0025 { 0DF 6 x--  0FF 6 x--  0DE 6 x--  0FE 6 x-- }
69B9: 0025 { 0B1 2 -y-  0B1 2 ---  0A0 2 -y-  0B1 2 --- }
69BA: 0025 { 0A1 2 -y-  0B1 2 ---  0A1 2 -y-  0B1 2 --- }
69BB: 0025 { 0A0 2 xy-  0B1 2 ---  0B1 2 ---  0B1 2 --- }
69BC: 0025 { 277 1 x--  255 1 x--  276 1 x--  254 1 x-- }
69BD: 0025 { 0E6 7 ---  0F6 7 ---  0E7 7 ---  0F7 7 --- }
69BE: 0025 { 0FD 2 ---  0F4 2 ---  0FD 2 x--  0F5 2 --- }
69BF: 0025 { 0FD 2 ---  0FD 2 ---  0FD 2 x--  0FD 2 x-- }
69C0: 0025 { 020 7 ---  030 7 ---  021 7 ---  031 7 --- }
69C1: 0025 { 022 7 ---  032 7 ---  023 7 ---  033 7 --- }
69C2: 0025 { 008 7 ---  018 7 ---  009 7 ---  019 7 --- }
69C3: 0025 { 00A 7 ---  01A 7 ---  00B 7 ---  01B 7 --- }
69C4: 0025 { 1E5 4 ---  1F5 4 ---  1E6 4 ---  1F6 4 --- }
69C5: 0025 { 1E7 4 ---  1F7 4 ---  1E8 4 ---  1F8 4 --- }
69C6: 0025 { 1E9 4 ---  1F9 4 ---  1EA 4 ---  1FA 4 --- }
69C7: 0025 { 1EB 4 ---  1FB 4 ---  1EC 4 ---  1FC 4 --- }
69C8: 0025 { 0B1 2 ---  096 2 ---  082 2 ---  0A5 2 --- }
69C9: 0025 { 082 2 ---  092 2 ---  082 2 ---  092 2 --- }
69CA: 0025 { 082 2 x--  092 2 x--  082 2 x--  092 2 x-- }
69CB: 0025 { 082 2 x--  0A5 2 x--  0B1 2 x--  096 2 x-- }
69CC: 0106 { 0AA 2 ---  0BA 0 ---  0AB 2 ---  0BB 0 --- }
69CD: 0106 { 0AB 2 x--  0BB 0 x--  0AA 2 x--  0BA 0 x-- }
69CE: 0025 { 0E8 2 ---  0F8 2 ---  0E9 2 ---  0F8 2 --- }
69CF: 0025 { 0F4 2 ---  0E8 2 ---  0F5 2 ---  0E9 2 --- }
69D0: 0025 { 280 0 ---  290 0 ---  281 0 ---  291 0 --- }
69D1: 0025 { 282 0 ---  292 0 ---  283 0 ---  293 0 --- }
69D2: 0025 { 284 0 ---  294 0 ---  285 0 ---  295 0 --- }
69D3: 0025 { 286 0 ---  296 0 ---  287 0 ---  297 0 --- }
69D4: 0025 { 288 0 ---  298 0 ---  289 0 ---  299 0 --- }
69D5: 0025 { 28A 0 ---  29A 0 ---  28B 0 ---  29B 0 --- }
69D6: 0025 { 28C 0 ---  29C 0 ---  28D 0 ---  29D 0 --- }
69D7: 0025 { 28D 0 x--  29D 0 x--  28C 0 x--  29C 0 x-- }
69D8: 0025 { 28B 0 x--  29B 0 x--  28A 0 x--  29A 0 x-- }
69D9: 0025 { 289 0 x--  299 0 x--  288 0 x--  298 0 x-- }
69DA: 0025 { 287 0 x--  297 0 x--  286 0 x--  296 0 x-- }
69DB: 0025 { 285 0 x--  295 0 x--  284 0 x--  294 0 x-- }
69DC: 0025 { 283 0 x--  293 0 x--  282 0 x--  292 0 x-- }
69DD: 0025 { 281 0 x--  291 0 x--  280 0 x--  290 0 x-- }
69DE: 0025 { 0C0 3 ---  0D0 3 ---  0C1 3 ---  0D1 3 --- }
69DF: 0025 { 0B4 3 ---  0C4 3 ---  0B5 3 ---  0C5 3 --- }
69E0: 0025 { 2A0 0 ---  2B0 0 ---  2A1 0 ---  2B1 0 --- }
69E1: 0025 { 2A2 0 ---  2B2 0 ---  2A3 0 ---  2B3 0 --- }
69E2: 0025 { 2A4 0 ---  2B4 0 ---  2A5 0 ---  2B5 0 --- }
69E3: 0025 { 2A6 0 ---  2B6 0 ---  2A7 0 ---  2B7 0 --- }
69E4: 0025 { 2A8 0 ---  2B8 0 ---  2A9 0 ---  2B9 0 --- }
69E5: 0025 { 2AA 0 ---  2BA 0 ---  2AB 0 ---  2BB 0 --- }
69E6: 0025 { 2AC 0 ---  2BC 0 ---  2AD 0 ---  2BD 0 --- }
69E7: 0025 { 2AD 0 x--  2BD 0 x--  2AC 0 x--  2BC 0 x-- }
69E8: 0025 { 180 4 ---  2BB 0 x--  181 4 ---  2BA 0 x-- }
69E9: 0025 { 2A9 0 x--  2B9 0 x--  2A8 0 x--  2B8 0 x-- }
69EA: 0025 { 2A7 0 x--  2B7 0 x--  2A6 0 x--  2B6 0 x-- }
69EB: 0025 { 2A5 0 x--  2B5 0 x--  2A4 0 x--  2B4 0 x-- }
69EC: 0025 { 2A3 0 x--  2B3 0 x--  2A2 0 x--  2B2 0 x-- }
69ED: 0025 { 2A1 0 x--  2B1 0 x--  2A0 0 x--  2B0 0 x-- }
69EE: 0025 { 0E0 3 ---  0F0 3 ---  0E1 3 ---  0F1 3 --- }
69EF: 0025 { 0D4 3 ---  0E4 3 ---  0D5 3 ---  0E5 3 --- }
69F0: 0025 { 2C0 0 ---  2D0 0 ---  2C1 0 ---  2D1 0 --- }
69F1: 0025 { 2C2 0 ---  2D2 0 ---  2C3 0 ---  2D3 0 --- }
69F2: 0025 { 2C4 0 ---  2D4 0 ---  2C5 0 ---  2D5 0 --- }
69F3: 0025 { 2C6 0 ---  2D6 0 ---  2C7 0 ---  2D7 0 --- }
69F4: 0025 { 2C8 0 ---  2D8 0 ---  2C9 0 ---  2D9 0 --- }
69F5: 0025 { 2CA 0 ---  2DA 0 ---  2CB 0 ---  2DB 0 --- }
69F6: 0025 { 2CC 0 ---  2DC 0 ---  2CD 0 ---  2DD 0 --- }
69F7: 0025 { 2CD 0 x--  2DD 0 x--  2CC 0 x--  2DC 0 x-- }
69F8: 0025 { 2CB 0 x--  2DB 0 x--  2CA 0 x--  2DA 0 x-- }
69F9: 0025 { 2C9 0 x--  2D9 0 x--  2C8 0 x--  2D8 0 x-- }
69FA: 0025 { 2C7 0 x--  2D7 0 x--  2C6 0 x--  2D6 0 x-- }
69FB: 0025 { 2C5 0 x--  2D5 0 x--  2C4 0 x--  2D4 0 x-- }
69FC: 0025 { 2C3 0 x--  2D3 0 x--  2C2 0 x--  2D2 0 x-- }
69FD: 0025 { 2C1 0 x--  2D1 0 x--  2C0 0 x--  2D0 0 x-- }
69FE: 0025 { 0B2 3 ---  0C2 3 ---  0B3 3 ---  0C3 3 --- }
69FF: 0025 { 0C8 3 ---  0D8 3 ---  0C9 3 ---  0D9 3 --- }
