6E00: 0025 { 0F8 3 ---  0F8 3 ---  1D0 3 ---  0F8 3 --- }
6E01: 0025 { 1E0 3 ---  0F8 3 ---  1F0 3 ---  0F8 3 --- }
6E02: 0025 { 0F8 3 ---  0F8 3 ---  1E1 3 ---  1F1 3 --- }
6E03: 0025 { 1E2 3 ---  1F2 3 ---  1E3 3 ---  1F3 3 --- }
6E04: ~
6E05: ~
6E06: 0130 { 0F8 1 ---  11C 1 ---  0F8 1 ---  11D 1 --- }
6E07: ~
6E08: 0025 { 0F8 1 ---  0F8 1 ---  0F8 1 ---  280 1 --- }
6E09: 0025 { 0F8 1 ---  281 1 ---  0F8 1 ---  282 1 --- }
6E0A: 0025 { 0F8 1 ---  283 1 ---  0F8 1 ---  284 1 --- }
6E0B: ~
6E0C: ~
6E0D: ~
6E0E: ~
6E0F: ~
6E10: 0025 { 0F8 1 ---  130 1 ---  0F8 1 ---  131 1 --- }
6E11: 0025 { 0F8 1 ---  132 1 ---  0F8 1 ---  133 1 --- }
6E12: 0025 { 0F8 1 ---  134 1 ---  0F8 1 ---  0F8 1 --- }
6E13: 0025 { 0F8 1 ---  136 1 ---  0F8 1 ---  137 1 --- }
6E14: 0025 { 0F8 1 ---  138 1 ---  0F8 1 ---  139 1 --- }
6E15: 0025 { 12A 1 ---  13A 1 ---  12B 1 ---  13B 1 --- }
6E16: 0025 { 12C 1 ---  13C 1 ---  12D 1 ---  13D 1 --- }
6E17: 0025 { 12E 1 ---  13E 1 ---  0F8 1 ---  13F 1 --- }
6E18: 0025 { 0F8 1 ---  0F8 1 ---  290 1 ---  0F8 1 --- }
6E19: 0025 { 291 1 ---  0F8 1 ---  292 1 ---  2A2 1 --- }
6E1A: 0025 { 293 1 ---  2A3 1 ---  294 1 ---  2A4 1 --- }
6E1B: 0025 { 295 1 ---  2A5 1 ---  296 1 ---  2A6 1 --- }
6E1C: 0025 { 297 1 ---  2A7 1 ---  298 1 ---  2A8 1 --- }
6E1D: ~
6E1E: ~
6E1F: ~
6E20: 0025 { 140 1 ---  150 1 ---  141 1 ---  151 1 --- }
6E21: 0025 { 142 1 ---  152 1 ---  143 1 ---  153 1 --- }
6E22: 0025 { 144 1 ---  154 1 ---  145 1 ---  155 1 --- }
6E23: 0025 { 146 1 ---  156 1 ---  147 1 ---  157 1 --- }
6E24: 0025 { 148 1 ---  158 1 ---  149 1 ---  159 1 --- }
6E25: 0025 { 14A 1 ---  15A 1 ---  14B 1 ---  15B 1 --- }
6E26: 0025 { 14C 1 ---  15C 1 ---  14D 1 ---  15D 1 --- }
6E27: 0025 { 14E 1 ---  15E 1 ---  14F 1 ---  15F 1 --- }
6E28: 0025 { 007 4 ---  2B6 4 ---  2AD 4 ---  2B7 4 --- }
6E29: 0025 { 0F8 1 ---  185 4 ---  25B 4 ---  18E 4 --- }
6E2A: 0025 { 25C 4 ---  18F 4 ---  0F8 1 ---  009 4 --- }
6E2B: 0025 { 007 4 ---  017 4 ---  008 4 ---  018 4 --- }
6E2C: 0025 { 021 4 ---  031 4 ---  022 4 ---  032 4 --- }
6E2D: 0025 { 023 4 ---  033 4 ---  024 4 ---  034 4 --- }
6E2E: 0025 { 025 4 ---  035 4 ---  026 4 ---  036 4 --- }
6E2F: 0025 { 007 4 ---  20F 4 ---  007 4 ---  254 4 --- }
6E30: 0025 { 160 1 ---  170 1 ---  161 1 ---  171 1 --- }
6E31: 0025 { 162 1 ---  172 1 ---  163 1 ---  173 1 --- }
6E32: 0025 { 164 1 ---  164 1 ---  164 1 ---  164 1 --- }
6E33: 0025 { 164 1 ---  164 1 ---  164 1 ---  177 1 --- }
6E34: 0025 { 168 1 ---  178 1 ---  169 1 ---  179 1 --- }
6E35: 0025 { 16A 1 ---  17A 1 ---  16B 1 ---  17B 1 --- }
6E36: 0025 { 16C 1 ---  17C 1 ---  16D 1 ---  17D 1 --- }
6E37: 0025 { 16E 1 ---  17E 1 ---  16F 1 ---  17F 1 --- }
6E38: 0025 { 19E 4 ---  007 4 ---  19F 4 ---  1BE 4 --- }
6E39: 0025 { 1AE 4 ---  1BF 4 ---  1AF 4 ---  1DE 4 --- }
6E3A: 0025 { 1CF 4 ---  1DF 4 ---  1EE 4 ---  1FE 4 --- }
6E3B: 0025 { 1EF 4 ---  1FF 4 ---  000 4 ---  010 4 --- }
6E3C: 0025 { 001 4 ---  011 4 ---  002 4 ---  012 4 --- }
6E3D: 0025 { 003 4 ---  013 4 ---  004 4 ---  014 4 --- }
6E3E: 0025 { 005 4 ---  015 4 ---  006 4 ---  016 4 --- }
6E3F: 0025 { 259 4 ---  007 4 ---  25A 4 ---  007 4 --- }
6E40: 0025 { 100 1 ---  10D 1 ---  101 1 ---  10E 1 --- }
6E41: 0025 { 102 1 ---  10E 1 ---  103 1 ---  10E 1 --- }
6E42: 0025 { 103 1 ---  10E 1 ---  103 1 ---  10E 1 --- }
6E43: 0025 { 104 1 ---  10E 1 ---  105 1 ---  10E 1 --- }
6E44: 0025 { 106 1 ---  10E 1 ---  107 1 ---  10E 1 --- }
6E45: 0025 { 103 1 ---  10E 1 ---  108 1 ---  10E 1 --- }
6E46: 0025 { 109 1 ---  10E 1 ---  10A 1 ---  10E 1 --- }
6E47: 0025 { 10B 1 ---  10E 1 ---  10C 1 ---  10F 1 --- }
6E48: 0025 { 200 4 ---  210 4 ---  201 4 ---  211 4 --- }
6E49: 0025 { 202 4 ---  212 4 ---  203 4 ---  213 4 --- }
6E4A: 0025 { 204 4 ---  214 4 ---  205 4 ---  215 4 --- }
6E4B: 0025 { 206 4 ---  216 4 ---  207 4 ---  217 4 --- }
6E4C: 0025 { 208 4 ---  218 4 ---  209 4 ---  219 4 --- }
6E4D: 0025 { 20A 4 ---  21A 4 ---  20B 4 ---  21B 4 --- }
6E4E: 0025 { 20C 4 ---  21C 4 ---  20D 4 ---  21D 4 --- }
6E4F: 0025 { 20E 4 ---  21E 4 ---  200 4 x--  21F 4 --- }
6E50: 0025 { 110 1 ---  120 1 ---  111 1 ---  121 1 --- }
6E51: 0025 { 28E 6 ---  29E 6 ---  28F 6 ---  29F 6 --- }
6E52: ~
6E53: 0025 { 111 1 x--  121 1 x--  110 1 x--  120 1 x-- }
6E54: 0025 { 112 1 ---  122 1 ---  113 1 ---  123 1 --- }
6E55: 0025 { 114 1 ---  124 1 ---  115 1 ---  125 1 --- }
6E56: 0025 { 116 1 ---  126 1 ---  117 1 ---  127 1 --- }
6E57: 0025 { 110 1 ---  120 1 ---  111 1 ---  121 1 --- }
6E58: 0025 { 220 4 ---  230 4 ---  221 4 ---  231 4 --- }
6E59: 0025 { 222 4 ---  232 4 ---  223 4 ---  233 4 --- }
6E5A: 0025 { 224 4 ---  234 4 ---  225 4 ---  235 4 --- }
6E5B: 0025 { 226 4 ---  236 4 ---  227 4 ---  237 4 --- }
6E5C: 0025 { 228 4 ---  238 4 ---  229 4 ---  239 4 --- }
6E5D: 0025 { 22A 4 ---  23A 4 ---  22B 4 ---  23B 4 --- }
6E5E: 0025 { 22C 4 ---  23C 4 ---  22D 4 ---  23D 4 --- }
6E5F: 0025 { 22E 4 ---  23E 4 ---  22F 4 ---  23F 4 --- }
6E60: 0025 { 120 1 ---  120 1 ---  121 1 ---  121 1 --- }
6E61: 0025 { 29E 6 ---  2AE 6 ---  29F 6 ---  2AF 6 --- }
6E62: ~
6E63: 0025 { 121 1 x--  121 1 x--  120 1 x--  120 1 x-- }
6E64: 0025 { 118 1 ---  128 1 ---  119 1 ---  129 1 --- }
6E65: 0025 { 11A 1 ---  11B 1 ---  11E 1 ---  11F 1 --- }
6E66: 0025 { 12F 1 ---  165 1 ---  135 1 ---  166 1 --- }
6E67: 0025 { 120 1 ---  120 1 ---  121 1 ---  121 1 --- }
6E68: 0025 { 240 4 ---  250 4 ---  241 4 ---  251 4 --- }
6E69: 0025 { 242 4 ---  252 4 ---  243 4 ---  253 4 --- }
6E6A: 0025 { 244 4 ---  253 4 ---  245 4 ---  255 4 --- }
6E6B: 0025 { 246 4 ---  256 4 ---  247 4 ---  257 4 --- }
6E6C: 0025 { 248 4 ---  258 4 ---  249 4 ---  253 4 --- }
6E6D: 0025 { 24A 4 ---  253 4 ---  24B 4 ---  253 4 --- }
6E6E: 0025 { 24C 4 ---  253 4 ---  24D 4 ---  25D 4 --- }
6E6F: 0025 { 24E 4 ---  25E 4 ---  24F 4 ---  25F 4 --- }
6E70: 0025 { 120 1 ---  110 1 -y-  121 1 ---  111 1 -y- }
6E71: 0025 { 2BF 6 x--  2BF 6 x--  2BE 6 x--  2BE 6 x-- }
6E72: ~
6E73: 0025 { 121 1 x--  287 1 ---  167 1 ---  288 1 --- }
6E74: 0025 { 174 1 ---  289 1 ---  175 1 ---  28A 1 --- }
6E75: 0025 { 175 1 ---  28A 1 ---  175 1 ---  28A 1 --- }
6E76: 0025 { 175 1 ---  28A 1 ---  176 1 ---  28B 1 --- }
6E77: 0025 { 286 1 ---  28C 1 ---  121 1 ---  111 1 -y- }
6E78: 0025 { 260 4 ---  270 4 ---  261 4 ---  271 4 --- }
6E79: 0025 { 180 3 ---  190 3 ---  181 3 ---  191 3 --- }
6E7A: 0025 { 182 3 ---  192 3 ---  183 3 ---  193 3 --- }
6E7B: 0025 { 266 4 ---  276 4 ---  267 4 ---  277 4 --- }
6E7C: 0025 { 268 4 ---  278 4 ---  269 4 ---  279 4 --- }
6E7D: 0025 { 26A 4 ---  27A 4 ---  26B 4 ---  27B 4 --- }
6E7E: 0025 { 26C 4 ---  27C 4 ---  26D 4 ---  27D 4 --- }
6E7F: 0025 { 26E 4 ---  27E 4 ---  26F 4 ---  27F 4 --- }
6E80: ~
6E81: ~
6E82: 0025 { 0F8 1 ---  0F8 1 ---  0F8 1 ---  195 5 --- }
6E83: 0025 { 186 5 ---  196 5 ---  187 5 ---  197 5 --- }
6E84: 0025 { 187 5 x--  197 5 x--  186 5 x--  196 5 x-- }
6E85: 0025 { 0F8 1 ---  195 5 x--  0F8 1 ---  0F8 1 --- }
6E86: ~
6E87: ~
6E88: 0025 { 262 4 ---  272 4 ---  263 4 ---  273 4 --- }
6E89: 0025 { 1A0 3 ---  1B0 3 ---  1A1 3 ---  1B1 3 --- }
6E8A: 0025 { 1A2 3 ---  1B2 3 ---  1A3 3 ---  1B3 3 --- }
6E8B: 0025 { 2D9 4 ---  2E9 4 ---  2DA 4 ---  2EA 4 --- }
6E8C: 0025 { 2DB 4 ---  2EB 4 ---  2DC 4 ---  2EC 4 --- }
6E8D: 0025 { 2DD 4 ---  2ED 4 ---  2DE 4 ---  2EE 4 --- }
6E8E: 0025 { 2DF 4 ---  2EF 4 ---  2F0 4 ---  2F1 4 --- }
6E8F: 0025 { 2F2 4 ---  2F7 4 ---  2F6 4 ---  2F8 4 --- }
6E90: 0025 { 1A0 5 ---  1B0 5 ---  1A1 5 ---  1B1 5 --- }
6E91: ~
6E92: 0025 { 0F8 1 ---  0F8 1 ---  1A5 5 ---  1B5 5 --- }
6E93: 0025 { 1A6 5 ---  1B6 5 ---  1A7 5 ---  1B7 5 --- }
6E94: 0025 { 1A7 5 x--  1B7 5 x--  1A6 5 x--  1B6 5 x-- }
6E95: 0025 { 1A5 5 x--  1B5 5 x--  0F8 1 ---  0F8 1 --- }
6E96: ~
6E97: 0025 { 1A1 5 x--  1B1 5 x--  1A0 5 x--  1B0 5 x-- }
6E98: 0025 { 264 4 ---  274 4 ---  265 4 ---  275 4 --- }
6E99: 0025 { 1C0 3 ---  0F8 3 ---  1C1 3 ---  1D1 3 --- }
6E9A: 0025 { 1C2 3 ---  1D2 3 ---  1C3 3 ---  1D3 3 --- }
6E9B: 0025 { 2F9 4 ---  28D 4 ---  2FA 4 ---  299 4 --- }
6E9C: 0025 { 2FB 4 ---  29A 4 ---  2FC 4 ---  29B 4 --- }
6E9D: 0025 { 2FD 4 ---  29C 4 ---  2FE 4 ---  29D 4 --- }
6E9E: 0025 { 2FF 4 ---  2A9 4 ---  2CE 4 ---  2AA 4 --- }
6E9F: 0025 { 2CF 4 ---  2AB 4 ---  285 4 ---  2AC 4 --- }
6EA0: 0025 { 1C0 5 ---  1D0 5 ---  1C1 5 ---  1D1 5 --- }
6EA1: 0025 { 1C2 5 ---  1D2 5 ---  1C3 5 ---  1D3 5 --- }
6EA2: 0025 { 1C4 5 ---  1D4 5 ---  1C5 5 ---  1D5 5 --- }
6EA3: 0025 { 1C6 5 ---  1D6 5 ---  1C7 5 ---  1D7 5 --- }
6EA4: 0025 { 1C7 5 x--  1D7 5 x--  1C6 5 x--  1D6 5 x-- }
6EA5: 0025 { 1C5 5 x--  1D5 5 x--  1C4 5 x--  1D4 5 x-- }
6EA6: 0025 { 1C3 5 x--  1D3 5 x--  1C2 5 x--  1D2 5 x-- }
6EA7: 0025 { 1C1 5 x--  1D1 5 x--  1C0 5 x--  1D0 5 x-- }
6EA8: ~
6EA9: ~
6EAA: 0025 { 0F8 1 ---  2A0 5 ---  0F8 1 ---  2A1 5 --- }
6EAB: ~
6EAC: ~
6EAD: ~
6EAE: ~
6EAF: ~
6EB0: 0025 { 1E0 5 ---  1F0 5 ---  1E1 5 ---  1F1 5 --- }
6EB1: 0025 { 1E2 5 ---  1F2 5 ---  1E1 5 ---  1F3 5 --- }
6EB2: 0025 { 1E4 5 ---  1F4 5 ---  1E1 5 ---  1F1 5 --- }
6EB3: 0025 { 1E2 5 ---  1F2 5 ---  1E7 5 ---  1F3 5 --- }
6EB4: 0025 { 1E7 5 x--  1F3 5 x--  1E2 5 x--  1F2 5 x-- }
6EB5: 0025 { 1E1 5 x--  1F1 5 x--  1E4 5 x--  1F4 5 x-- }
6EB6: 0025 { 1E1 5 x--  1F3 5 x--  1E2 5 x--  1F2 5 x-- }
6EB7: 0025 { 1E1 5 x--  1F1 5 x--  1E0 5 x--  1F0 5 x-- }
6EB8: 0025 { 0F8 1 ---  0F8 1 ---  2B0 5 ---  2C0 5 --- }
6EB9: 0025 { 2B1 5 ---  2C1 5 ---  2B2 5 ---  2C2 5 --- }
6EBA: 0025 { 2B3 5 ---  2C3 5 ---  2B4 5 ---  2C4 5 --- }
6EBB: 0025 { 2B5 5 ---  2C5 5 ---  2B6 5 ---  2C6 5 --- }
6EBC: 0025 { 0F8 1 ---  2C7 5 ---  2B8 5 ---  2C8 5 --- }
6EBD: 0025 { 2B9 5 ---  2C9 5 ---  2BA 5 ---  2CA 5 --- }
6EBE: 0025 { 2BB 5 ---  2CB 5 ---  2BC 5 ---  2CC 5 --- }
6EBF: 0025 { 2BD 5 ---  2CD 5 ---  0F8 1 ---  0F8 1 --- }
6EC0: 0025 { 1E5 5 ---  1F5 5 ---  1F6 5 ---  1E6 5 --- }
6EC1: 0025 { 1F7 5 ---  1FA 5 ---  1F8 5 ---  1E3 5 --- }
6EC2: 0025 { 1F9 5 ---  1E3 5 x--  1F6 5 ---  1FA 5 --- }
6EC3: 0025 { 1F7 5 ---  1A4 5 ---  1F8 5 ---  1B4 5 --- }
6EC4: 0025 { 1F8 5 x--  1B4 5 x--  1F7 5 x--  1A4 5 x-- }
6EC5: 0025 { 1F6 5 x--  1FA 5 x--  1F9 5 x--  1E3 5 --- }
6EC6: 0025 { 1F8 5 x--  1E3 5 x--  1F7 5 x--  1FA 5 x-- }
6EC7: 0025 { 1F6 5 x--  1E6 5 x--  1E5 5 x--  1F5 5 x-- }
6EC8: 0025 { 0F8 1 ---  0F8 1 ---  2D0 4 ---  2E0 4 --- }
6EC9: 0025 { 2D1 4 ---  2E1 4 ---  2D2 4 ---  2E2 4 --- }
6ECA: 0025 { 2D3 4 ---  2E3 4 ---  2D4 4 ---  2E4 4 --- }
6ECB: 0025 { 2D5 4 ---  2E5 4 ---  2D6 4 ---  2E6 4 --- }
6ECC: 0025 { 2D7 4 ---  2E7 4 ---  2D8 4 ---  2E8 4 --- }
6ECD: 0025 { 0F8 1 ---  0A6 4 ---  0F8 1 ---  0A7 4 --- }
6ECE: 0025 { 0CA 5 ---  0A8 4 ---  0CB 5 ---  0A8 4 x-- }
6ECF: 0025 { 0F8 1 ---  0A7 4 x--  0F8 1 ---  0A6 4 x-- }
6ED0: 0025 { 181 5 x--  191 5 x--  180 5 x--  190 5 x-- }
6ED1: 0130 { 180 3 ---  194 3 ---  181 3 ---  195 3 --- }
6ED2: 0130 { 182 3 ---  196 3 ---  0F8 3 ---  197 3 --- }
6ED3: 0025 { 188 5 ---  198 5 ---  189 5 ---  199 5 --- }
6ED4: 0025 { 1A8 5 ---  1B8 5 ---  1A9 5 ---  1B9 5 --- }
6ED5: 0025 { 1AA 5 ---  1BA 5 ---  1AB 5 ---  1BB 5 --- }
6ED6: 0025 { 1AC 5 ---  1BC 5 ---  1AD 5 ---  1BD 5 --- }
6ED7: 0025 { 180 5 ---  190 5 ---  181 5 ---  191 5 --- }
6ED8: 0130 { 1E4 3 ---  1F4 3 ---  1E5 3 ---  1F5 3 --- }
6ED9: 0130 { 1E6 3 ---  1F6 3 ---  1E7 3 ---  1F7 3 --- }
6EDA: 0025 { 2F3 4 ---  0F8 1 ---  2F4 4 ---  0F8 1 --- }
6EDB: 0025 { 2F5 4 ---  0F8 1 ---  0F8 1 ---  0F8 1 --- }
6EDC: ~
6EDD: 0025 { 0B6 4 ---  0F8 1 ---  0B7 4 ---  0F8 1 --- }
6EDE: 0025 { 0B8 4 ---  0A9 5 ---  0B8 4 x--  0E6 5 --- }
6EDF: 0025 { 0B7 4 x--  0F8 1 ---  0B6 4 x--  0F8 1 --- }
6EE0: 0025 { 183 5 x--  193 5 x--  182 5 x--  192 5 x-- }
6EE1: 0130 { 1A4 3 ---  1B4 3 ---  1A5 3 ---  1B5 3 --- }
6EE2: 0130 { 1A6 3 ---  1B6 3 ---  1A7 3 ---  1B7 3 --- }
6EE3: 0025 { 18A 5 ---  19A 5 ---  18B 5 ---  19B 5 --- }
6EE4: 0025 { 1C8 5 ---  1D8 5 ---  1C9 5 ---  1D9 5 --- }
6EE5: 0025 { 1CA 5 ---  1DA 5 ---  1CB 5 ---  1DB 5 --- }
6EE6: 0025 { 1CC 5 ---  1DC 5 ---  1CD 5 ---  1DD 5 --- }
6EE7: 0025 { 182 5 ---  192 5 ---  183 5 ---  193 5 --- }
6EE8: 0025 { 0F8 3 ---  0F8 3 ---  183 3 ---  0F8 3 --- }
6EE9: 0025 { 184 3 ---  186 3 ---  185 3 ---  187 3 --- }
6EEA: 0025 { 004 4 ---  004 4 ---  004 4 ---  004 4 --- }
6EEB: 0025 { 004 4 ---  004 4 ---  004 4 ---  004 4 --- }
6EEC: 0025 { 004 4 ---  004 4 ---  004 4 ---  004 4 --- }
6EED: 0025 { 004 4 ---  004 4 ---  004 4 ---  004 4 --- }
6EEE: 0025 { 0B9 5 ---  0B9 5 ---  0F6 5 ---  0F6 5 --- }
6EEF: ~
6EF0: 0025 { 1A3 5 x--  1B3 5 x--  184 5 ---  194 5 --- }
6EF1: 0130 { 1C4 3 ---  1D4 3 ---  1C5 3 ---  1D5 3 --- }
6EF2: 0130 { 1C6 3 ---  1D6 3 ---  1C7 3 ---  1D7 3 --- }
6EF3: 0025 { 18C 5 ---  19C 5 ---  18D 5 ---  19D 5 --- }
6EF4: 0025 { 1E8 5 ---  1FD 5 x--  1E9 5 ---  1FC 5 x-- }
6EF5: 0025 { 1EA 5 ---  1FB 5 x--  1EB 5 ---  1FB 5 --- }
6EF6: 0025 { 1EC 5 ---  1FC 5 ---  1ED 5 ---  1FD 5 --- }
6EF7: 0025 { 1A2 5 ---  1B2 5 ---  1A3 5 ---  1B3 5 --- }
6EF8: 0025 { 220 5 ---  222 5 ---  221 5 ---  223 5 --- }
6EF9: 0025 { 230 5 ---  232 5 ---  231 5 ---  233 5 --- }
6EFA: 0025 { 240 5 ---  242 5 ---  241 5 ---  243 5 --- }
6EFB: 0025 { 250 5 ---  252 5 ---  251 5 ---  253 5 --- }
6EFC: 0025 { 260 5 ---  262 5 ---  261 5 ---  263 5 --- }
6EFD: 0025 { 270 5 ---  272 5 ---  271 5 ---  273 5 --- }
6EFE: 0025 { 0C6 5 ---  0D6 5 ---  0C7 5 ---  0D7 5 --- }
6EFF: ~
