4B00: 0130 { 209 2 ---  219 2 ---  181 2 ---  191 2 --- }
4B01: 0100 { 180 2 ---  190 2 ---  181 2 ---  191 2 --- }
4B02: 0130 { 180 2 ---  190 2 ---  20C 2 ---  21C 2 --- }
4B03: 0130 { 209 2 ---  219 2 ---  20C 2 ---  21C 2 --- }
4B04: 0130 { 1A0 2 ---  190 2 ---  1A1 2 ---  191 2 --- }
4B05: 0130 { 182 2 ---  192 2 ---  183 2 ---  193 2 --- }
4B06: 0130 { 1A0 2 ---  1D0 2 ---  1C2 2 ---  1D2 2 --- }
4B07: 0130 { 1C3 2 ---  1D3 2 ---  1A1 2 ---  1D1 2 --- }
4B08: 0100 { 180 2 ---  190 2 ---  181 2 ---  1B4 2 --- }
4B09: 0100 { 180 2 ---  1B5 2 ---  181 2 ---  191 2 --- }
4B0A: 0100 { 180 2 ---  18E 2 ---  181 2 ---  18F 2 --- }
4B0B: 0100 { 180 2 ---  1CF 2 ---  181 2 ---  191 2 --- }
4B0C: 0130 { 1A0 2 ---  188 2 ---  1E6 2 ---  1F6 2 --- }
4B0D: 0130 { 1E7 2 ---  1F7 2 ---  1A1 2 ---  191 2 --- }
4B0E: 0130 { 18B 2 ---  19B 2 ---  18C 2 ---  19C 2 --- }
4B0F: 0130 { 18D 2 ---  19D 2 ---  1A1 2 ---  191 2 --- }
4B10: 0130 { 229 2 ---  21A 2 ---  1A1 2 ---  191 2 --- }
4B11: 0130 { 1A0 2 ---  190 2 ---  1A1 2 ---  191 2 --- }
4B12: 0130 { 1A0 2 ---  190 2 ---  22C 2 ---  21B 2 --- }
4B13: 0130 { 229 2 ---  21A 2 ---  22C 2 ---  21B 2 --- }
4B14: 0130 { 1B0 2 ---  1C0 2 ---  1B1 2 ---  1C1 2 --- }
4B15: 0130 { 1A2 2 ---  1B2 2 ---  1A3 2 ---  1B3 2 --- }
4B16: 0130 { 189 2 ---  199 2 ---  18A 2 ---  19A 2 --- }
4B17: 0130 { 1A9 2 ---  1B9 2 ---  1AA 2 ---  1BA 2 --- }
4B18: 0100 { 1A0 2 ---  190 2 ---  1A1 2 ---  1B4 2 --- }
4B19: 0100 { 1A0 2 ---  1B5 2 ---  1A1 2 ---  191 2 --- }
4B1A: 0100 { 1A0 2 ---  18E 2 ---  1A1 2 ---  18F 2 --- }
4B1B: 0100 { 1A0 2 ---  1CF 2 ---  1A1 2 ---  191 2 --- }
4B1C: 0130 { 198 2 ---  190 2 ---  1E8 2 ---  191 2 --- }
4B1D: 0130 { 1F8 2 ---  190 2 ---  1A1 2 ---  191 2 --- }
4B1E: 0130 { 1AB 2 ---  190 2 ---  1AC 2 ---  191 2 --- }
4B1F: 0130 { 1AD 2 ---  190 2 ---  1A1 2 ---  191 2 --- }
4B20: 0130 { 229 2 ---  2B0 2 ---  1A1 2 ---  235 2 --- }
4B21: 0130 { 1A0 2 ---  234 2 ---  1A1 2 ---  235 2 --- }
4B22: 0130 { 1A0 2 ---  234 2 ---  22C 2 ---  2B1 2 --- }
4B23: 0130 { 229 2 ---  2B0 2 ---  22C 2 ---  2B1 2 --- }
4B24: 0130 { 1A6 2 ---  1B6 2 ---  1A7 2 ---  1B7 2 --- }
4B25: 0130 { 1A8 2 ---  1B8 2 ---  1A1 2 ---  191 2 --- }
4B26: 0130 { 1A0 2 ---  1E0 2 ---  1A1 2 ---  1E1 2 --- }
4B27: 0130 { 1E2 2 ---  1F2 2 ---  1E3 2 ---  1F3 2 --- }
4B28: 0130 { 1F4 2 ---  186 2 ---  1C4 2 ---  1D4 2 --- }
4B29: 0130 { 1C5 2 ---  1D5 2 ---  1F5 2 ---  187 2 --- }
4B2A: 0130 { 19E 2 ---  1AE 2 ---  19F 2 ---  1AF 2 --- }
4B2B: 0130 { 1DF 2 ---  1EF 2 ---  1A1 2 ---  191 2 --- }
4B2C: 0196 { 0F8 2 ---  1F9 2 ---  0F8 2 ---  1FA 2 --- }
4B2D: 019B { 1CB 2 ---  1BC 2 ---  1CC 2 ---  191 2 --- }
4B2E: 01AA { 0F8 2 ---  213 2 ---  204 2 ---  214 2 --- }
4B2F: 0100 { 1C9 2 ---  1D9 2 ---  1CA 2 ---  1DA 2 --- }
4B30: 0130 { 209 2 ---  2B0 2 ---  181 2 ---  235 2 --- }
4B31: 0100 { 180 2 ---  234 2 ---  181 2 ---  235 2 --- }
4B32: 0130 { 180 2 ---  234 2 ---  20C 2 ---  2B1 2 --- }
4B33: 0130 { 2A9 2 ---  219 2 ---  20C 2 ---  21C 2 --- }
4B34: 0130 { 1C6 2 ---  1D6 2 ---  1C7 2 ---  1D7 2 --- }
4B35: 0130 { 1C8 2 ---  1D8 2 ---  1A1 2 ---  191 2 --- }
4B36: 0130 { 1F0 2 ---  190 2 ---  1F1 2 ---  191 2 --- }
4B37: 0130 { 194 2 ---  1A4 2 ---  195 2 ---  1A5 2 --- }
4B38: 0130 { 196 2 ---  190 2 ---  1E4 2 ---  191 2 --- }
4B39: 0130 { 1E5 2 ---  190 2 ---  197 2 ---  191 2 --- }
4B3A: 0130 { 1BE 2 ---  190 2 ---  1BF 2 ---  191 2 --- }
4B3B: 0130 { 1FF 2 ---  190 2 ---  1A1 2 ---  191 2 --- }
4B3C: 01DE { 1BB 2 ---  190 2 ---  1A1 2 ---  191 2 --- }
4B3D: 0130 { 1A0 2 ---  190 2 ---  1A1 2 ---  191 2 --- }
4B3E: 01E2 { 203 2 ---  190 2 ---  1A1 2 ---  191 2 --- }
4B3F: 0100 { 2B8 2 ---  1D9 2 ---  2B9 2 ---  1DA 2 --- }
4B40: 0130 { 2A9 2 ---  219 2 ---  181 2 ---  191 2 --- }
4B41: 0130 { 180 2 ---  190 2 ---  2AA 2 ---  21C 2 --- }
4B42: 0130 { 209 2 ---  219 2 ---  2AA 2 ---  21C 2 --- }
4B43: 0130 { 229 2 ---  2A0 2 ---  22C 2 ---  2B1 2 --- }
4B44: 0130 { 1BD 2 ---  1CD 2 ---  1CE 2 ---  1DE 2 --- }
4B45: 0130 { 1EE 2 ---  1FE 2 ---  1A1 2 ---  191 2 --- }
4B46: 0130 { 2BA 2 ---  1DB 2 ---  2BB 2 ---  1DC 2 --- }
4B47: 0130 { 1A0 2 ---  1DD 2 ---  1A1 2 ---  191 2 --- }
4B48: 0130 { 1A0 2 ---  200 2 ---  1A1 2 ---  201 2 --- }
4B49: 0130 { 1A0 2 ---  190 2 ---  1A1 2 ---  191 2 --- }
4B4A: 0130 { 28A 2 ---  29A 2 ---  28B 2 ---  29B 2 --- }
4B4B: 0130 { 1A0 2 ---  29C 2 ---  1A1 2 ---  191 2 --- }
4B4C: 01A0 { 205 2 ---  190 2 ---  206 2 ---  216 2 --- }
4B4D: 01A5 { 0F8 2 ---  223 2 ---  0F8 2 ---  224 2 --- }
4B4E: 01E2 { 229 2 ---  21A 2 ---  1A1 2 ---  191 2 --- }
4B4F: 0130 { 1E9 2 ---  190 2 ---  1EA 2 ---  191 2 --- }
4B50: 0130 { 229 2 ---  2A0 2 ---  1A1 2 ---  235 2 --- }
4B51: 0130 { 1A0 2 ---  234 2 ---  22C 2 ---  2A1 2 --- }
4B52: 0130 { 229 2 ---  2B0 2 ---  22C 2 ---  2A1 2 --- }
4B53: 0106 { 225 2 ---  0F8 2 ---  226 2 ---  0F8 2 --- }
4B54: 0025 { 277 2 ---  24B 2 ---  278 2 ---  24C 2 --- }
4B55: 0025 { 227 2 ---  24B 2 ---  23D 2 ---  24C 2 --- }
4B56: 0130 { 1EB 2 ---  1FB 2 ---  1EC 2 ---  1FC 2 --- }
4B57: 0130 { 1ED 2 ---  1FD 2 ---  1A1 2 ---  191 2 --- }
4B58: 0130 { 210 2 ---  220 2 ---  211 2 ---  221 2 --- }
4B59: 0130 { 212 2 ---  222 2 ---  1A1 2 ---  191 2 --- }
4B5A: 0130 { 1A0 2 ---  190 2 ---  2AB 2 ---  191 2 --- }
4B5B: 0130 { 2AC 2 ---  190 2 ---  1A1 2 ---  191 2 --- }
4B5C: 0130 { 1A0 2 ---  190 2 ---  1A1 2 ---  191 2 --- }
4B5D: 01E0 { 1A0 2 ---  190 2 ---  215 2 ---  191 2 --- }
4B5E: 0025 { 227 2 ---  28E 2 ---  228 2 ---  28F 2 --- }
4B5F: 01AF { 207 2 ---  217 2 ---  0F8 2 ---  218 2 --- }
4B60: 0130 { 2A9 2 ---  2B0 2 ---  181 2 ---  235 2 --- }
4B61: 0130 { 180 2 ---  234 2 ---  2AA 2 ---  2B1 2 --- }
4B62: 0130 { 2A9 2 ---  219 2 ---  2AA 2 ---  21C 2 --- }
4B63: 0106 { 2A4 2 ---  26C 2 ---  2A5 2 ---  2AF 2 --- }
4B64: 0025 { 23E 2 ---  24D 2 ---  23F 2 ---  0F8 2 --- }
4B65: 0130 { 1A0 2 ---  190 2 ---  1A1 2 ---  2B4 2 --- }
4B66: 0130 { 1A0 2 ---  2B5 2 ---  1A1 2 ---  191 2 --- }
4B67: 0196 { 227 2 ---  20D 2 ---  228 2 ---  20E 2 --- }
4B68: 019B { 27E 2 ---  1BC 2 ---  27F 2 ---  191 2 --- }
4B69: 01A0 { 265 2 ---  190 2 ---  266 2 ---  216 2 --- }
4B6A: 01A5 { 227 2 ---  275 2 ---  228 2 ---  276 2 --- }
4B6B: 01AA { 227 2 ---  299 2 ---  289 2 ---  214 2 --- }
4B6C: 01AF { 290 2 ---  217 2 ---  228 2 ---  291 2 --- }
4B6D: 0025 { 29D 2 ---  2AD 2 ---  228 2 ---  241 2 --- }
4B6E: 0025 { 29E 2 ---  240 2 ---  29F 2 ---  241 2 --- }
4B6F: 01E4 { 1A0 2 ---  190 2 ---  202 2 ---  191 2 --- }
4B70: 0130 { 209 2 ---  2A0 2 ---  181 2 ---  235 2 --- }
4B71: 0130 { 180 2 ---  234 2 ---  20C 2 ---  2A1 2 --- }
4B72: 0130 { 229 2 ---  2A0 2 ---  22C 2 ---  2A1 2 --- }
4B73: 0106 { 2A2 2 ---  2B2 2 ---  2A3 2 ---  2B3 2 --- }
4B74: 0025 { 268 2 ---  24D 2 ---  269 2 ---  0F8 2 --- }
4B75: 0130 { 1A0 2 ---  190 2 ---  22B 2 ---  191 2 --- }
4B76: 0130 { 22A 2 ---  190 2 ---  1A1 2 ---  191 2 --- }
4B77: 01DE { 1BB 2 ---  190 2 ---  1A1 2 ---  191 2 --- }
4B78: 0130 { 1A0 2 ---  190 2 ---  1A1 2 ---  191 2 --- }
4B79: 0130 { 1A0 2 ---  190 2 ---  1A1 2 ---  191 2 --- }
4B7A: 01E0 { 1A0 2 ---  190 2 ---  215 2 ---  191 2 --- }
4B7B: 01E2 { 203 2 ---  190 2 ---  1A1 2 ---  191 2 --- }
4B7C: 01E4 { 1A0 2 ---  190 2 ---  202 2 ---  191 2 --- }
4B7D: 0130 { 2A9 2 ---  2A0 2 ---  2AA 2 ---  2A1 2 --- }
4B7E: 0130 { 209 2 ---  2B0 2 ---  20C 2 ---  2B1 2 --- }
4B7F: 01E4 { 1A0 2 ---  190 2 ---  22C 2 ---  21B 2 --- }
4B80: 0130 { 2A9 2 ---  2A0 2 ---  181 2 ---  235 2 --- }
4B81: 0130 { 180 2 ---  234 2 ---  2AA 2 ---  2A1 2 --- }
4B82: 0025 { 26B 2 ---  20F 2 ---  233 2 ---  22E 2 --- }
4B83: 0025 { 263 2 ---  240 2 ---  264 2 ---  274 2 --- }
4B84: 01EE { 1A0 2 ---  253 2 ---  1A1 2 ---  191 2 --- }
4B85: 0130 { 1A0 2 ---  190 2 ---  1A1 2 ---  191 2 --- }
4B86: 0130 { 1A0 2 ---  190 2 ---  1A1 2 ---  191 2 --- }
4B87: 01EF { 1A0 2 ---  190 2 ---  1A1 2 ---  247 2 --- }
4B88: 01EC { 1A0 2 ---  253 2 ---  1A1 2 ---  191 2 --- }
4B89: 01ED { 1A0 2 ---  190 2 ---  1A1 2 ---  248 2 --- }
4B8A: 01EE { 1A0 2 ---  253 2 ---  1A1 2 ---  191 2 --- }
4B8B: 0130 { 1A0 2 ---  190 2 ---  1A1 2 ---  191 2 --- }
4B8C: 0130 { 1A0 2 ---  190 2 ---  1A1 2 ---  191 2 --- }
4B8D: 01EF { 1A0 2 ---  190 2 ---  1A1 2 ---  247 2 --- }
4B8E: 01EC { 1A0 2 ---  253 2 ---  1A1 2 ---  191 2 --- }
4B8F: 01ED { 1A0 2 ---  190 2 ---  1A1 2 ---  248 2 --- }
4B90: 0025 { 232 2 ---  0F8 2 ---  233 2 ---  243 2 --- }
4B91: 0025 { 23B 2 ---  22F 2 ---  23C 2 ---  241 2 --- }
4B92: 0025 { 23B 2 ---  240 2 ---  23C 2 ---  241 2 --- }
4B93: 0025 { 26D 2 ---  272 2 ---  0F8 2 ---  273 2 --- }
4B94: 01C6 { 287 2 ---  240 2 ---  288 2 ---  25B 2 --- }
4B95: 01C7 { 250 2 ---  285 2 ---  1A1 2 ---  286 2 --- }
4B96: 01C8 { 1A0 2 ---  244 2 ---  236 2 ---  245 2 --- }
4B97: 01C9 { 237 2 ---  246 2 ---  238 2 ---  241 2 --- }
4B98: 01C4 { 294 2 ---  295 2 ---  255 2 ---  296 2 --- }
4B99: 01C5 { 239 2 ---  249 2 ---  23A 2 ---  24A 2 --- }
4B9A: 01C6 { 251 2 ---  0F8 2 ---  252 2 ---  0F8 2 --- }
4B9B: 01C7 { 250 2 ---  24E 2 ---  1A1 2 ---  24F 2 --- }
4B9C: 01C8 { 1A0 2 ---  27C 2 ---  236 2 ---  27D 2 --- }
4B9D: 01C9 { 280 2 ---  0F8 2 ---  281 2 ---  0F8 2 --- }
4B9E: 01C4 { 254 2 ---  0F8 2 ---  255 2 ---  256 2 --- }
4B9F: 01C5 { 239 2 ---  28C 2 ---  28D 2 ---  0F8 2 --- }
4BA0: 0025 { 0F8 2 ---  20A 2 ---  21F 2 ---  20B 2 --- }
4BA1: 0025 { 231 2 ---  240 2 ---  228 2 ---  241 2 --- }
4BA2: 0025 { 25E 2 ---  26E 2 ---  25F 2 ---  241 2 --- }
4BA3: 0025 { 262 2 ---  272 2 ---  0F8 2 ---  273 2 --- }
4BA4: 0025 { 257 2 ---  0F8 2 ---  258 2 ---  208 2 --- }
4BA5: 0025 { 227 2 ---  240 2 ---  284 2 ---  241 2 --- }
4BA6: 0025 { 242 2 ---  240 2 ---  228 2 ---  241 2 --- }
4BA7: 0025 { 293 2 ---  270 2 ---  0F8 2 ---  271 2 --- }
4BA8: 0025 { 227 2 ---  240 2 ---  297 2 ---  241 2 --- }
4BA9: 0025 { 230 2 ---  240 2 ---  228 2 ---  241 2 --- }
4BAA: 0025 { 2A6 2 ---  2B6 2 ---  2A7 2 ---  2B7 2 --- }
4BAB: 0025 { 2BE 2 ---  2BC 2 ---  2BF 2 ---  2BD 2 --- }
4BAC: 0025 { 227 2 ---  240 2 ---  228 2 ---  267 2 --- }
4BAD: 0025 { 21D 2 ---  0F8 2 ---  21E 2 ---  208 2 --- }
4BAE: 0025 { 0F8 2 ---  279 2 ---  26A 2 ---  27A 2 --- }
4BAF: 0025 { 23B 2 ---  240 2 ---  23C 2 ---  267 2 --- }
4BB0: 0025 { 22D 2 ---  20F 2 ---  228 2 ---  22E 2 --- }
4BB1: 0025 { 227 2 ---  22F 2 ---  228 2 ---  241 2 --- }
4BB2: 0025 { 25E 2 ---  26E 2 ---  27B 2 ---  241 2 --- }
4BB3: 0025 { 260 2 ---  270 2 ---  0F8 2 ---  271 2 --- }
4BB4: 0025 { 232 2 ---  0F8 2 ---  233 2 ---  243 2 --- }
4BB5: 0025 { 0F8 2 ---  20A 2 ---  2AE 2 ---  20B 2 --- }
4BB6: 0025 { 227 2 ---  240 2 ---  228 2 ---  241 2 --- }
4BB7: 0025 { 227 2 ---  240 2 ---  261 2 ---  241 2 --- }
4BB8: 01E2 { 203 2 ---  234 2 ---  1A1 2 ---  235 2 --- }
4BB9: 01E4 { 1A0 2 ---  234 2 ---  202 2 ---  235 2 --- }
4BBA: 01DE { 1BB 2 ---  234 2 ---  1A1 2 ---  235 2 --- }
4BBB: 01E0 { 1A0 2 ---  234 2 ---  215 2 ---  235 2 --- }
4BBC: 0020 { 227 2 ---  282 2 ---  228 2 ---  283 2 --- }
4BBD: 001F { 292 2 ---  292 2 ---  292 2 ---  292 2 --- }
4BBE: 0025 { 2A6 2 ---  2B6 2 ---  2A7 2 ---  2A8 2 --- }
4BBF: 001F { 2A8 2 ---  292 2 ---  2A8 2 x--  292 2 --- }
4BC0: 0130 { 229 2 ---  21A 2 ---  1A1 2 ---  2B4 2 --- }
4BC1: 0025 { 0F8 4 ---  0F8 4 ---  0F8 4 ---  0F8 4 --- }
4BC2: 014B { 004 4 ---  004 4 ---  004 4 ---  004 4 --- }
4BC3: 014C { 004 4 ---  004 4 ---  004 4 ---  004 4 --- }
4BC4: 014B { 004 4 ---  004 4 ---  004 4 ---  004 4 --- }
4BC5: ~
4BC6: 014C { 004 4 ---  004 4 ---  004 4 ---  004 4 --- }
4BC7: 014D { 004 4 ---  004 4 ---  004 4 ---  004 4 --- }
4BC8: 014F { 004 4 ---  004 4 ---  004 4 ---  004 4 --- }
4BC9: 01AA { 004 4 ---  004 4 ---  004 4 ---  004 4 --- }
4BCA: 0196 { 004 4 ---  004 4 ---  004 4 ---  004 4 --- }
4BCB: 019B { 004 4 ---  004 4 ---  004 4 ---  004 4 --- }
4BCC: 01DE { 004 4 ---  004 4 ---  004 4 ---  004 4 --- }
4BCD: 01E0 { 004 4 ---  004 4 ---  004 4 ---  004 4 --- }
4BCE: 01A0 { 004 4 ---  004 4 ---  004 4 ---  004 4 --- }
4BCF: 01A5 { 004 4 ---  004 4 ---  004 4 ---  004 4 --- }
4BD0: ~
4BD1: ~
4BD2: ~
4BD3: ~
4BD4: 014D { 004 4 ---  004 4 ---  004 4 ---  004 4 --- }
4BD5: 014E { 004 4 ---  004 4 ---  004 4 ---  004 4 --- }
4BD6: 014F { 004 4 ---  004 4 ---  004 4 ---  004 4 --- }
4BD7: 01AA { 004 4 ---  004 4 ---  004 4 ---  004 4 --- }
4BD8: 01AF { 004 4 ---  004 4 ---  004 4 ---  004 4 --- }
4BD9: 01AF { 004 4 ---  004 4 ---  004 4 ---  004 4 --- }
4BDA: ~
4BDB: ~
4BDC: ~
4BDD: 0145 { 004 4 ---  004 4 ---  004 4 ---  004 4 --- }
4BDE: 0148 { 004 4 ---  004 4 ---  004 4 ---  004 4 --- }
4BDF: 0100 { 004 4 ---  004 4 ---  004 4 ---  004 4 --- }
4BE0: ~
4BE1: ~
4BE2: ~
4BE3: ~
4BE4: 014E { 004 4 ---  004 4 ---  004 4 ---  004 4 --- }
4BE5: 0145 { 004 4 ---  004 4 ---  004 4 ---  004 4 --- }
4BE6: 0148 { 004 4 ---  004 4 ---  004 4 ---  004 4 --- }
4BE7: 01E2 { 004 4 ---  004 4 ---  004 4 ---  004 4 --- }
4BE8: 01E4 { 004 4 ---  004 4 ---  004 4 ---  004 4 --- }
4BE9: ~
4BEA: ~
4BEB: ~
4BEC: ~
4BED: 014D { 004 4 ---  004 4 ---  004 4 ---  004 4 --- }
4BEE: 014F { 004 4 ---  004 4 ---  004 4 ---  004 4 --- }
4BEF: 014E { 004 4 ---  004 4 ---  004 4 ---  004 4 --- }
4BF0: 004D { 004 4 ---  004 4 ---  004 4 ---  004 4 --- }
4BF1: 004D { 004 4 ---  004 4 ---  004 4 ---  004 4 --- }
4BF2: 004D { 004 4 ---  004 4 ---  004 4 ---  004 4 --- }
4BF3: 0100 { 004 4 ---  004 4 ---  004 4 ---  004 4 --- }
4BF4: 014E { 004 4 ---  004 4 ---  004 4 ---  004 4 --- }
4BF5: 014D { 004 4 ---  004 4 ---  004 4 ---  004 4 --- }
4BF6: 014F { 004 4 ---  004 4 ---  004 4 ---  004 4 --- }
4BF7: ~
4BF8: ~
4BF9: ~
4BFA: ~
4BFB: ~
4BFC: ~
4BFD: ~
4BFE: ~
4BFF: ~
