7000: 0130 { 200 3 ---  210 3 ---  201 3 ---  211 3 --- }
7001: 0130 { 0A6 3 ---  0B6 3 ---  0A7 3 ---  0B7 3 --- }
7002: 0130 { 244 3 ---  230 3 ---  221 3 ---  231 3 --- }
7003: 0130 { 222 3 ---  232 3 ---  245 3 ---  233 3 --- }
7004: 0130 { 240 3 ---  250 3 ---  241 3 ---  251 3 --- }
7005: 0130 { 242 3 ---  252 3 ---  243 3 ---  253 3 --- }
7006: 0130 { 22C 2 ---  23C 2 ---  22D 2 ---  23D 2 --- }
7007: 0130 { 22D 2 x--  23D 2 x--  22C 2 x--  23C 2 x-- }
7008: 0130 { 0CA 2 ---  194 2 ---  193 2 ---  195 2 --- }
7009: 0130 { 0CB 2 ---  194 2 ---  193 2 ---  195 2 --- }
700A: 0130 { 0CC 2 ---  194 2 ---  193 2 ---  195 2 --- }
700B: 0130 { 0CA 2 ---  194 2 ---  193 2 ---  0CB 2 --- }
700C: 0130 { 192 2 ---  0CB 2 x--  0CA 2 x--  195 2 --- }
700D: 0130 { 0CA 2 -y-  0CB 2 xy-  193 2 ---  195 2 --- }
700E: 0130 { 192 2 ---  194 2 ---  193 2 ---  0CA 2 --- }
700F: 0130 { 192 2 ---  194 2 ---  193 2 ---  195 2 --- }
7010: 0130 { 220 3 ---  230 3 ---  221 3 ---  231 3 --- }
7011: 0130 { 222 3 ---  232 3 ---  223 3 ---  233 3 --- }
7012: 0130 { 188 2 ---  0F8 5 x--  188 2 x--  0F8 5 x-- }
7013: 0130 { 264 3 ---  274 3 ---  265 3 ---  275 3 --- }
7014: 0130 { 260 3 ---  270 3 ---  261 3 ---  271 3 --- }
7015: 0130 { 262 3 ---  272 3 ---  263 3 ---  273 3 --- }
7016: 0130 { 24C 2 ---  25C 2 ---  24D 2 ---  25D 2 --- }
7017: 0130 { 24D 2 x--  25D 2 x--  24C 2 x--  25C 2 x-- }
7018: 0130 { 192 2 ---  194 2 ---  0CA 2 x--  195 2 --- }
7019: 0130 { 192 2 ---  194 2 ---  0CB 2 x--  195 2 --- }
701A: 0130 { 193 2 ---  194 2 ---  0CC 2 x--  195 2 --- }
701B: 0130 { 0CB 2 xy-  194 2 ---  193 2 ---  0CC 2 xy- }
701C: 0130 { 192 2 ---  194 2 ---  0CA 2 x--  0CB 2 --- }
701D: 0130 { 192 2 ---  194 2 ---  193 2 ---  0CC 2 --- }
701E: 0130 { 192 2 ---  194 2 ---  193 2 ---  0CB 2 --- }
701F: 0130 { 266 5 ---  276 5 ---  267 5 ---  277 5 --- }
7020: 0130 { 0F8 5 ---  0F8 5 ---  0F8 5 ---  0E0 5 --- }
7021: 0130 { 0F8 5 ---  0F8 5 ---  0F8 5 ---  094 5 --- }
7022: 0130 { 0F8 5 x--  0E0 5 x--  0F8 5 x--  0F8 5 x-- }
7023: 0130 { 0F8 5 x--  094 5 x--  0F8 5 x--  0F8 5 x-- }
7024: 0130 { 0F8 5 ---  094 5 ---  0F8 5 x--  0E0 5 x-- }
7025: 0130 { 0F8 5 ---  0E0 5 ---  0F8 5 x--  094 5 x-- }
7026: 0130 { 204 3 ---  234 3 ---  205 3 ---  235 3 --- }
7027: 0130 { 206 3 ---  236 3 ---  207 3 ---  237 3 --- }
7028: 0130 { 204 3 ---  234 3 ---  207 3 ---  237 3 --- }
7029: 0130 { 229 2 ---  194 2 ---  193 2 ---  195 2 --- }
702A: 0130 { 192 2 ---  194 2 ---  193 2 ---  229 2 x-- }
702B: 0130 { 192 2 ---  194 2 ---  229 2 ---  195 2 --- }
702C: 0130 { 192 2 ---  229 2 x--  193 2 ---  195 2 --- }
702D: 0130 { 2EF 5 x--  2FF 5 x--  2EE 5 x--  2FE 5 x-- }
702E: 0130 { 2EE 6 ---  2FE 6 ---  2EF 6 ---  2FF 6 --- }
702F: 0130 { 268 4 ---  278 4 ---  269 4 ---  279 4 --- }
7030: 0130 { 204 3 ---  214 3 ---  205 3 ---  215 3 --- }
7031: 0130 { 206 3 ---  216 3 ---  207 3 ---  217 3 --- }
7032: 0130 { 208 3 ---  218 3 ---  209 3 ---  219 3 --- }
7033: 0130 { 20A 3 ---  21A 3 ---  20B 3 ---  21B 3 --- }
7034: 0130 { 000 5 ---  010 5 ---  001 5 ---  011 5 --- }
7035: 0130 { 002 5 ---  012 5 ---  003 5 ---  013 5 --- }
7036: 0130 { 27F 7 xy-  26F 7 xy-  27E 7 xy-  26E 7 xy- }
7037: 0130 { 27D 7 xy-  26D 7 xy-  27C 7 xy-  26C 7 xy- }
7038: 0130 { 22E 3 ---  23E 3 ---  22F 3 ---  23F 3 --- }
7039: 0130 { 26A 3 ---  27A 3 ---  26B 3 ---  27B 3 --- }
703A: 0130 { 27B 7 xy-  26B 7 xy-  27A 7 xy-  26A 7 xy- }
703B: 0130 { 26B 7 x--  27B 7 x--  26A 7 x--  27A 7 x-- }
703C: 0130 { 25E 7 -y-  24E 7 -y-  25F 7 -y-  24F 7 -y- }
703D: 0130 { 0F8 5 x--  0F8 5 x--  0F8 5 x--  0F8 5 x-- }
703E: 0130 { 22F 7 x--  23F 7 x--  22E 7 x--  23E 7 x-- }
703F: 0130 { 204 3 ---  214 3 ---  207 3 ---  217 3 --- }
7040: 0130 { 224 3 ---  234 3 ---  225 3 ---  235 3 --- }
7041: 0130 { 226 3 ---  236 3 ---  227 3 ---  237 3 --- }
7042: 0130 { 228 3 ---  238 3 ---  21A 3 -y-  239 3 --- }
7043: 0130 { 22A 3 ---  23A 3 ---  22B 3 ---  23B 3 --- }
7044: 0130 { 020 5 ---  020 5 ---  021 5 ---  021 5 --- }
7045: 0130 { 022 5 ---  022 5 ---  023 5 ---  023 5 --- }
7046: 0130 { 26C 3 ---  27C 3 ---  26D 3 ---  27D 3 --- }
7047: 0130 { 26E 3 ---  27E 3 ---  26F 3 ---  27F 3 --- }
7048: 0130 { 24E 3 ---  25E 3 ---  24F 3 ---  25F 3 --- }
7049: 0130 { 27F 7 xy-  26F 7 xy-  27C 7 xy-  26C 7 xy- }
704A: 0130 { 26F 7 x--  27F 7 x--  26E 7 x--  27E 7 x-- }
704B: 0130 { 26D 7 x--  27D 7 x--  26C 7 x--  27C 7 x-- }
704C: 0130 { 23E 7 -y-  22E 7 -y-  23F 7 -y-  22F 7 -y- }
704D: 0130 { 25F 7 xy-  22E 7 -y-  25E 7 xy-  22F 7 -y- }
704E: 0130 { 24F 7 x--  25F 7 x--  24E 7 x--  25E 7 x-- }
704F: 0130 { 224 3 ---  234 3 ---  227 3 ---  237 3 --- }
7050: 0130 { 0F8 5 ---  0B0 5 ---  0F8 5 ---  0B1 5 --- }
7051: 0130 { 0F8 5 ---  0B2 5 ---  0F8 5 ---  0B3 5 --- }
7052: 0130 { 0F8 5 ---  0B0 6 ---  0F8 5 ---  0B1 6 --- }
7053: 0130 { 0F8 5 ---  0B2 6 ---  0F8 5 ---  0B3 6 --- }
7054: 0130 { 0F8 5 x--  0B3 5 x--  0F8 5 x--  0B2 5 x-- }
7055: 0130 { 0F8 5 x--  0B1 5 x--  0F8 5 x--  0B0 5 x-- }
7056: 0130 { 0F8 5 ---  0C5 4 ---  0F8 5 x--  0C6 4 --- }
7057: 0130 { 0F8 5 ---  0C6 5 x--  0F8 5 x--  0C5 5 x-- }
7058: 0130 { 2CC 6 -y-  0F5 6 -y-  2CD 6 -y-  0F6 6 -y- }
7059: 0130 { 2CD 5 xy-  0F6 5 xy-  2CC 5 xy-  0F5 5 xy- }
705A: 0130 { 084 4 ---  290 4 ---  085 4 ---  291 4 --- }
705B: 0130 { 085 5 x--  291 5 x--  084 5 x--  290 5 x-- }
705C: 0130 { 084 6 ---  290 6 ---  085 6 ---  291 6 --- }
705D: 0130 { 2B1 4 xy-  2A1 4 xy-  2B0 4 xy-  2A0 4 xy- }
705E: 0130 { 2B0 6 -y-  2A0 6 -y-  2B1 6 -y-  2A1 6 -y- }
705F: 0130 { 2B1 5 xy-  2A1 5 xy-  2B0 5 xy-  2A0 5 xy- }
7060: 0130 { 0C0 5 ---  0D0 5 ---  0C1 5 ---  0D1 5 --- }
7061: 0130 { 0C2 5 ---  0D2 5 ---  0C3 5 ---  0F8 5 --- }
7062: 0130 { 0C0 6 ---  0D0 6 ---  0C1 6 ---  0D1 6 --- }
7063: 0130 { 0C2 6 ---  0D2 6 ---  0C3 6 ---  0F8 5 --- }
7064: 0130 { 0C3 5 x--  0F8 5 ---  0C2 5 x--  0D2 5 x-- }
7065: 0130 { 0C1 5 x--  0D1 5 x--  0C0 5 x--  0D0 5 x-- }
7066: 0130 { 0D5 4 ---  0E5 4 ---  0D6 4 ---  0E6 4 --- }
7067: 0130 { 0D6 5 x--  0E6 5 x--  0D5 5 x--  0E5 5 x-- }
7068: 0130 { 0E5 6 -y-  0D5 6 -y-  0E6 6 -y-  0D6 6 -y- }
7069: 0130 { 0E6 5 xy-  0D6 5 xy-  0E5 5 xy-  0D5 5 xy- }
706A: 0130 { 2A0 4 ---  2B0 4 ---  2A1 4 ---  2B1 4 --- }
706B: 0130 { 2A1 5 x--  2B1 5 x--  2A0 5 x--  2B0 5 x-- }
706C: 0130 { 2A0 6 ---  2B0 6 ---  2A1 6 ---  2B1 6 --- }
706D: 0130 { 291 4 xy-  085 4 xy-  290 4 xy-  084 4 xy- }
706E: 0130 { 290 6 -y-  084 6 -y-  291 6 -y-  085 6 -y- }
706F: 0130 { 291 5 xy-  085 5 xy-  290 5 xy-  084 5 xy- }
7070: 0130 { 2B8 5 ---  2C8 5 ---  2B9 5 ---  2C9 5 --- }
7071: 0130 { 2BA 5 ---  2CA 5 ---  2BB 5 ---  2CB 5 --- }
7072: 0130 { 2B8 6 ---  2C8 6 ---  2B9 6 ---  2C9 6 --- }
7073: 0130 { 2BA 6 ---  2CA 6 ---  2BB 6 ---  2CB 6 --- }
7074: 0130 { 2BB 5 x--  2CB 5 x--  2BA 5 x--  2CA 5 x-- }
7075: 0130 { 2B9 5 x--  2C9 5 x--  2B8 5 x--  2C8 5 x-- }
7076: 0130 { 0F5 4 ---  2CC 4 ---  0F6 4 ---  2CD 4 --- }
7077: 0130 { 0F6 5 x--  2CD 5 x--  0F5 5 x--  2CC 5 x-- }
7078: 0130 { 0C5 6 -y-  0F8 5 ---  0C6 6 -y-  0F8 5 --- }
7079: 0130 { 0C6 5 xy-  0F8 5 ---  0C5 5 xy-  0F8 5 --- }
707A: 0130 { 2EC 4 ---  2FC 4 ---  2ED 4 ---  2FD 4 --- }
707B: 0130 { 2ED 5 x--  2FD 5 x--  2EC 5 x--  2FC 5 x-- }
707C: 0130 { 2EE 4 ---  2FE 4 ---  2EF 4 ---  2FF 4 --- }
707D: 0130 { 2FC 6 -y-  2EC 6 -y-  2FD 6 -y-  2ED 6 -y- }
707E: 0130 { 2FD 4 xy-  2ED 4 xy-  2FC 4 xy-  2EC 4 xy- }
707F: 0130 { 2FE 5 -y-  2EE 5 -y-  2FF 5 -y-  2EF 5 -y- }
7080: 0130 { 20C 3 ---  21C 3 ---  20C 3 x--  21C 3 x-- }
7081: 0130 { 0F8 5 ---  0F8 5 ---  0F8 5 ---  2B3 4 --- }
7082: 0130 { 0F8 5 ---  2B4 4 ---  0F8 5 ---  2B5 4 --- }
7083: 0130 { 0F8 5 ---  2F0 4 ---  0F8 5 ---  2F1 4 --- }
7084: 0130 { 2E7 4 ---  2F7 4 ---  2E8 4 ---  2F8 4 --- }
7085: 0130 { 0F8 5 ---  0F8 5 ---  0F8 5 ---  295 4 --- }
7086: 0130 { 0E3 4 ---  296 4 ---  0F8 5 ---  297 4 --- }
7087: 0130 { 0F8 5 ---  0F8 5 ---  0F8 5 ---  295 4 --- }
7088: 0130 { 0E3 4 ---  296 4 ---  0F8 5 ---  297 4 --- }
7089: 0130 { 0F8 5 ---  297 4 x--  0E3 4 x--  296 4 x-- }
708A: 0130 { 0F8 5 ---  295 4 x--  0F8 5 ---  0F8 5 --- }
708B: 0130 { 0F8 5 ---  297 4 x--  0E3 4 x--  296 4 x-- }
708C: 0130 { 0F8 5 ---  295 4 x--  0F8 5 ---  0F8 5 --- }
708D: 0130 { 1CD 3 ---  1DD 3 ---  1CE 3 ---  1DE 3 --- }
708E: 0130 { 2CE 5 ---  2CF 5 x--  2CF 5 ---  2CE 5 x-- }
708F: 0130 { 1BF 2 ---  19A 2 -y-  19A 2 xy-  19A 2 -y- }
7090: 0130 { 20E 3 ---  21E 3 ---  20F 3 ---  21F 3 --- }
7091: 0130 { 0F3 4 ---  2D2 4 ---  0F4 4 ---  2D3 4 --- }
7092: 0130 { 2C4 4 ---  2D4 4 ---  2C5 4 ---  2D5 4 --- }
7093: 0130 { 2E8 4 x--  2F8 4 x--  2E7 4 x--  2F7 4 x-- }
7094: 0130 { 0F8 5 ---  2F1 4 x--  0F8 5 ---  2F0 4 x-- }
7095: 0130 { 0F8 5 ---  0F8 5 ---  2A5 4 ---  0E1 4 --- }
7096: 0130 { 2A6 4 ---  0E2 4 ---  2A7 4 ---  0F8 5 --- }
7097: 0130 { 0F8 5 ---  0F8 5 ---  2A5 4 ---  0E1 4 --- }
7098: 0130 { 2A6 4 ---  0E2 4 ---  2A7 4 ---  0F8 5 --- }
7099: 0130 { 2A7 4 x--  0F8 5 ---  2A6 4 x--  0E2 4 x-- }
709A: 0130 { 2A5 4 x--  0E1 4 x--  0F8 5 ---  0F8 5 --- }
709B: 0130 { 2A7 4 x--  0F8 5 ---  2A6 4 x--  0E2 4 x-- }
709C: 0130 { 2A5 4 x--  0E1 4 x--  0F8 5 ---  0F8 5 --- }
709D: 0130 { 1ED 3 ---  1CF 3 ---  1EE 3 ---  1DF 3 --- }
709E: 0130 { 2CE 5 ---  2DE 5 ---  2CF 5 ---  2DF 5 --- }
709F: 0130 { 19A 2 xy-  19A 2 -y-  19A 2 xy-  1BF 2 --- }
70A0: 0130 { 0F8 5 ---  2F0 4 ---  0F8 5 ---  2F1 4 --- }
70A1: 0130 { 2E2 4 ---  2F2 4 ---  2E3 4 ---  2F3 4 --- }
70A2: 0130 { 2E4 4 ---  2F4 4 ---  2E5 4 ---  2F5 4 --- }
70A3: 0130 { 2E6 4 ---  2F6 4 ---  2E7 4 ---  2F7 4 --- }
70A4: 0130 { 2E8 4 ---  2F8 4 ---  0F8 5 ---  2F0 4 x-- }
70A5: 0130 { 292 4 ---  2A2 4 ---  293 4 ---  2A3 4 --- }
70A6: 0130 { 0F2 4 ---  2A4 4 ---  0F8 5 ---  0F8 5 --- }
70A7: 0130 { 2D9 4 ---  2D6 4 ---  2DA 4 ---  2D7 4 --- }
70A8: 0130 { 2DB 4 ---  2D8 4 ---  0F8 5 ---  2F0 4 x-- }
70A9: 0130 { 0F8 5 ---  0F8 5 ---  0F2 4 x--  2A4 4 x-- }
70AA: 0130 { 293 4 x--  2A3 4 x--  292 4 x--  2A2 4 x-- }
70AB: 0130 { 0F8 5 ---  2F0 4 ---  2DB 4 x--  2D8 4 x-- }
70AC: 0130 { 2DA 4 x--  2D7 4 x--  2D9 4 x--  2D6 4 x-- }
70AD: 0130 { 1EF 3 ---  1F0 3 ---  1E2 3 ---  1F1 3 --- }
70AE: 0130 { 1AE 2 ---  19A 2 -y-  1AE 2 ---  1AE 2 --- }
70AF: 0130 { 19A 2 -y-  1AE 2 ---  19A 2 -y-  19A 2 -y- }
70B0: 0130 { 1C3 7 ---  1D3 7 ---  1C4 7 ---  1D4 7 --- }
70B1: 0130 { 1C5 7 ---  1D5 7 ---  1C6 7 ---  1D6 7 --- }
70B2: 0130 { 1C7 7 ---  1D7 7 ---  1C8 7 ---  1D8 7 --- }
70B3: 0130 { 1C9 7 ---  1D9 7 ---  1CA 7 ---  1DA 7 --- }
70B4: 0130 { 1CB 7 ---  1DB 7 ---  1CC 7 ---  1DC 7 --- }
70B5: 0130 { 0F8 5 ---  255 4 ---  246 4 ---  256 4 --- }
70B6: 0130 { 247 4 ---  257 4 ---  248 4 ---  258 4 --- }
70B7: 0130 { 249 4 ---  259 4 ---  24A 4 ---  25A 4 --- }
70B8: 0130 { 24A 5 x--  25A 5 x--  249 5 x--  259 5 x-- }
70B9: 0130 { 248 5 x--  258 5 x--  247 5 x--  257 5 x-- }
70BA: 0130 { 246 5 x--  256 5 x--  0F8 5 ---  255 5 x-- }
70BB: 0130 { 0F8 5 ---  255 6 ---  246 6 ---  256 6 --- }
70BC: 0130 { 247 6 ---  257 6 ---  248 6 ---  258 6 --- }
70BD: 0130 { 249 6 ---  259 6 ---  24A 6 ---  25A 6 --- }
70BE: 0130 { 19A 2 xy-  19A 2 xy-  19A 2 xy-  1AE 2 x-- }
70BF: 0130 { 1AE 2 x--  1AE 2 x--  1AE 2 x--  19A 2 xy- }
70C0: 0130 { 1E3 7 ---  182 2 ---  1E4 7 ---  183 2 --- }
70C1: 0130 { 1E5 7 ---  182 2 ---  1E6 7 ---  183 2 --- }
70C2: 0130 { 1E7 7 ---  182 2 ---  1E8 7 ---  183 2 --- }
70C3: 0130 { 1E9 7 ---  182 2 ---  1EA 7 ---  183 2 --- }
70C4: 0130 { 1EB 7 ---  182 2 ---  1EC 7 ---  183 2 --- }
70C5: 0130 { 1FB 2 ---  0F8 5 ---  1FB 2 ---  0F8 5 --- }
70C6: 0130 { 1F3 2 ---  1F5 2 ---  1FB 2 ---  0F8 5 --- }
70C7: 0130 { 1FB 2 ---  0F8 5 ---  1F3 2 ---  1F5 2 x-- }
70C8: 0130 { 1FB 2 ---  0F8 5 ---  1F2 2 x--  0F8 5 --- }
70C9: 0130 { 188 2 ---  0F8 5 ---  189 2 ---  188 2 --- }
70CA: 0130 { 189 2 x--  188 2 x--  188 2 x--  0F8 5 --- }
70CB: 0130 { 1AC 2 ---  1BC 2 ---  1A0 2 ---  1B0 2 --- }
70CC: 0130 { 1A1 2 ---  1B1 2 ---  0F8 5 ---  0F8 5 --- }
70CD: 0130 { 0F8 5 ---  0F8 5 ---  1A1 2 x--  1B1 2 x-- }
70CE: 0130 { 1A0 2 x--  1B0 2 x--  1AB 2 ---  1BB 2 --- }
70CF: 0130 { 1AE 2 ---  19A 2 -y-  19A 2 xy-  19A 2 -y- }
70D0: 0130 { 184 2 ---  186 2 ---  193 2 ---  195 2 --- }
70D1: 0130 { 192 2 ---  194 2 ---  184 2 x--  186 2 x-- }
70D2: 0130 { 180 2 ---  190 2 ---  180 2 x--  190 2 x-- }
70D3: 0130 { 180 2 ---  180 2 -y-  182 2 ---  183 2 -y- }
70D4: 0130 { 183 2 ---  182 2 -y-  182 2 ---  183 2 -y- }
70D5: 0130 { 1F2 2 ---  0F8 5 ---  1F3 2 ---  1F5 2 --- }
70D6: 0130 { 1F6 2 ---  1F5 2 ---  0F8 5 ---  0F8 5 --- }
70D7: 0130 { 0F8 5 ---  0F8 5 ---  1F6 2 x--  1F5 2 x-- }
70D8: 0130 { 1F3 2 ---  1F5 2 ---  1F2 2 x--  0F8 5 --- }
70D9: 0130 { 19A 2 ---  19A 2 ---  19A 2 ---  19A 2 --- }
70DA: 0130 { 19A 2 ---  189 2 ---  19A 2 ---  19A 2 --- }
70DB: 0130 { 19A 2 x--  19A 2 x--  19A 2 x--  189 2 x-- }
70DC: 0130 { 19A 2 -y-  19A 2 -y-  189 2 xy-  19A 2 -y- }
70DD: 0130 { 189 2 -y-  19A 2 -y-  19A 2 -y-  19A 2 -y- }
70DE: 0130 { 192 2 ---  18D 2 -y-  18D 2 -y-  189 2 -y- }
70DF: 0130 { 18D 2 xy-  189 2 xy-  193 2 ---  18D 2 xy- }
70E0: 0130 { 192 2 ---  194 2 ---  186 2 x--  195 2 --- }
70E1: 0130 { 186 2 ---  194 2 ---  193 2 ---  195 2 --- }
70E2: 0130 { 190 2 ---  186 2 ---  190 2 x--  186 2 x-- }
70E3: 0130 { 182 2 ---  186 2 -y-  183 2 ---  195 2 --- }
70E4: 0130 { 1F2 2 ---  0F8 5 ---  1FB 2 ---  0F8 5 --- }
70E5: 0130 { 0F8 5 ---  1F7 2 ---  1FA 3 ---  1F8 2 --- }
70E6: 0130 { 1F6 2 ---  1F9 2 ---  0F8 5 ---  0F8 5 --- }
70E7: 0130 { 0F8 5 ---  0F8 5 ---  1F6 2 x--  1F9 2 x-- }
70E8: 0130 { 1FA 3 x--  1F8 2 x--  0F8 5 ---  1F7 2 x-- }
70E9: 0130 { 198 2 ---  1BB 2 ---  199 2 ---  1BC 2 --- }
70EA: 0130 { 188 2 ---  0F8 5 ---  189 2 ---  198 2 --- }
70EB: 0130 { 189 2 x--  199 2 ---  188 2 x--  0F8 5 --- }
70EC: 0130 { 19A 2 -y-  19A 2 xy-  1AE 2 x--  19A 2 xy- }
70ED: 0130 { 08B 3 ---  09B 3 ---  08C 3 ---  09C 3 --- }
70EE: 0130 { 0AA 3 ---  0BA 3 ---  0AB 3 ---  0BE 3 --- }
70EF: 0130 { 0F8 5 ---  0BF 3 ---  0F8 5 ---  0F8 5 --- }
70F0: 0130 { 192 2 ---  194 2 ---  193 2 ---  186 2 xy- }
70F1: 0130 { 192 2 ---  186 2 -y-  193 2 ---  195 2 --- }
70F2: 0130 { 190 2 ---  186 2 ---  190 2 x--  190 2 x-- }
70F3: 0130 { 190 2 ---  190 2 ---  190 2 x--  186 2 x-- }
70F4: 0130 { 28F 3 ---  29F 3 ---  28F 3 ---  29F 3 --- }
70F5: 0130 { 29F 3 -y-  28F 3 -y-  29F 3 -y-  28F 3 -y- }
70F6: 0130 { 2BF 3 x--  2BF 3 x--  2AF 3 x--  2AF 3 x-- }
70F7: 0130 { 2AF 3 ---  2AF 3 ---  2BF 3 ---  2BF 3 --- }
70F8: 0130 { 1A1 2 x--  1B1 2 x--  1A0 2 x--  1B0 2 x-- }
70F9: 0130 { 1AB 2 ---  1BB 2 ---  1AC 2 ---  1BC 2 --- }
70FA: 0130 { 1A0 2 ---  1B0 2 ---  1A1 2 ---  1B1 2 --- }
70FB: 0130 { 0F8 5 ---  0F8 5 ---  1AB 2 ---  1BB 2 --- }
70FC: 0130 { 1AC 2 ---  1BC 2 ---  0F8 5 ---  0F8 5 --- }
70FD: 0130 { 086 3 ---  0C4 3 ---  087 3 ---  0D3 3 --- }
70FE: 0130 { 088 3 ---  0D4 3 ---  095 3 ---  0E4 3 --- }
70FF: 0130 { 0B5 3 ---  0E8 3 ---  0F8 5 ---  0E9 3 --- }
