0800: 016B { 060 6 ---  062 6 ---  061 6 ---  063 6 --- }
0801: 016A { 060 6 ---  062 6 ---  061 6 ---  063 6 --- }
0802: ~
0803: ~
0804: ~
0805: ~
0806: ~
0807: ~
0808: ~
0809: ~
080A: ~
080B: ~
080C: ~
080D: ~
080E: ~
080F: ~
0810: 012F { 25C 6 ---  25E 6 ---  25D 6 ---  25F 6 --- }
0811: ~
0812: ~
0813: ~
0814: ~
0815: ~
0816: ~
0817: ~
0818: ~
0819: ~
081A: ~
081B: ~
081C: ~
081D: ~
081E: ~
081F: ~
0820: 003F { 194 2 ---  212 2 ---  195 2 ---  213 2 --- }
0821: 003F { 212 2 -y-  194 2 -y-  213 2 -y-  195 2 -y- }
0822: 003F { 1D1 2 ---  192 2 ---  0F8 2 ---  1D1 2 --- }
0823: 003F { 0F8 2 x--  1D1 2 x--  1D1 2 x--  193 2 --- }
0824: 003F { 194 2 ---  1D1 2 -y-  1D1 2 -y-  0F8 2 -y- }
0825: 003F { 1D1 2 xy-  0F8 2 xy-  195 2 ---  1D1 2 xy- }
0826: ~
0827: ~
0828: ~
0829: ~
082A: ~
082B: ~
082C: ~
082D: ~
082E: ~
082F: ~
0830: 0146 { 233 2 ---  232 2 ---  223 2 ---  193 2 --- }
0831: 0100 { 224 2 ---  192 2 ---  223 2 ---  193 2 --- }
0832: 0148 { 224 2 ---  192 2 ---  233 2 x--  232 2 x-- }
0833: 0146 { 222 2 ---  232 2 ---  223 2 ---  193 2 --- }
0834: 0148 { 224 2 ---  192 2 ---  222 2 x--  232 2 x-- }
0835: 0146 { 235 2 ---  232 2 ---  183 2 ---  193 2 --- }
0836: 0148 { 182 2 ---  192 2 ---  235 2 x--  232 2 x-- }
0837: 0100 { 225 2 ---  192 2 ---  183 2 ---  193 2 --- }
0838: 0100 { 182 2 ---  192 2 ---  225 2 x--  193 2 --- }
0839: 0146 { 244 2 ---  190 2 ---  223 2 ---  193 2 --- }
083A: 0148 { 224 2 ---  192 2 ---  244 2 x--  190 2 x-- }
083B: 014B { 243 2 ---  190 2 ---  195 2 ---  193 2 --- }
083C: 014C { 194 2 x--  192 2 ---  243 2 x--  190 2 x-- }
083D: ~
083E: ~
083F: ~
0840: 014B { 242 2 ---  232 2 ---  195 2 ---  193 2 --- }
0841: ~
0842: 014C { 195 2 x--  193 2 x--  242 2 x--  232 2 x-- }
0843: 014D { 232 2 -y-  222 2 -y-  193 2 -y-  223 2 -y- }
0844: 014F { 192 2 -y-  224 2 -y-  232 2 xy-  222 2 xy- }
0845: 014D { 232 2 -y-  235 2 -y-  193 2 -y-  183 2 -y- }
0846: 014F { 192 2 -y-  182 2 -y-  232 2 xy-  235 2 xy- }
0847: 014E { 192 2 -y-  225 2 -y-  193 2 -y-  183 2 -y- }
0848: 014E { 192 2 -y-  182 2 -y-  193 2 -y-  225 2 xy- }
0849: 014D { 190 2 -y-  244 2 -y-  193 2 -y-  223 2 -y- }
084A: 014F { 192 2 -y-  224 2 -y-  190 2 xy-  244 2 xy- }
084B: 014B { 190 2 -y-  243 2 -y-  193 2 -y-  195 2 -y- }
084C: 014C { 192 2 -y-  194 2 xy-  190 2 xy-  243 2 xy- }
084D: ~
084E: ~
084F: ~
0850: 014D { 232 2 -y-  233 2 -y-  193 2 -y-  223 2 -y- }
0851: 014E { 192 2 -y-  224 2 -y-  193 2 -y-  223 2 -y- }
0852: 014F { 192 2 -y-  224 2 -y-  232 2 xy-  233 2 xy- }
0853: 0101 { 234 2 ---  192 2 ---  223 2 ---  193 2 --- }
0854: 0103 { 224 2 ---  192 2 ---  234 2 x--  193 2 --- }
0855: 0101 { 245 2 ---  1D0 2 ---  223 2 ---  193 2 --- }
0856: 0103 { 224 2 ---  192 2 ---  245 2 x--  1D0 2 x-- }
0857: 0101 { 234 2 ---  212 2 ---  223 2 ---  213 2 --- }
0858: 0103 { 224 2 ---  212 2 ---  234 2 x--  213 2 --- }
0859: ~
085A: ~
085B: ~
085C: ~
085D: ~
085E: ~
085F: ~
0860: 01ED { 194 2 ---  192 2 ---  195 2 ---  252 2 xy- }
0861: 01EC { 194 2 ---  252 2 -y-  195 2 ---  193 2 --- }
0862: 013B { 004 5 ---  014 5 ---  20E 5 ---  015 5 --- }
0863: 013D { 20F 5 ---  03E 5 ---  20F 5 ---  03E 5 --- }
0864: 013B { 20E 5 x--  015 5 x--  004 5 x--  014 5 x-- }
0865: 0137 { 000 5 ---  010 5 ---  001 5 ---  011 5 --- }
0866: 0138 { 002 5 ---  012 5 ---  003 5 ---  013 5 --- }
0867: 0148 { 225 2 ---  192 2 ---  180 2 x--  190 2 x-- }
0868: 0146 { 180 2 ---  190 2 ---  225 2 x--  193 2 --- }
0869: ~
086A: ~
086B: 014D { 243 2 ---  180 2 -y-  195 2 ---  183 2 -y- }
086C: 014F { 194 2 x--  182 2 -y-  243 2 x--  180 2 xy- }
086D: ~
086E: ~
086F: ~
0870: 01E4 { 195 2 x--  192 2 ---  252 2 x--  193 2 --- }
0871: 01E2 { 252 2 ---  192 2 ---  195 2 ---  193 2 --- }
0872: 013F { 024 5 ---  034 5 ---  025 5 ---  21E 5 --- }
0873: 013E { 02F 5 ---  21F 5 ---  02F 5 ---  21F 5 --- }
0874: 013F { 025 5 x--  21E 5 x--  024 5 x--  034 5 x-- }
0875: 0135 { 22E 5 ---  22E 5 ---  021 5 ---  021 5 --- }
0876: 0136 { 022 5 ---  022 5 ---  22F 5 ---  22F 5 --- }
0877: 014F { 192 2 -y-  225 2 -y-  190 2 xy-  180 2 xy- }
0878: 014D { 190 2 -y-  180 2 -y-  193 2 -y-  225 2 xy- }
0879: ~
087A: ~
087B: 0146 { 180 2 ---  243 2 -y-  183 2 ---  195 2 -y- }
087C: 0148 { 182 2 ---  194 2 xy-  180 2 x--  243 2 xy- }
087D: ~
087E: ~
087F: ~
0880: ~
0881: ~
0882: ~
0883: ~
0884: ~
0885: 0135 { 020 5 ---  020 5 ---  021 5 ---  021 5 --- }
0886: 0136 { 022 5 ---  022 5 ---  023 5 ---  023 5 --- }
0887: ~
0888: ~
0889: ~
088A: ~
088B: ~
088C: ~
088D: ~
088E: ~
088F: ~
0890: ~
0891: ~
0892: ~
0893: ~
0894: ~
0895: ~
0896: ~
0897: ~
0898: ~
0899: ~
089A: ~
089B: ~
089C: ~
089D: ~
089E: ~
089F: ~
08A0: ~
08A1: ~
08A2: ~
08A3: ~
08A4: ~
08A5: ~
08A6: ~
08A7: ~
08A8: ~
08A9: ~
08AA: ~
08AB: ~
08AC: ~
08AD: ~
08AE: ~
08AF: ~
08B0: ~
08B1: ~
08B2: ~
08B3: ~
08B4: ~
08B5: ~
08B6: ~
08B7: ~
08B8: ~
08B9: ~
08BA: ~
08BB: ~
08BC: ~
08BD: ~
08BE: ~
08BF: ~
08C0: ~
08C1: ~
08C2: ~
08C3: ~
08C4: ~
08C5: ~
08C6: ~
08C7: ~
08C8: ~
08C9: ~
08CA: ~
08CB: ~
08CC: ~
08CD: ~
08CE: ~
08CF: ~
08D0: ~
08D1: ~
08D2: ~
08D3: ~
08D4: ~
08D5: ~
08D6: ~
08D7: ~
08D8: ~
08D9: ~
08DA: ~
08DB: ~
08DC: ~
08DD: ~
08DE: ~
08DF: ~
08E0: ~
08E1: ~
08E2: ~
08E3: ~
08E4: ~
08E5: ~
08E6: ~
08E7: ~
08E8: ~
08E9: ~
08EA: ~
08EB: ~
08EC: ~
08ED: ~
08EE: ~
08EF: ~
08F0: ~
08F1: ~
08F2: ~
08F3: ~
08F4: ~
08F5: ~
08F6: ~
08F7: ~
08F8: ~
08F9: ~
08FA: ~
08FB: ~
08FC: ~
08FD: ~
08FE: ~
08FF: ~
