3500: 0130 { 180 2 ---  190 2 ---  181 2 ---  191 2 --- }
3501: 0130 { 182 2 ---  192 2 ---  183 2 ---  193 2 --- }
3502: 0130 { 184 2 ---  194 2 ---  185 2 ---  195 2 --- }
3503: 0130 { 1C2 2 ---  192 2 ---  1C3 2 ---  193 2 --- }
3504: 0130 { 1CC 2 ---  192 2 ---  1C3 2 ---  193 2 --- }
3505: 0130 { 1CC 2 ---  192 2 ---  1CD 2 ---  193 2 --- }
3506: 0130 { 1F3 2 ---  192 2 ---  183 2 ---  193 2 --- }
3507: 0130 { 183 2 ---  192 2 ---  1F3 2 x--  193 2 --- }
3508: 0130 { 24A 2 ---  25A 2 ---  24B 2 ---  25B 2 --- }
3509: 0130 { 248 2 ---  258 2 ---  249 2 ---  259 2 --- }
350A: 0130 { 24C 2 ---  25C 2 ---  24D 2 ---  25D 2 --- }
350B: 0130 { 20E 2 ---  21E 2 ---  20F 2 ---  21F 2 --- }
350C: 0130 { 24E 2 ---  25E 2 ---  24F 2 ---  25F 2 --- }
350D: 0130 { 200 3 ---  210 3 ---  201 3 ---  211 3 --- }
350E: 0130 { 202 3 ---  212 3 ---  203 3 ---  213 3 --- }
350F: 0130 { 204 3 ---  214 3 ---  205 3 ---  215 3 --- }
3510: 0130 { 1A0 2 ---  1B0 2 ---  1A1 2 ---  1B1 2 --- }
3511: 0130 { 1A2 2 ---  1B2 2 ---  1A3 2 ---  1B3 2 --- }
3512: 0130 { 1A4 2 ---  1B4 2 ---  1A5 2 ---  1B5 2 --- }
3513: 0130 { 1B4 2 ---  1B2 2 ---  1BE 2 ---  193 2 --- }
3514: 0130 { 1BE 2 x--  192 2 ---  1B1 2 ---  1B3 2 --- }
3515: 0130 { 1A2 2 ---  1A4 2 ---  187 2 ---  1BE 2 -y- }
3516: 0130 { 186 2 ---  1BE 2 xy-  1A3 2 ---  1B1 2 --- }
3517: 0130 { 18C 2 ---  19C 2 ---  18D 2 ---  19D 2 --- }
3518: 0130 { 26A 2 ---  27A 2 ---  26B 2 ---  27B 2 --- }
3519: 0130 { 268 2 ---  278 2 ---  269 2 ---  279 2 --- }
351A: 0130 { 26C 2 ---  27C 2 ---  26D 2 ---  27D 2 --- }
351B: 0130 { 22E 2 ---  23E 2 ---  22F 2 ---  23F 2 --- }
351C: 0130 { 26E 2 ---  27E 2 ---  26F 2 ---  27F 2 --- }
351D: 0130 { 224 3 ---  234 3 ---  225 3 ---  235 3 --- }
351E: 0130 { 222 3 ---  232 3 ---  223 3 ---  233 3 --- }
351F: 0130 { 224 3 ---  234 3 ---  247 3 ---  257 3 --- }
3520: 0130 { 1C0 2 ---  1D0 2 ---  1C1 2 ---  1D1 2 --- }
3521: 0130 { 186 2 ---  196 2 ---  187 2 ---  197 2 --- }
3522: 0130 { 1C4 2 ---  1D4 2 ---  1C5 2 ---  1D5 2 --- }
3523: 0025 { 18B 5 x--  19B 5 x--  18A 5 x--  19A 5 x-- }
3524: 0130 { 1C6 2 ---  1D6 2 ---  1C7 2 ---  1D7 2 --- }
3525: 0106 { 280 4 ---  290 4 ---  281 4 ---  291 4 --- }
3526: 0106 { 292 4 ---  291 4 x--  292 4 ---  291 4 --- }
3527: 0106 { 281 4 x--  291 4 x--  280 4 x--  290 4 x-- }
3528: 0196 { 0F8 5 ---  1E0 2 ---  0F8 5 ---  1E1 2 --- }
3529: 019B { 1E0 2 ---  1F0 2 ---  1E1 2 ---  1F1 2 --- }
352A: 01AA { 0F8 5 ---  1D2 2 ---  1DB 2 ---  1D3 2 --- }
352B: 0130 { 266 3 ---  276 3 ---  267 3 ---  277 3 --- }
352C: 0130 { 267 3 x--  277 3 x--  266 3 x--  276 3 x-- }
352D: 0130 { 223 3 x--  233 3 x--  222 3 x--  232 3 x-- }
352E: 0130 { 225 3 x--  235 3 x--  224 3 x--  234 3 x-- }
352F: 0130 { 20B 3 ---  22B 3 ---  21B 3 ---  22C 3 --- }
3530: 0025 { 188 5 ---  188 5 ---  188 5 x--  188 5 x-- }
3531: 0025 { 18A 5 ---  19A 5 ---  18B 5 ---  19B 5 --- }
3532: 0025 { 18A 5 ---  19A 5 ---  18B 5 ---  19B 5 --- }
3533: 0025 { 1AB 5 x--  1BB 5 x--  0F8 5 ---  0F8 5 --- }
3534: 0025 { 18B 5 x--  19B 5 x--  18A 5 x--  19A 5 x-- }
3535: 0025 { 2A0 4 --p  2B0 4 --p  2A1 4 --p  2B1 4 --p }
3536: 0025 { 2A1 4 x-p  2A1 4 --p  2A2 4 x-p  2A2 4 --p }
3537: 0025 { 2A1 4 x-p  2B1 4 x-p  2A0 4 x-p  2B0 4 x-p }
3538: 01DE { 1F0 2 ---  1B2 2 ---  1F1 2 ---  1B3 2 --- }
3539: 01E6 { 1F2 2 ---  1B2 2 ---  1B3 2 ---  1B3 2 --- }
353A: 01E2 { 1E2 2 ---  1E3 2 ---  1E3 2 ---  1B3 2 --- }
353B: 0130 { 225 3 ---  235 3 ---  222 3 ---  232 3 --- }
353C: 0130 { 240 3 ---  275 3 ---  241 3 ---  218 3 --- }
353D: 0130 { 242 3 ---  228 3 ---  243 3 ---  238 3 --- }
353E: 0130 { 244 3 ---  239 3 ---  245 3 ---  23A 3 --- }
353F: 0130 { 255 3 ---  23B 3 ---  265 3 ---  23C 3 --- }
3540: 0025 { 188 5 ---  198 5 ---  188 5 x--  199 5 --- }
3541: 0025 { 1AA 5 ---  1BA 5 ---  1AB 5 ---  1BB 5 --- }
3542: 0025 { 0F8 5 ---  0F8 5 ---  1AC 5 ---  1BC 5 --- }
3543: 0025 { 1AD 5 ---  1BD 5 ---  0F8 5 ---  0F8 5 --- }
3544: 0025 { 1AB 5 x--  1BB 5 x--  1AA 5 x--  1BA 5 x-- }
3545: 0025 { 2A0 4 --p  2C0 4 --p  2A1 4 --p  2C1 4 --p }
3546: 0025 { 2A1 4 x-p  2C2 4 --p  2A2 4 x-p  2C2 4 x-p }
3547: 0025 { 2A1 4 x-p  2C1 4 x-p  2A0 4 x-p  2C0 4 x-p }
3548: 0130 { 250 3 ---  260 3 ---  251 3 ---  261 3 --- }
3549: 0130 { 252 3 ---  262 3 ---  252 3 ---  262 3 --- }
354A: 0130 { 253 3 ---  263 3 ---  254 3 ---  264 3 --- }
354B: 0130 { 2AD 5 ---  2BD 5 ---  28C 5 ---  29C 5 --- }
354C: 0130 { 2AC 5 ---  2BE 5 ---  2BC 5 ---  2BF 5 --- }
354D: 0130 { 286 3 ---  296 3 ---  287 3 ---  297 3 --- }
354E: 0130 { 288 3 ---  298 3 ---  289 3 ---  299 3 --- }
354F: 0130 { 28A 3 ---  29A 3 ---  28B 3 ---  29B 3 --- }
3550: 0025 { 1A8 5 ---  1B8 5 ---  1A9 5 ---  1B9 5 --- }
3551: 0025 { 1CE 5 ---  1CE 5 ---  1CF 5 ---  1CF 5 --- }
3552: 0025 { 1EC 5 ---  1FC 5 ---  1ED 5 ---  1FD 5 --- }
3553: 0025 { 1EE 5 ---  1FE 5 ---  1EF 5 ---  1FF 5 --- }
3554: 0006 { 18E 5 ---  18E 5 ---  18F 5 ---  18F 5 --- }
3555: 0025 { 1B7 6 x--  1B7 6 x--  1B7 6 x--  1B7 6 x-- }
3556: 0025 { 1B7 6 x--  1B7 6 x--  0F8 6 ---  1B7 6 x-- }
3557: 0025 { 20C 6 ---  21C 6 ---  20D 6 ---  21D 6 --- }
3558: 0130 { 270 3 ---  270 3 ---  271 3 ---  271 3 --- }
3559: 0130 { 271 3 ---  271 3 ---  271 3 ---  271 3 --- }
355A: 0130 { 271 3 ---  271 3 ---  270 3 ---  270 3 --- }
355B: 003F { 28D 5 ---  29D 5 ---  28D 5 ---  29D 5 --- }
355C: 0025 { 28E 5 ---  28E 5 ---  28F 5 ---  28F 5 --- }
355D: 0130 { 284 3 ---  294 3 ---  285 3 ---  295 3 --- }
355E: 0130 { 2A8 3 ---  2B8 3 ---  2A9 3 ---  2B9 3 --- }
355F: 0130 { 2AA 3 ---  2BA 3 ---  2AB 3 ---  2BB 3 --- }
3560: 0006 { 1C8 5 ---  1D8 5 ---  1C9 5 ---  1D9 5 --- }
3561: 0025 { 1DE 5 ---  1DC 5 ---  1DF 5 ---  1DD 5 --- }
3562: 0025 { 1E8 5 ---  1F8 5 ---  1E9 5 ---  1F9 5 --- }
3563: 0025 { 1EA 5 ---  1FA 5 ---  1EB 5 ---  1FB 5 --- }
3564: 0006 { 18E 5 ---  19E 5 ---  18F 5 ---  19F 5 --- }
3565: 0130 { 18D 2 x--  19D 2 x--  18C 2 x--  19C 2 x-- }
3566: 0025 { 206 5 ---  216 5 ---  207 5 ---  217 5 --- }
3567: 0025 { 22D 5 x--  23D 5 x--  22D 5 ---  23D 5 --- }
3568: 0130 { 270 3 ---  272 3 ---  271 3 ---  273 3 --- }
3569: 0130 { 271 3 ---  273 3 ---  271 3 ---  273 3 --- }
356A: 0130 { 271 3 ---  273 3 ---  270 3 ---  274 3 --- }
356B: 0025 { 28D 5 ---  29D 5 ---  2AE 5 ---  2AE 5 -y- }
356C: 0025 { 2AE 5 x--  28E 5 ---  2AE 5 ---  28F 5 --- }
356D: 0130 { 2A4 3 ---  2C4 3 ---  2A5 3 ---  2C5 3 --- }
356E: 0130 { 2C8 3 ---  2D8 3 ---  2C9 3 ---  2D9 3 --- }
356F: 0130 { 2CA 3 ---  2DA 3 ---  2CB 3 ---  2DB 3 --- }
3570: 0130 { 1E4 5 ---  1F4 5 ---  1E5 5 ---  1F5 5 --- }
3571: 0130 { 1E5 5 x--  1F5 5 x--  1E4 5 x--  1F4 5 x-- }
3572: 0025 { 0F8 5 ---  0F8 5 ---  208 4 ---  0F8 5 x-- }
3573: 0025 { 209 4 ---  219 4 ---  20A 4 ---  21A 4 --- }
3574: 0025 { 20A 4 x--  21A 4 x--  209 4 x--  219 4 x-- }
3575: 0025 { 208 4 x--  0F8 5 x--  0F8 5 x--  0F8 5 x-- }
3576: 0025 { 226 5 ---  236 5 ---  227 5 ---  237 5 --- }
3577: 0025 { 23D 5 x--  23D 5 x--  23D 5 ---  23D 5 --- }
3578: 0130 { 2D4 2 ---  2D0 3 ---  2D5 2 ---  2D1 3 --- }
3579: 0130 { 2E4 2 ---  2D2 3 ---  2E5 2 ---  2D3 3 --- }
357A: 0130 { 2D0 3 ---  2E0 3 ---  2D1 3 ---  2E1 3 --- }
357B: 0130 { 2D2 3 ---  2E2 3 ---  2D3 3 ---  2E3 3 --- }
357C: 0130 { 2E4 2 ---  2D0 3 ---  2E5 2 ---  2D1 3 --- }
357D: 0130 { 2D4 2 ---  2D1 3 ---  2D5 2 ---  2D1 3 --- }
357E: 0130 { 2D5 2 x--  2D2 3 ---  2D4 2 x--  2D3 3 --- }
357F: 0130 { 2A6 3 ---  2B6 3 ---  2A7 3 ---  2B7 3 --- }
3580: 0130 { 1E6 5 ---  1F6 5 ---  1E7 5 ---  1F7 5 --- }
3581: 0025 { 1A6 7 ---  1B6 7 ---  1A7 7 ---  1B7 7 --- }
3582: 0025 { 1A7 7 x--  1B7 7 x--  1A6 7 x--  1B6 7 x-- }
3583: 0025 { 229 4 ---  0F8 5 ---  22A 4 ---  0F8 5 x-- }
3584: 0025 { 22A 4 x--  0F8 5 x--  229 4 x--  0F8 5 x-- }
3585: 0130 { 2D1 3 ---  2E1 3 ---  2D1 3 ---  2E1 3 --- }
3586: 0130 { 2E0 3 ---  2E0 3 ---  2E1 3 ---  2E1 3 -y- }
3587: 0130 { 2E2 3 ---  2E2 3 ---  2E3 3 ---  2E3 3 --- }
3588: 0130 { 2E0 3 ---  2F0 3 ---  2E1 3 ---  2F1 3 --- }
3589: 0130 { 2E2 3 ---  2F2 3 ---  2E3 3 ---  2F3 3 --- }
358A: 0130 { 2E0 3 ---  2F0 3 ---  2E1 3 -y-  2F1 3 --- }
358B: 0130 { 2E2 3 ---  2F2 3 ---  2E3 3 ---  2F3 3 --- }
358C: 0130 { 2E0 3 ---  2F0 3 ---  2E1 3 ---  2F1 3 --- }
358D: 0130 { 2E1 3 ---  2F1 3 ---  2E1 3 ---  2F1 3 --- }
358E: 0130 { 2E2 3 ---  2F2 3 ---  2E3 3 ---  2F3 3 --- }
358F: 0130 { 29E 5 ---  29E 5 ---  29F 5 ---  29F 5 --- }
3590: 0130 { 1F6 5 -y-  1E6 5 -y-  1F7 5 -y-  1E7 5 -y- }
3591: 0025 { 189 7 ---  189 7 ---  1B7 7 ---  1B7 7 --- }
3592: 0025 { 1B7 7 x--  1B7 7 x--  189 7 x--  189 7 x-- }
3593: 0130 { 2CC 2 ---  2DC 2 ---  2CD 2 ---  2DD 2 --- }
3594: 0130 { 2CE 2 ---  2DE 2 ---  1A3 2 ---  1B3 2 --- }
3595: 0130 { 2E1 3 -y-  2F1 3 ---  2E1 3 -y-  2F1 3 --- }
3596: 0130 { 2E1 3 ---  2E1 3 -y-  2E1 3 ---  2E1 3 -y- }
3597: 0130 { 2D1 3 ---  2E1 3 ---  2D1 3 ---  2E1 3 --- }
3598: 0130 { 2D6 2 ---  2D0 3 ---  2D7 2 ---  2D1 3 --- }
3599: 0130 { 2C6 2 ---  2D2 3 ---  2C7 2 ---  2D3 3 --- }
359A: 0130 { 2E6 2 ---  2D0 3 ---  2E7 2 ---  2D1 3 --- }
359B: 0130 { 2E8 2 ---  2D1 3 ---  2E9 2 ---  2D1 3 --- }
359C: 0130 { 2C6 2 ---  2D2 3 ---  2C7 2 ---  2D3 3 --- }
359D: 0130 { 2EE 3 ---  2FE 3 ---  2EF 3 ---  2FF 3 --- }
359E: 0130 { 2EC 3 ---  2FC 3 ---  2ED 3 ---  2FD 3 --- }
359F: 0130 { 2E1 3 ---  2EE 3 ---  2E1 3 ---  2EF 3 --- }
35A0: 0130 { 1A0 2 ---  1B0 2 ---  1A5 2 ---  1B5 2 --- }
35A1: 0025 { 189 7 ---  1A6 7 -y-  1B7 7 ---  1A7 7 -y- }
35A2: 0025 { 1B7 7 x--  1A7 7 xy-  189 7 x--  1A6 7 xy- }
35A3: 0025 { 2EA 5 ---  2FA 5 ---  2EB 5 ---  2FB 5 --- }
35A4: 0025 { 2EB 5 ---  2FB 5 ---  2EB 5 ---  2FB 5 --- }
35A5: 0025 { 2EB 5 x--  2FB 5 x--  2EA 5 x--  2FA 5 x-- }
35A6: 0130 { 13B 6 ---  14B 6 ---  13C 6 ---  14C 6 --- }
35A7: 0130 { 13D 6 ---  14D 6 ---  13D 6 ---  14D 6 --- }
35A8: 0130 { 13C 6 x--  14C 6 x--  13B 6 x--  14B 6 x-- }
35A9: 0130 { 0F8 5 ---  0F8 5 ---  1CE 5 ---  1CE 5 --- }
35AA: 0130 { 1CF 5 ---  1CF 5 ---  0F8 5 ---  0F8 5 --- }
35AB: 01F0 { 1B3 2 xy-  1B3 2 xy-  1B2 2 xy-  1F2 2 xy- }
35AC: 01EF { 1B3 2 xy-  1F1 2 xy-  1B2 2 xy-  1F0 2 xy- }
35AD: 0025 { 0F8 5 ---  2D0 3 ---  0F8 5 x--  2D1 3 --- }
35AE: 0130 { 0F8 5 ---  2D2 3 ---  0F8 5 x--  2D3 3 --- }
35AF: 0130 { 2FE 3 ---  2F1 3 ---  2FF 3 ---  2F1 3 --- }
35B0: 0130 { 1BE 2 x--  194 2 ---  1A5 2 ---  1B5 2 --- }
35B1: 0130 { 186 2 ---  1BE 2 xy-  186 2 ---  1BE 2 -y- }
35B2: 0130 { 1B0 2 ---  1D0 2 ---  1B5 2 ---  1D5 2 --- }
35B3: 0025 { 2AF 5 ---  2AF 5 ---  2FB 5 ---  2FB 5 --- }
35B4: 0025 { 2FB 5 ---  2FB 5 ---  2FB 5 ---  2FB 5 --- }
35B5: 0025 { 2FB 5 ---  2FB 5 ---  2AF 5 ---  2AF 5 --- }
35B6: 0130 { 15E 6 ---  15E 6 ---  15F 6 ---  15F 6 --- }
35B7: 0130 { 13E 6 ---  14E 6 ---  13F 6 ---  14F 6 --- }
35B8: 0130 { 14E 6 -y-  13E 6 -y-  14F 6 -y-  13F 6 -y- }
35B9: 0130 { 0F8 5 ---  0F8 5 ---  1DE 5 ---  1DC 5 --- }
35BA: 0130 { 1DF 5 ---  1DD 5 ---  0F8 5 ---  0F8 5 --- }
35BB: 01C8 { 1F1 2 xy-  1E1 2 xy-  1F0 2 xy-  1E0 2 xy- }
35BC: 01C9 { 1E1 2 xy-  0F8 5 xy-  1E0 2 xy-  0F8 5 xy- }
35BD: 0025 { 2E0 3 ---  2F0 3 ---  2E1 3 ---  2F1 3 --- }
35BE: 0130 { 2E2 3 ---  2F2 3 ---  2E3 3 ---  2F3 3 --- }
35BF: 0130 { 2E1 3 ---  2EC 3 ---  2E1 3 ---  2ED 3 --- }
35C0: 0106 { 130 6 ---  0F8 5 ---  131 6 ---  0F8 5 x-- }
35C1: 0106 { 131 6 ---  0F8 5 ---  131 6 ---  0F8 5 x-- }
35C2: 0106 { 131 6 ---  0F8 5 ---  132 6 ---  0F8 5 x-- }
35C3: 0106 { 130 6 ---  140 6 ---  131 6 ---  141 6 --- }
35C4: 0106 { 131 6 ---  141 6 x--  132 6 ---  140 6 x-- }
35C5: 0106 { 131 6 ---  151 6 ---  131 6 ---  152 6 --- }
35C6: 0106 { 131 6 ---  133 6 ---  131 6 ---  0F8 5 --- }
35C7: 0025 { 0F8 5 ---  0F8 5 ---  18A 5 ---  19A 5 --- }
35C8: 0025 { 18B 5 ---  19B 5 ---  0F8 5 ---  0F8 5 --- }
35C9: 01AA { 0F8 5 ---  143 6 ---  134 6 ---  144 6 --- }
35CA: 0196 { 0F8 5 ---  135 6 ---  0F8 5 ---  136 6 --- }
35CB: 019B { 135 6 ---  145 6 ---  136 6 ---  146 6 --- }
35CC: 003F { 2AD 5 ---  2BD 5 ---  2AD 5 ---  2BD 5 --- }
35CD: 0025 { 2AE 5 x--  2AE 5 xy-  28D 5 x--  29D 5 x-- }
35CE: 0130 { 28C 5 x--  29C 5 x--  2AD 5 x--  2BD 5 x-- }
35CF: 0130 { 2FC 3 ---  2F1 3 ---  2FD 3 ---  2F1 3 --- }
35D0: 0106 { 130 6 ---  152 6 ---  131 6 ---  133 6 --- }
35D1: 0106 { 131 6 x--  133 6 x--  130 6 x--  152 6 x-- }
35D2: 0106 { 130 6 ---  0F8 5 x--  131 6 ---  133 6 x-- }
35D3: 0025 { 150 6 ---  142 6 ---  0F8 5 ---  0F8 5 --- }
35D4: 0025 { 0F8 5 x--  0F8 5 x--  150 6 x--  142 6 x-- }
35D5: 0106 { 131 6 ---  0F8 5 x--  131 6 ---  133 6 x-- }
35D6: 0106 { 131 6 ---  152 6 x--  131 6 ---  151 6 x-- }
35D7: 0025 { 0F8 5 ---  0F8 5 ---  1AA 5 ---  1BA 5 --- }
35D8: 0025 { 1AB 5 ---  1BB 5 ---  0F8 5 ---  0F8 5 --- }
35D9: 01E2 { 153 6 ---  0F8 5 ---  154 6 ---  0F8 5 --- }
35DA: 01DE { 145 6 ---  0F8 5 ---  146 6 ---  0F8 5 --- }
35DB: 01E6 { 0F8 5 ---  0F8 5 ---  0F8 5 ---  0F8 5 --- }
35DC: 01A0 { 1E1 2 x--  1F1 2 x--  1E0 2 x--  1F0 2 x-- }
35DD: 01A5 { 0F8 5 x--  1E1 2 x--  0F8 5 x--  1E0 2 x-- }
35DE: 0025 { 1BA 5 -y-  1AA 5 -y-  1BB 5 -y-  1AB 5 -y- }
35DF: 0025 { 19B 5 xy-  18B 5 xy-  19A 5 xy-  18A 5 xy- }
35E0: 0025 { 0F8 5 ---  0F8 5 ---  106 7 ---  106 7 --- }
35E1: 0025 { 0F8 5 ---  0F8 5 ---  083 6 ---  093 6 --- }
35E2: 0025 { 084 6 ---  094 6 ---  083 6 x--  093 6 x-- }
35E3: 0025 { 083 6 ---  093 6 ---  084 6 x--  094 6 x-- }
35E4: 0025 { 083 6 x--  093 6 x--  0F8 5 x--  0F8 5 x-- }
35E5: 0025 { 106 7 ---  106 7 ---  0F8 5 ---  0F8 5 --- }
35E6: 0025 { 1B7 7 x--  1B7 7 x--  0F8 5 ---  1B7 7 x-- }
35E7: 0130 { 1C4 2 ---  1BE 2 xy-  1A5 2 ---  1B5 2 --- }
35E8: 01EE { 1B3 2 xy-  1F0 2 -y-  1B2 2 xy-  1F1 2 -y- }
35E9: 01F0 { 1B3 2 xy-  1F2 2 -y-  1B2 2 xy-  1B3 2 xy- }
35EA: 0025 { 0F8 5 -y-  0F8 5 -y-  1BC 5 -y-  1AC 5 -y- }
35EB: 0025 { 1BD 5 -y-  1AD 5 -y-  0F8 5 -y-  0F8 5 -y- }
35EC: 01E6 { 1B3 2 ---  1B2 2 ---  1F2 2 x--  1B3 2 --- }
35ED: 01E0 { 1F1 2 x--  1B2 2 ---  1F0 2 x--  1B3 2 --- }
35EE: 0025 { 19A 5 -y-  18A 5 -y-  19B 5 -y-  18B 5 -y- }
35EF: 001F { 206 5 ---  216 5 ---  207 5 ---  217 5 --- }
35F0: 0025 { 0F8 7 ---  0F8 7 ---  160 7 ---  170 7 --- }
35F1: 0025 { 161 7 ---  171 7 ---  162 7 ---  172 7 --- }
35F2: 0025 { 163 7 ---  173 7 ---  164 7 ---  174 7 --- }
35F3: 0025 { 165 7 ---  175 7 ---  166 7 ---  176 7 --- }
35F4: 0025 { 167 7 ---  177 7 ---  168 7 ---  178 7 --- }
35F5: 0025 { 169 7 ---  179 7 ---  0F8 7 ---  0F8 7 --- }
35F6: 0106 { 131 6 ---  140 6 ---  131 6 ---  141 6 --- }
35F7: 0130 { 196 2 -y-  196 2 ---  197 2 -y-  197 2 --- }
35F8: 01C6 { 1E0 2 -y-  0F8 5 -y-  1E1 2 -y-  0F8 5 -y- }
35F9: 01C7 { 1F0 2 -y-  1E0 2 -y-  1F1 2 -y-  1E1 2 -y- }
35FA: 0025 { 19A 5 -y-  18A 5 -y-  19B 5 -y-  18B 5 -y- }
35FB: 0025 { 1BB 5 xy-  1AB 5 xy-  0F8 5 -y-  0F8 5 -y- }
35FC: 0025 { 08E 3 ---  09E 3 ---  08F 3 ---  09F 3 --- }
35FD: 0025 { 08B 6 x--  09B 6 x--  08A 6 x--  09A 6 x-- }
35FE: 0130 { 085 2 ---  095 2 ---  086 2 ---  096 2 --- }
35FF: 0020 { 226 5 ---  236 5 ---  227 5 ---  237 5 --- }
