6800: 0025 { 100 7 ---  103 7 ---  101 7 ---  2F1 7 --- }
6801: 0025 { 101 7 ---  2F1 7 ---  101 7 ---  2F1 7 --- }
6802: 0025 { 101 7 ---  2F1 7 ---  102 7 ---  104 7 --- }
6803: 0025 { 15B 5 ---  15E 5 ---  15C 5 ---  0FC 4 --- }
6804: 0025 { 15C 5 ---  0FC 4 ---  15C 5 ---  0FC 4 --- }
6805: 0025 { 15C 5 ---  0FC 4 ---  15D 5 ---  15F 4 --- }
6806: 0025 { 1AE 5 ---  1B1 5 ---  1AF 5 ---  0FD 4 --- }
6807: 0025 { 1AF 5 ---  0FD 4 ---  1AF 5 ---  0FD 4 --- }
6808: 0025 { 1AF 5 ---  0FD 4 ---  1B0 5 ---  1B2 4 --- }
6809: 0025 { 0FE 1 ---  0FE 1 ---  0FE 1 ---  0FE 1 --- }
680A: 0025 { 0FE 1 ---  0FE 1 ---  0FE 1 ---  0FE 1 --- }
680B: 0025 { 0FE 1 ---  0FE 1 ---  0FE 1 ---  0FE 1 --- }
680C: 0025 { 0FE 1 ---  0FE 1 ---  0FE 1 ---  0FE 1 --- }
680D: 0025 { 0FE 1 ---  0FE 1 ---  106 4 ---  10D 4 --- }
680E: 0025 { 107 4 ---  10E 4 ---  108 4 ---  108 4 --- }
680F: 0025 { 0FE 1 ---  0FE 1 ---  0FE 1 ---  0FE 1 --- }
6810: 0025 { 105 7 ---  108 7 ---  106 7 ---  109 7 --- }
6811: 0025 { 106 7 ---  109 7 ---  106 7 ---  109 7 --- }
6812: 0025 { 106 7 ---  109 7 ---  107 7 ---  108 7 x-- }
6813: 0025 { 15E 5 ---  160 4 ---  0FC 4 ---  161 4 --- }
6814: 0025 { 0FC 4 ---  161 4 ---  0FC 4 ---  161 4 --- }
6815: 0025 { 0FC 4 ---  161 4 ---  15F 4 ---  160 4 x-- }
6816: 0025 { 1B1 5 ---  1B3 7 ---  0FD 4 ---  1B4 7 --- }
6817: 0025 { 0FD 4 ---  1B4 7 ---  0FD 4 ---  1B4 7 --- }
6818: 0025 { 0FD 4 ---  1B4 7 ---  1B2 4 ---  1B3 7 x-- }
6819: 0025 { 121 5 ---  14C 5 ---  122 5 ---  14D 5 --- }
681A: 0025 { 123 5 ---  14E 5 ---  124 5 ---  14F 1 --- }
681B: 0025 { 125 5 ---  150 5 ---  126 5 ---  151 5 --- }
681C: 0025 { 127 5 ---  152 5 ---  128 5 ---  153 5 --- }
681D: 0025 { 129 5 ---  154 5 ---  12A 5 ---  155 5 --- }
681E: 0025 { 10E 4 ---  10E 4 ---  12B 4 ---  156 1 --- }
681F: 0025 { 12C 5 ---  157 5 ---  12D 5 ---  158 5 --- }
6820: 0025 { 100 5 ---  103 5 ---  101 5 ---  286 4 --- }
6821: 0025 { 101 5 ---  286 4 ---  101 5 ---  286 4 --- }
6822: 0025 { 101 5 ---  286 4 ---  102 5 ---  104 4 --- }
6823: 0025 { 169 7 ---  16C 7 ---  16A 7 ---  0FC 7 --- }
6824: 0025 { 16A 7 ---  0FC 7 ---  16A 7 ---  0FC 7 --- }
6825: 0025 { 16A 7 ---  0FC 7 ---  16B 7 ---  16D 7 --- }
6826: 0025 { 1C1 5 ---  1C4 5 ---  1C2 5 ---  08E 4 --- }
6827: 0025 { 1C2 5 ---  08E 4 ---  1C2 5 ---  08E 4 --- }
6828: 0025 { 1C2 5 ---  08E 4 ---  1C3 5 ---  1C5 4 --- }
6829: 0025 { 177 4 ---  1A2 4 ---  178 4 ---  1A3 4 --- }
682A: 0025 { 179 4 ---  1A4 4 ---  17A 4 ---  1A5 4 --- }
682B: 0025 { 17B 4 ---  1A6 1 ---  17C 4 ---  1A7 1 --- }
682C: 0025 { 17D 4 ---  1A8 5 ---  17E 4 ---  1A9 4 --- }
682D: 0025 { 17F 4 ---  1AA 4 ---  180 4 ---  1AB 4 --- }
682E: 0025 { 10E 4 ---  10E 4 ---  181 4 ---  1AC 4 --- }
682F: 0025 { 182 4 ---  1AD 4 ---  183 4 ---  1AE 4 --- }
6830: 0025 { 103 5 ---  105 5 ---  286 4 ---  106 4 --- }
6831: 0025 { 286 4 ---  106 4 ---  286 4 ---  106 4 --- }
6832: 0025 { 286 4 ---  106 4 ---  104 4 ---  107 4 --- }
6833: 0025 { 16C 7 ---  16E 5 ---  0FC 7 ---  16F 7 --- }
6834: 0025 { 0FC 7 ---  16F 7 ---  0FC 7 ---  16F 7 --- }
6835: 0025 { 0FC 7 ---  16F 7 ---  16D 7 ---  170 7 --- }
6836: 0025 { 1C4 5 ---  1C6 5 ---  08E 4 ---  1C7 4 --- }
6837: 0025 { 08E 4 ---  1C7 4 ---  08E 4 ---  1C7 4 --- }
6838: 0025 { 08E 4 ---  1C7 4 ---  1C5 4 ---  1C8 4 --- }
6839: 0025 { 1CF 4 ---  1FC 5 ---  1D0 4 ---  1FD 5 --- }
683A: 0025 { 1D1 4 ---  1FE 5 ---  1D2 4 ---  1FF 4 --- }
683B: 0025 { 1D3 4 ---  200 4 ---  1D4 4 ---  201 4 --- }
683C: 0025 { 1D5 4 ---  202 4 ---  1D6 4 ---  203 4 --- }
683D: 0025 { 1D7 4 ---  204 5 ---  1D8 4 ---  205 4 --- }
683E: 0025 { 10E 4 ---  107 4 -y-  1D9 4 ---  206 4 --- }
683F: 0025 { 1DA 4 ---  207 4 ---  1DB 4 ---  208 4 --- }
6840: 0025 { 21B 7 ---  21D 7 ---  21C 7 ---  21E 7 --- }
6841: 0025 { 21C 7 ---  21F 7 ---  21C 7 ---  220 7 --- }
6842: 0025 { 21C 7 ---  221 7 ---  21C 7 ---  222 7 --- }
6843: 0025 { 21C 7 ---  223 7 ---  21C 7 ---  224 7 --- }
6844: 0025 { 21C 7 ---  225 7 ---  21C 7 ---  226 7 --- }
6845: 0025 { 21C 7 ---  21E 7 ---  21C 7 ---  21F 7 --- }
6846: 0025 { 21C 7 ---  220 7 ---  21C 7 ---  221 7 --- }
6847: 0025 { 21C 7 ---  227 7 ---  21B 7 x--  21D 7 x-- }
6848: 0130 { 08E 2 ---  09E 2 ---  08F 2 ---  09F 2 --- }
6849: 0025 { 0FE 1 ---  0FE 1 ---  0FE 1 ---  0FE 1 --- }
684A: 0025 { 0FE 1 ---  0FE 1 ---  0FE 1 ---  0FE 1 --- }
684B: 0025 { 0FE 1 ---  0FE 1 ---  0FE 1 ---  0FE 1 --- }
684C: 0025 { 109 4 ---  10C 4 x--  10A 4 ---  10B 4 x-- }
684D: 0025 { 101 1 ---  103 1 ---  102 1 ---  0FA 1 --- }
684E: 0025 { 102 1 ---  0FA 1 ---  102 1 ---  0FA 1 --- }
684F: 0025 { 102 1 ---  0FA 1 ---  101 1 x--  103 1 x-- }
6850: 0025 { 21D 7 ---  21D 7 ---  21E 7 ---  21E 7 --- }
6851: 0025 { 21F 7 -y-  22B 7 ---  228 7 ---  22C 7 --- }
6852: 0025 { 221 7 -y-  22D 7 ---  222 7 ---  222 7 --- }
6853: 0025 { 223 7 ---  22E 7 ---  229 7 ---  22F 7 --- }
6854: 0025 { 22A 7 ---  230 7 ---  226 7 ---  231 7 --- }
6855: 0025 { 21E 7 ---  21E 7 ---  21F 7 -y-  22B 7 --- }
6856: 0025 { 228 7 ---  22C 7 ---  221 7 -y-  22D 7 --- }
6857: 0025 { 227 7 ---  227 7 ---  21D 7 x--  21D 7 x-- }
6858: 0130 { 02C 2 ---  03C 2 ---  02D 2 ---  03D 2 --- }
6859: 0025 { 12E 5 ---  159 5 ---  12F 5 ---  15A 5 --- }
685A: 0025 { 130 5 ---  15B 5 ---  131 5 ---  15C 5 --- }
685B: 0025 { 132 4 ---  15D 1 ---  133 5 ---  15E 1 --- }
685C: 0025 { 134 4 ---  15F 4 ---  10B 4 x--  10B 4 x-- }
685D: 0025 { 103 1 ---  101 1 -y-  0FA 1 ---  102 1 -y- }
685E: 0025 { 0FA 1 ---  102 1 -y-  0FA 1 ---  102 1 -y- }
685F: 0025 { 0FA 1 ---  102 1 -y-  103 1 x--  101 1 xy- }
6860: 0025 { 21D 7 ---  21D 7 ---  21E 7 ---  238 7 --- }
6861: 0025 { 232 7 ---  239 7 ---  233 7 ---  239 7 --- }
6862: 0025 { 233 7 ---  239 7 ---  222 7 ---  23A 7 --- }
6863: 0025 { 234 7 ---  239 7 ---  235 7 ---  23B 7 --- }
6864: 0025 { 236 7 ---  23C 7 ---  237 7 ---  23D 7 --- }
6865: 0025 { 21E 7 ---  238 7 ---  232 7 ---  239 7 --- }
6866: 0025 { 233 7 ---  239 7 ---  233 7 ---  239 7 --- }
6867: 0025 { 227 7 ---  23E 7 ---  21D 7 x--  21D 7 x-- }
6868: 0130 { 019 2 ---  019 2 ---  019 2 ---  019 2 --- }
6869: 0025 { 184 5 ---  1AF 1 ---  185 4 ---  1B0 1 --- }
686A: 0025 { 186 4 ---  1B1 4 ---  187 4 ---  1B2 4 --- }
686B: 0025 { 188 4 ---  1B3 1 ---  189 1 ---  1B4 1 --- }
686C: 0025 { 15F 4 ---  1B5 4 ---  10B 4 x--  10B 4 x-- }
686D: 0025 { 210 7 ---  213 7 ---  211 7 ---  214 7 --- }
686E: 0025 { 211 7 ---  214 7 ---  211 7 ---  214 7 --- }
686F: 0025 { 211 7 ---  214 7 ---  212 7 ---  215 7 --- }
6870: 0025 { 23F 7 ---  243 7 ---  240 7 ---  244 7 --- }
6871: 0025 { 241 7 ---  245 7 ---  241 7 ---  245 7 --- }
6872: 0025 { 241 7 ---  245 7 ---  241 7 ---  245 7 --- }
6873: 0025 { 241 7 ---  245 7 ---  241 7 ---  245 7 --- }
6874: 0025 { 242 7 ---  246 7 ---  214 7 ---  245 7 --- }
6875: 0025 { 214 7 ---  245 7 ---  214 7 ---  245 7 --- }
6876: 0025 { 214 7 ---  245 7 ---  214 7 ---  245 7 --- }
6877: 0025 { 214 7 ---  245 7 ---  21D 7 x--  247 7 --- }
6878: 0025 { 0D6 2 -y-  0D7 2 -y-  0D7 2 -y-  0D6 2 -y- }
6879: 0025 { 1DC 4 ---  209 4 ---  1DD 4 ---  20A 4 --- }
687A: 0025 { 1DE 5 ---  20B 4 ---  1DF 4 ---  20C 4 --- }
687B: 0025 { 1E0 4 ---  20D 4 ---  1E1 4 ---  20E 5 --- }
687C: 0025 { 1E2 4 ---  20F 4 ---  10B 4 x--  10A 4 -y- }
687D: 0025 { 216 7 ---  219 7 ---  217 7 ---  21A 7 --- }
687E: 0025 { 217 7 ---  21A 7 ---  217 7 ---  21A 7 --- }
687F: 0025 { 217 7 ---  21A 7 ---  218 7 ---  219 7 x-- }
6880: 0025 { 2E5 6 ---  2F5 6 ---  2E6 6 ---  2F6 6 --- }
6881: 0025 { 2E7 6 ---  2F7 6 ---  2E8 6 ---  2F8 6 --- }
6882: 0025 { 000 3 ---  010 3 ---  001 3 ---  011 3 --- }
6883: 0025 { 002 3 ---  012 3 ---  003 3 ---  013 3 --- }
6884: 0025 { 143 6 ---  153 6 ---  144 6 ---  154 6 --- }
6885: 0025 { 146 6 ---  156 6 ---  147 6 ---  157 6 --- }
6886: 0025 { 0E7 6 ---  0F7 6 ---  0CC 6 ---  0CD 6 --- }
6887: 0025 { 08A 6 ---  09A 6 ---  08B 6 ---  09B 6 --- }
6888: 0130 { 0D6 2 -y-  0C6 2 -y-  0D7 2 -y-  0C7 2 -y- }
6889: 0025 { 0F8 5 ---  0F8 5 ---  2BF 6 x--  2BF 6 x-- }
688A: 0025 { 2BE 6 x--  2BE 6 x--  0F8 5 ---  0F8 5 --- }
688B: 0130 { 0C6 2 ---  0D6 2 ---  0C7 2 ---  0D7 2 --- }
688C: 0025 { 0D7 2 ---  0D6 2 ---  0D6 2 ---  0D7 2 --- }
688D: 0130 { 0A6 2 ---  0B6 2 ---  0A7 2 ---  0B7 2 --- }
688E: 0020 { 0C0 3 ---  0D0 3 ---  0C1 3 ---  0D1 3 --- }
688F: 0020 { 0B4 3 ---  0C4 3 ---  0B5 3 ---  0C5 3 --- }
6890: 0025 { 0F8 4 ---  0F8 4 ---  0F8 4 ---  1C7 1 --- }
6891: 0025 { 0F8 4 ---  1C8 1 ---  0F8 4 ---  1C9 1 --- }
6892: 0025 { 0F8 4 ---  1CA 1 ---  0F8 4 ---  1CB 1 --- }
6893: 0025 { 0F8 4 ---  1CC 1 ---  0F8 4 ---  1CD 1 --- }
6894: 0025 { 0F8 4 ---  1CF 1 ---  0F8 4 ---  1D7 1 --- }
6895: 0025 { 0F8 4 ---  1DE 1 ---  0F8 4 ---  1DF 1 --- }
6896: 0025 { 0F8 4 ---  0F8 4 ---  0F8 4 ---  0F8 4 --- }
6897: 0025 { 0F8 4 ---  0F8 4 ---  2CF 6 x--  2DF 6 x-- }
6898: 0025 { 2CE 6 x--  2DE 6 x--  0F8 4 ---  0F8 4 --- }
6899: 0025 { 0F8 5 ---  0F8 5 ---  2BF 6 x--  0DF 6 x-- }
689A: 0025 { 2BE 6 x--  0DE 6 x--  0F8 5 ---  0F8 5 --- }
689B: 0025 { 0F8 5 ---  0F8 5 ---  28F 6 x--  29F 6 x-- }
689C: 0025 { 28E 6 x--  29E 6 x--  0F8 5 ---  0F8 5 --- }
689D: 0130 { 0E6 2 ---  0F6 2 ---  0A7 2 ---  0B7 2 --- }
689E: 0020 { 0E0 3 ---  0F0 3 ---  0E1 3 ---  0F1 3 --- }
689F: 0020 { 0D4 3 ---  0E4 3 ---  0D5 3 ---  0E5 3 --- }
68A0: 0025 { 0F8 4 ---  0F8 4 ---  19D 1 ---  0F8 4 --- }
68A1: 0025 { 19E 1 ---  0F8 4 ---  19F 1 ---  0F8 4 --- }
68A2: 0025 { 18F 1 ---  0F8 4 ---  2BE 1 ---  0F8 4 --- }
68A3: 0025 { 28E 1 ---  0F8 4 ---  28F 1 ---  0F8 4 --- }
68A4: 0025 { 29E 1 ---  0F8 4 ---  29F 1 ---  0F8 4 --- }
68A5: 0025 { 2AE 1 ---  0F8 4 ---  2AF 1 ---  0F8 4 --- }
68A6: 0025 { 0F8 4 ---  0F8 4 ---  0F8 4 ---  0F8 4 --- }
68A7: 0025 { 0F8 4 ---  0F8 4 ---  0DF 6 x--  0FF 6 x-- }
68A8: 0025 { 0DE 6 x--  0FE 6 x--  0F8 4 ---  0F8 4 --- }
68A9: 0025 { 0F8 5 ---  0F8 5 ---  0EF 6 x--  0FF 6 x-- }
68AA: 0025 { 0EE 6 x--  0FE 6 x--  0F8 5 ---  0F8 5 --- }
68AB: 0025 { 0F8 5 ---  0F8 5 ---  29F 6 x--  2AF 6 x-- }
68AC: 0025 { 29E 6 x--  2AE 6 x--  0F8 5 ---  0F8 5 --- }
68AD: 0130 { 0A6 2 ---  0B6 2 ---  0E7 2 ---  0F7 2 --- }
68AE: 0020 { 0B2 3 ---  0C2 3 ---  0B3 3 ---  0C3 3 --- }
68AF: 0020 { 0C8 3 ---  0D8 3 ---  0C9 3 ---  0D9 3 --- }
68B0: 0025 { 0F8 4 ---  0F8 4 ---  0F8 4 ---  111 1 --- }
68B1: 0025 { 0F8 4 ---  112 1 ---  0F8 4 ---  113 1 --- }
68B2: 0025 { 0F8 4 ---  114 1 ---  0F8 4 ---  115 1 --- }
68B3: 0025 { 0F8 4 ---  116 1 ---  0F8 4 ---  117 1 --- }
68B4: 0025 { 0F8 4 ---  118 1 ---  0F8 4 ---  15A 1 --- }
68B5: 0025 { 0F8 4 ---  15B 1 ---  0F8 4 ---  0F8 4 --- }
68B6: 0025 { 0F8 4 ---  0F8 4 ---  0F8 4 ---  291 1 --- }
68B7: 0025 { 0F8 4 ---  292 1 ---  0F8 4 ---  293 1 --- }
68B8: 0025 { 0F8 4 ---  294 1 ---  0F8 4 ---  0F8 4 --- }
68B9: 0025 { 2EC 6 ---  2FC 6 ---  2ED 6 ---  2FD 6 --- }
68BA: 0025 { 2EE 6 ---  2FE 6 ---  2EF 6 ---  2FF 6 --- }
68BB: 0025 { 0F8 4 ---  0F8 4 ---  0F8 4 ---  28C 1 --- }
68BC: 0025 { 0F8 4 ---  28D 1 ---  0F8 4 ---  2BC 1 --- }
68BD: 0025 { 0F8 4 ---  2BD 1 ---  0F8 4 ---  0F8 4 --- }
68BE: 0025 { 0F8 2 ---  022 7 ---  0F8 2 ---  023 7 --- }
68BF: 0025 { 0F8 2 ---  020 7 ---  0F8 2 ---  021 7 --- }
68C0: 0025 { 0F8 4 ---  0F8 4 ---  121 1 ---  131 1 --- }
68C1: 0025 { 122 1 ---  132 1 ---  123 1 ---  133 1 --- }
68C2: 0025 { 124 1 ---  134 1 ---  125 1 ---  135 1 --- }
68C3: 0025 { 126 1 ---  136 1 ---  127 1 ---  137 1 --- }
68C4: 0025 { 14D 1 ---  138 1 ---  15C 1 ---  28D 1 --- }
68C5: 0025 { 15D 1 ---  0F8 4 ---  0F8 4 ---  0F8 4 --- }
68C6: 0025 { 2A0 1 ---  2B0 1 ---  2A2 1 ---  2B1 1 --- }
68C7: 0025 { 2A2 1 ---  2B2 1 ---  2A3 1 ---  2B3 1 --- }
68C8: 0025 { 2A4 1 ---  2B4 1 ---  0F8 4 ---  2B5 1 --- }
68C9: 0025 { 0F8 4 ---  2B6 1 ---  0F8 4 ---  0F8 4 --- }
68CA: 0130 { 09F 2 ---  09E 2 ---  09E 2 ---  09F 2 --- }
68CB: 0025 { 0F8 4 ---  0F8 4 ---  2CB 1 ---  2CD 1 --- }
68CC: 0025 { 2CC 1 ---  2F4 1 ---  2CC 1 x--  2F4 1 x-- }
68CD: 0025 { 2CB 1 x--  2CD 1 x--  0F8 4 x--  0F8 4 x-- }
68CE: 0025 { 032 7 ---  0F8 2 ---  033 7 ---  0F8 2 --- }
68CF: 0025 { 030 7 ---  0F8 2 ---  031 7 ---  0F8 2 --- }
68D0: 0025 { 0F8 4 ---  0F8 4 ---  280 1 ---  0F8 4 --- }
68D1: 0025 { 281 1 ---  0F8 4 ---  282 1 ---  0F8 4 --- }
68D2: 0025 { 283 1 ---  0F8 4 ---  284 1 ---  0F8 4 --- }
68D3: 0025 { 285 1 ---  0F8 4 ---  286 1 ---  0F8 4 --- }
68D4: 0025 { 287 1 ---  0F8 4 ---  288 1 ---  0F8 4 --- }
68D5: 0025 { 096 2 -y-  0B1 2 -y-  0A5 2 -y-  082 2 -y- }
68D6: 0025 { 2B0 1 ---  2B0 1 ---  13E 1 ---  13E 1 --- }
68D7: 0025 { 2C2 1 ---  13E 1 ---  2C3 1 ---  13E 1 --- }
68D8: 0025 { 2C4 1 ---  2B2 1 ---  2C5 1 ---  2D5 1 --- }
68D9: 0025 { 2C6 1 ---  2D6 1 ---  2C7 1 ---  2D7 1 --- }
68DA: 0025 { 2C8 1 ---  2D8 1 ---  0F8 4 ---  0F8 4 --- }
68DB: 0025 { 0F8 4 ---  0F8 4 ---  2F5 1 ---  2F5 1 --- }
68DC: 0025 { 2F6 1 ---  2F6 1 ---  2F6 1 x--  2F6 1 x-- }
68DD: 0025 { 2F5 1 x--  2F5 1 x--  0F8 4 x--  0F8 4 x-- }
68DE: 0025 { 2CE 6 ---  2DE 6 ---  2CF 6 ---  2DF 6 --- }
68DF: 0025 { 2CF 6 x--  2DF 6 x--  2CE 6 x--  2DE 6 x-- }
68E0: 0025 { 0F8 5 ---  0F8 5 ---  0F8 5 ---  2B0 5 --- }
68E1: 0025 { 0F8 5 ---  2B1 5 ---  0F8 5 ---  2B2 5 --- }
68E2: 0025 { 0F8 5 ---  2B3 5 ---  0F8 5 ---  2B5 5 --- }
68E3: 0130 { 0B1 2 ---  0B1 2 ---  0B1 2 ---  0B1 2 --- }
68E4: 0025 { 082 2 ---  095 2 ---  082 2 ---  095 2 --- }
68E5: 0025 { 0F8 5 ---  283 5 ---  0F8 5 ---  284 5 --- }
68E6: 0025 { 0F8 5 ---  285 5 ---  0F8 5 ---  286 5 --- }
68E7: 0025 { 0F8 5 ---  287 5 ---  0F8 5 ---  288 5 --- }
68E8: 0025 { 0F8 5 ---  289 5 ---  0F8 5 ---  28A 5 --- }
68E9: 0130 { 0B8 2 ---  0B8 2 ---  0B8 2 ---  0B8 2 --- }
68EA: 0025 { 095 2 -y-  082 2 -y-  095 2 -y-  082 2 -y- }
68EB: 0025 { 0F8 4 ---  0F8 4 ---  2F5 1 ---  2F8 1 --- }
68EC: 0025 { 2F7 1 ---  2F9 1 ---  2F7 1 x--  2F9 1 x-- }
68ED: 0025 { 2F5 1 x--  2F8 1 x--  0F8 4 x--  0F8 4 x-- }
68EE: 0025 { 0DE 6 ---  0FE 6 ---  0DF 6 ---  0FF 6 --- }
68EF: 0025 { 0DF 6 x--  0FF 6 x--  0DE 6 x--  0FE 6 x-- }
68F0: 0025 { 0F8 5 ---  0F8 5 ---  2C0 5 ---  2B7 5 --- }
68F1: 0025 { 2C1 5 ---  2B8 5 ---  2C2 5 ---  2B9 5 --- }
68F2: 0025 { 2B4 5 ---  2BA 5 ---  2B6 5 ---  2BB 5 --- }
68F3: 0025 { 0F8 5 ---  0F8 5 ---  290 5 ---  2A0 5 --- }
68F4: 0025 { 291 5 ---  2A1 5 ---  292 5 ---  2A2 5 --- }
68F5: 0025 { 293 5 ---  2A3 5 ---  294 5 ---  2A4 5 --- }
68F6: 0025 { 295 5 ---  2A5 5 ---  296 5 ---  2A6 5 --- }
68F7: 0025 { 297 5 ---  2A7 5 ---  298 5 ---  2A8 5 --- }
68F8: 0025 { 299 5 ---  2A9 5 ---  29A 5 ---  2AA 5 --- }
68F9: 0025 { 29B 5 ---  2AB 5 ---  29C 5 ---  2AC 5 --- }
68FA: 0025 { 29D 5 ---  2AD 5 ---  0F8 5 ---  0F8 5 --- }
68FB: 0025 { 0F8 4 x--  18D 1 ---  2EE 1 ---  2FE 1 --- }
68FC: 0025 { 2EF 1 ---  2FF 1 ---  2EF 1 x--  2FF 1 x-- }
68FD: 0025 { 2EE 1 x--  2FE 1 x--  0F8 4 ---  18D 1 x-- }
68FE: 0025 { 1AB 6 ---  1BB 6 ---  1AC 6 ---  1BC 6 --- }
68FF: 0025 { 1AD 6 ---  1BD 6 ---  1AF 6 ---  1BF 6 --- }
