3300: 0025 { 0F8 3 ---  0F8 3 ---  0F8 3 ---  0F8 3 --- }
3301: 0025 { 0F8 3 ---  0F8 3 ---  0F8 3 ---  0F8 3 --- }
3302: ~
3303: ~
3304: 3300 { 0F8 3 ---  169 6 x--  0F8 3 ---  169 6 x-- }
3305: 0025 { 0F8 3 ---  169 6 x--  0F8 3 ---  169 6 x-- }
3306: ~
3307: ~
3308: ~
3309: ~
330A: ~
330B: ~
330C: ~
330D: ~
330E: ~
330F: ~
3310: 0130 { 160 2 --p  170 2 --p  161 2 --p  171 2 --p }
3311: 0130 { 166 3 ---  176 3 ---  167 3 ---  177 3 --- }
3312: 0025 { 160 2 --p  170 2 --p  161 2 --p  171 2 --p }
3313: 0025 { 15C 7 ---  16C 7 ---  15D 7 ---  16D 7 --- }
3314: 0130 { 16A 6 ---  17A 6 ---  16B 6 ---  17B 6 --- }
3315: 0105 { 179 3 x--  0F8 3 ---  179 3 x--  0F8 3 --- }
3316: 0025 { 14E 2 ---  15E 2 ---  14F 2 ---  15F 2 --- }
3317: 3301 { 14E 2 ---  15E 2 ---  14F 2 ---  15F 2 --- }
3318: ~
3319: ~
331A: ~
331B: ~
331C: ~
331D: ~
331E: ~
331F: ~
3320: 0130 { 162 2 --p  172 2 --p  163 2 --p  173 2 --p }
3321: 0130 { 164 7 ---  174 7 ---  165 7 ---  175 7 --- }
3322: 0025 { 162 2 --p  172 2 --p  163 2 --p  173 2 --p }
3323: 0025 { 16C 7 ---  16C 7 ---  16D 7 ---  16D 7 --- }
3324: 0130 { 16E 2 ---  17E 2 ---  16F 2 ---  17F 2 --- }
3325: 0025 { 146 3 ---  156 3 ---  147 3 ---  157 3 --- }
3326: ~
3327: ~
3328: ~
3329: ~
332A: ~
332B: ~
332C: ~
332D: ~
332E: ~
332F: ~
3330: ~
3331: ~
3332: ~
3333: 0025 { 16C 7 ---  17C 7 ---  16D 7 ---  17D 7 --- }
3334: ~
3335: ~
3336: ~
3337: ~
3338: ~
3339: ~
333A: ~
333B: ~
333C: ~
333D: ~
333E: ~
333F: ~
3340: 0002 { 1C6 7 ---  1D6 7 ---  1C7 7 ---  1D7 7 --- }
3341: 0002 { 1C4 7 --p  0FC 7 --p  1C5 7 --p  0FC 7 --p }
3342: 0002 { 1C4 1 --p  0FC 1 --p  1C5 1 --p  0FC 1 --p }
3343: 0130 { 1C4 1 --p  0FC 1 --p  1C5 1 --p  0FC 1 --p }
3344: 012F { 1C2 6 ---  1D2 6 ---  1C3 6 ---  1D3 6 --- }
3345: ~
3346: 0200 { 0F8 3 ---  0F8 3 ---  0F8 3 ---  0F8 3 --- }
3347: 0002 { 1C4 7 --p  0FC 7 --p  1C5 1 --p  0FC 1 --p }
3348: 0002 { 1C4 1 --p  0FC 1 --p  1C4 7 --p  0FC 7 --p }
3349: ~
334A: ~
334B: ~
334C: ~
334D: ~
334E: ~
334F: ~
3350: 0002 { 1E6 7 ---  1D6 7 ---  1E7 7 ---  1D7 7 --- }
3351: 0002 { 0FC 7 --p  0FC 7 --p  0FC 7 --p  0FC 7 --p }
3352: 0002 { 0FC 1 --p  0FC 1 --p  0FC 1 --p  0FC 1 --p }
3353: 0130 { 0FC 1 --p  0FC 1 --p  0FC 1 --p  0FC 1 --p }
3354: 012F { 1D2 6 -y-  1C2 6 -y-  1D3 6 -y-  1C3 6 -y- }
3355: 0025 { 0F8 3 ---  1D4 3 ---  0F8 3 ---  1D5 3 --- }
3356: 020B { 0F8 3 ---  0F8 3 ---  0F8 3 ---  0F8 3 --- }
3357: 0002 { 0FC 7 --p  0FC 7 --p  0FC 1 --p  0FC 1 --p }
3358: 0002 { 0FC 1 --p  0FC 1 --p  0FC 7 --p  0FC 7 --p }
3359: ~
335A: ~
335B: ~
335C: ~
335D: ~
335E: ~
335F: ~
3360: 0130 { 1C6 1 --p  1D6 1 --p  1C7 1 --p  1D7 1 --p }
3361: 0025 { 1C6 1 --p  1D6 1 --p  1C7 1 --p  1D7 1 --p }
3362: 01E4 { 1C4 1 --p  0FC 1 --p  1C5 1 --p  0FC 1 --p }
3363: 0100 { 1C4 1 --p  0FC 1 --p  1C5 1 --p  0FC 1 --p }
3364: ~
3365: ~
3366: ~
3367: ~
3368: ~
3369: ~
336A: ~
336B: ~
336C: ~
336D: ~
336E: ~
336F: ~
3370: 0130 { 1E6 1 --p  1D6 1 --p  1E7 1 --p  1D7 1 --p }
3371: 0025 { 1E6 1 --p  1D6 1 --p  1E7 1 --p  1D7 1 --p }
3372: 0135 { 020 5 ---  020 5 ---  021 5 ---  021 5 --- }
3373: 0136 { 022 5 ---  022 5 ---  023 5 ---  023 5 --- }
3374: ~
3375: ~
3376: ~
3377: ~
3378: ~
3379: ~
337A: ~
337B: ~
337C: ~
337D: ~
337E: ~
337F: ~
3380: 0066 { 0F8 7 ---  00E 7 ---  0F8 7 ---  00F 7 --- }
3381: 0067 { 0F8 7 ---  08C 7 ---  0F8 7 ---  00B 7 --- }
3382: 0067 { 0F8 7 x--  00B 7 x--  0F8 7 x--  08C 7 x-- }
3383: 0066 { 0F8 7 x--  00F 7 x--  0F8 7 x--  00E 7 x-- }
3384: ~
3385: ~
3386: ~
3387: ~
3388: ~
3389: ~
338A: ~
338B: ~
338C: ~
338D: ~
338E: ~
338F: ~
3390: 0068 { 01E 7 ---  093 5 ---  01F 7 ---  0D5 7 --- }
3391: 0069 { 09C 7 ---  0F8 7 ---  0F8 7 ---  094 5 --- }
3392: 0069 { 0F8 7 x--  094 5 x--  09C 7 x--  0F8 7 x-- }
3393: 0068 { 01F 7 x--  0D5 7 x--  01E 7 x--  093 5 x-- }
3394: ~
3395: ~
3396: ~
3397: ~
3398: ~
3399: ~
339A: ~
339B: ~
339C: ~
339D: ~
339E: ~
339F: ~
33A0: 0025 { 0F8 5 ---  0B2 5 ---  0B0 5 ---  0B3 5 --- }
33A1: 0025 { 0B0 5 ---  0B4 5 ---  0B0 5 ---  0B3 5 --- }
33A2: 0025 { 0B1 5 ---  0B4 5 ---  0F8 5 ---  0B5 5 --- }
33A3: 0025 { 08A 0 ---  08A 0 ---  08A 0 x--  08A 0 x-- }
33A4: ~
33A5: ~
33A6: ~
33A7: ~
33A8: ~
33A9: ~
33AA: ~
33AB: ~
33AC: ~
33AD: ~
33AE: ~
33AF: ~
33B0: 0130 { 182 3 ---  192 3 ---  183 3 ---  193 3 --- }
33B1: 0130 { 180 5 ---  190 5 ---  181 5 ---  191 5 --- }
33B2: 012F { 200 7 ---  210 7 ---  201 7 ---  211 7 --- }
33B3: 012F { 202 7 ---  212 7 ---  203 7 ---  213 7 --- }
33B4: 012F { 204 7 ---  214 7 ---  205 7 ---  215 7 --- }
33B5: 012F { 206 7 ---  216 7 ---  207 7 ---  217 7 --- }
33B6: 0130 { 182 0 ---  192 0 ---  183 0 ---  193 0 --- }
33B7: 012F { 058 7 ---  05A 7 ---  059 7 ---  05B 7 --- }
33B8: ~
33B9: ~
33BA: ~
33BB: ~
33BC: ~
33BD: ~
33BE: ~
33BF: ~
33C0: ~
33C1: ~
33C2: ~
33C3: ~
33C4: ~
33C5: ~
33C6: ~
33C7: ~
33C8: ~
33C9: ~
33CA: ~
33CB: ~
33CC: ~
33CD: ~
33CE: ~
33CF: ~
33D0: ~
33D1: ~
33D2: ~
33D3: ~
33D4: ~
33D5: ~
33D6: ~
33D7: ~
33D8: ~
33D9: ~
33DA: ~
33DB: ~
33DC: ~
33DD: ~
33DE: ~
33DF: ~
33E0: ~
33E1: ~
33E2: ~
33E3: ~
33E4: ~
33E5: ~
33E6: ~
33E7: ~
33E8: ~
33E9: ~
33EA: ~
33EB: ~
33EC: ~
33ED: ~
33EE: ~
33EF: ~
33F0: ~
33F1: ~
33F2: ~
33F3: ~
33F4: ~
33F5: ~
33F6: ~
33F7: ~
33F8: ~
33F9: ~
33FA: ~
33FB: ~
33FC: ~
33FD: ~
33FE: ~
33FF: ~
