5A00: ~
5A01: ~
5A02: ~
5A03: 0025 { 188 2 ---  18F 2 ---  189 2 ---  18F 2 --- }
5A04: 0025 { 189 2 x--  18F 2 x--  188 2 x--  18F 2 x-- }
5A05: 0025 { 19F 2 ---  18F 2 ---  1AF 2 ---  18F 2 --- }
5A06: 0025 { 18F 2 x--  1AF 2 ---  18F 2 x--  18F 2 x-- }
5A07: 0025 { 185 5 ---  185 5 ---  185 5 ---  195 5 --- }
5A08: 0025 { 186 5 ---  196 5 ---  187 5 ---  197 5 --- }
5A09: 0025 { 188 5 ---  198 5 ---  188 5 x--  198 5 x-- }
5A0A: 0025 { 187 5 x--  197 5 x--  186 5 x--  196 5 x-- }
5A0B: 0025 { 185 5 x--  195 5 x--  185 5 ---  185 5 --- }
5A0C: ~
5A0D: ~
5A0E: ~
5A0F: ~
5A10: ~
5A11: ~
5A12: ~
5A13: 0130 { 1F2 2 ---  190 2 ---  180 2 ---  191 2 --- }
5A14: 0130 { 181 2 ---  191 2 x--  180 2 ---  190 2 x-- }
5A15: 0130 { 1BF 2 ---  1BF 2 ---  19F 2 ---  1AF 2 --- }
5A16: 0130 { 1AF 2 ---  19F 2 ---  1BF 2 ---  1BF 2 --- }
5A17: 0025 { 185 5 ---  185 5 ---  1A5 5 ---  1B5 5 --- }
5A18: 0025 { 1A6 5 ---  1B6 5 ---  1A7 5 ---  1B7 5 --- }
5A19: 0025 { 1A8 5 ---  1B8 5 ---  1A8 5 x--  1B8 5 x-- }
5A1A: 0025 { 1A7 5 x--  1B7 5 x--  1A6 5 x--  1B6 5 x-- }
5A1B: 0025 { 1A5 5 x--  1B5 5 x--  185 5 ---  185 5 --- }
5A1C: ~
5A1D: ~
5A1E: ~
5A1F: ~
5A20: ~
5A21: ~
5A22: ~
5A23: 0130 { 181 2 ---  190 2 ---  1F2 2 ---  191 2 --- }
5A24: 0130 { 180 2 ---  191 2 x--  181 2 ---  190 2 x-- }
5A25: 0130 { 1F2 2 ---  182 2 ---  180 2 ---  183 2 --- }
5A26: 0130 { 181 2 ---  184 2 ---  1F2 2 ---  185 2 --- }
5A27: 0130 { 180 2 ---  186 2 ---  181 2 ---  187 2 --- }
5A28: 0130 { 1F2 2 ---  187 2 x--  180 2 ---  186 2 --- }
5A29: 0130 { 181 2 ---  185 2 ---  1F2 2 ---  186 2 --- }
5A2A: 0130 { 180 2 ---  185 2 ---  181 2 ---  182 2 x-- }
5A2B: 0130 { 1F2 2 ---  182 2 ---  1E4 2 ---  1F4 2 --- }
5A2C: ~
5A2D: ~
5A2E: ~
5A2F: ~
5A30: ~
5A31: ~
5A32: ~
5A33: 0130 { 180 2 ---  190 2 ---  181 2 ---  191 2 --- }
5A34: 0130 { 1F2 2 ---  191 2 x--  180 2 ---  190 2 x-- }
5A35: 0130 { 181 2 ---  182 2 ---  1F2 2 ---  183 2 --- }
5A36: 0130 { 180 2 ---  184 2 ---  181 2 ---  185 2 --- }
5A37: 0130 { 1F2 2 ---  186 2 ---  180 2 ---  187 2 --- }
5A38: 0130 { 181 2 ---  187 2 x--  1F2 2 ---  186 2 --- }
5A39: 0130 { 180 2 ---  185 2 ---  181 2 ---  186 2 --- }
5A3A: 0130 { 1F2 2 ---  185 2 ---  180 2 ---  182 2 x-- }
5A3B: 0130 { 192 2 ---  1A2 2 ---  1E5 2 ---  1F5 2 --- }
5A3C: ~
5A3D: ~
5A3E: ~
5A3F: ~
5A40: ~
5A41: ~
5A42: ~
5A43: 0130 { 1A0 2 ---  1B0 2 ---  1A1 2 ---  1B1 2 --- }
5A44: 0130 { 1A1 2 x--  1B1 2 x--  1A0 2 x--  1B0 2 x-- }
5A45: 0130 { 192 2 ---  1A2 2 ---  193 2 ---  1A3 2 --- }
5A46: 0130 { 194 2 ---  1A4 2 ---  195 2 ---  1A5 2 --- }
5A47: 0130 { 196 2 ---  1A6 2 ---  197 2 ---  1A7 2 --- }
5A48: 0130 { 198 2 ---  1A8 2 ---  196 2 x--  1A6 2 x-- }
5A49: 0130 { 195 2 x--  1A5 2 x--  194 2 x--  1A4 2 x-- }
5A4A: 0130 { 193 2 x--  1A3 2 x--  192 2 x--  1A2 2 x-- }
5A4B: 0130 { 1B2 2 ---  1C2 2 ---  1E6 2 ---  1F6 2 --- }
5A4C: ~
5A4D: ~
5A4E: ~
5A4F: 0130 { 19E 2 ---  1AE 2 ---  180 2 ---  186 2 --- }
5A50: ~
5A51: ~
5A52: ~
5A53: 0130 { 1C0 2 ---  1D0 2 ---  1C1 2 ---  1D1 2 --- }
5A54: 0130 { 1C1 2 x--  1D1 2 x--  1C0 2 x--  1D0 2 x-- }
5A55: 0130 { 1B2 2 ---  1C2 2 ---  1B3 2 ---  1C3 2 --- }
5A56: 0130 { 1B4 2 ---  1C4 2 ---  1B5 2 ---  1C5 2 --- }
5A57: 0130 { 1B6 2 ---  1C6 2 ---  1B7 2 ---  1C7 2 --- }
5A58: 0130 { 1B8 2 ---  1C8 2 ---  1B6 2 x--  1C6 2 x-- }
5A59: 0130 { 1B5 2 x--  1C5 2 x--  1B4 2 x--  1D8 2 --- }
5A5A: 0130 { 1B3 2 x--  1D9 2 ---  1B2 2 x--  1C2 2 x-- }
5A5B: 0130 { 1D2 2 ---  1E2 2 ---  1E7 2 ---  1F7 2 --- }
5A5C: ~
5A5D: ~
5A5E: ~
5A5F: 0130 { 1BE 2 ---  1CE 2 ---  196 2 x--  1A6 2 x-- }
5A60: ~
5A61: ~
5A62: ~
5A63: 0130 { 1E0 2 ---  1F0 2 ---  1E1 2 ---  1F1 2 --- }
5A64: 0130 { 1E1 2 x--  1F1 2 x--  1E0 2 x--  1F0 2 x-- }
5A65: 0130 { 1D2 2 ---  1E2 2 ---  1D3 2 ---  1E3 2 --- }
5A66: 0130 { 1D4 2 ---  0F8 2 ---  1D5 2 ---  0F8 2 --- }
5A67: ~
5A68: ~
5A69: 0130 { 1D5 2 x--  0F8 2 x--  1D4 2 x--  0F8 2 x-- }
5A6A: 0130 { 1E9 2 ---  1E3 2 x--  1D2 2 x--  1E2 2 x-- }
5A6B: ~
5A6C: ~
5A6D: ~
5A6E: ~
5A6F: 0130 { 1DE 2 ---  1EE 2 ---  1B6 2 x--  1C6 2 x-- }
5A70: 0130 { 180 2 x--  186 2 x--  19E 2 x--  1AE 2 x-- }
5A71: 0130 { 206 3 ---  216 3 ---  207 3 ---  217 3 --- }
5A72: 0130 { 208 3 ---  218 3 ---  209 3 ---  219 3 --- }
5A73: 0130 { 226 3 ---  236 3 ---  227 3 ---  237 3 --- }
5A74: 0025 { 246 3 ---  249 3 ---  246 3 ---  248 3 --- }
5A75: 0025 { 246 3 ---  249 3 ---  247 3 ---  257 3 --- }
5A76: 0025 { 18A 4 ---  19A 4 ---  18B 4 ---  19B 4 --- }
5A77: 0020 { 18C 4 ---  19C 4 ---  18D 4 ---  19D 4 --- }
5A78: 0025 { 25E 2 ---  26E 2 ---  222 2 ---  26F 2 --- }
5A79: 0025 { 223 2 ---  27C 2 ---  27F 2 ---  27D 2 --- }
5A7A: 0025 { 27F 2 x--  27D 2 x--  223 2 x--  27C 2 x-- }
5A7B: 0025 { 222 2 x--  26F 2 x--  25E 2 x--  26E 2 x-- }
5A7C: 0025 { 0F8 2 ---  24E 2 ---  0F8 2 x--  23D 2 --- }
5A7D: 0025 { 0F8 2 x--  24E 2 ---  21C 2 ---  23D 2 --- }
5A7E: 0025 { 0F8 2 ---  23D 2 x--  0F8 2 x--  24E 2 x-- }
5A7F: ~
5A80: 0130 { 196 2 ---  1A6 2 ---  1BE 2 x--  1CE 2 x-- }
5A81: 0130 { 266 5 ---  276 5 ---  267 5 ---  277 5 --- }
5A82: 0130 { 268 5 ---  278 5 ---  269 5 ---  279 5 --- }
5A83: 0130 { 250 3 ---  260 3 ---  251 3 ---  261 3 --- }
5A84: 0025 { 258 3 ---  258 3 -y-  258 3 x--  258 3 xy- }
5A85: 0025 { 228 3 ---  238 3 ---  229 3 ---  239 3 --- }
5A86: 0025 { 1AA 4 ---  1BA 4 ---  1AB 4 ---  1BB 4 --- }
5A87: 0020 { 1AC 4 ---  1BC 4 ---  1AD 4 ---  1BD 4 --- }
5A88: 0025 { 252 2 ---  262 2 ---  253 2 ---  263 2 --- }
5A89: 0025 { 252 2 ---  262 2 ---  253 2 ---  263 2 --- }
5A8A: 0025 { 253 2 x--  263 2 x--  252 2 x--  262 2 x-- }
5A8B: 0025 { 253 2 x--  263 2 x--  252 2 x--  262 2 x-- }
5A8C: 0025 { 23E 2 ---  24E 2 ---  23F 2 ---  24F 2 --- }
5A8D: 0025 { 21C 2 x--  23D 2 ---  0F8 2 ---  24E 2 x-- }
5A8E: 0025 { 23F 2 x--  24F 2 ---  23E 2 x--  24E 2 x-- }
5A8F: 0025 { 24E 2 x--  23D 2 x--  0F8 2 x--  24E 2 x-- }
5A90: 0130 { 1B6 2 ---  1C6 2 ---  1DE 2 x--  1EE 2 x-- }
5A91: 0130 { 200 5 ---  210 5 ---  201 5 ---  211 5 --- }
5A92: 0130 { 202 5 ---  212 5 ---  203 5 ---  213 5 --- }
5A93: 0130 { 0F8 2 ---  0F8 2 ---  0F8 2 ---  0F8 2 --- }
5A94: 0025 { 21C 2 x--  22C 2 x--  0F8 2 ---  0F8 2 --- }
5A95: 0025 { 0F8 2 x--  0F8 2 x--  21C 2 ---  22C 2 --- }
5A96: 0025 { 21C 2 ---  22C 2 ---  21D 2 ---  22D 2 --- }
5A97: 0025 { 21D 2 x--  22D 2 x--  21C 2 x--  22C 2 x-- }
5A98: 0106 { 20C 2 ---  0F8 2 ---  20D 2 ---  0F8 2 --- }
5A99: 0106 { 20F 2 ---  0F8 2 ---  20E 2 ---  0F8 2 --- }
5A9A: 0025 { 0F8 2 ---  21C 2 x--  0F8 2 ---  0F8 2 --- }
5A9B: 0025 { 0F8 2 ---  24E 2 xy-  0F8 2 ---  0F8 2 --- }
5A9C: ~
5A9D: ~
5A9E: ~
5A9F: 0025 { 0F8 2 ---  24E 2 ---  24E 2 ---  23D 2 --- }
5AA0: 0130 { 181 2 ---  182 2 ---  1F2 2 ---  183 2 --- }
5AA1: 0130 { 180 2 ---  184 2 ---  181 2 ---  185 2 --- }
5AA2: 0130 { 1F2 2 ---  186 2 ---  180 2 ---  187 2 --- }
5AA3: 0130 { 181 2 ---  187 2 x--  1F2 2 ---  186 2 --- }
5AA4: 0130 { 180 2 ---  185 2 ---  181 2 ---  186 2 --- }
5AA5: 0130 { 1F2 2 ---  185 2 ---  180 2 ---  182 2 x-- }
5AA6: 0130 { 19E 2 ---  1AE 2 ---  180 2 ---  186 2 --- }
5AA7: 0130 { 180 2 x--  186 2 x--  19E 2 x--  1AE 2 x-- }
5AA8: 0130 { 180 2 ---  190 2 ---  181 2 ---  191 2 --- }
5AA9: 0130 { 1F2 2 ---  191 2 x--  180 2 ---  190 2 x-- }
5AAA: 0025 { 27E 2 ---  27C 2 ---  27E 2 x--  27D 2 --- }
5AAB: 0025 { 25E 2 ---  26E 2 ---  25F 2 ---  26F 2 --- }
5AAC: 0130 { 1F2 2 ---  182 2 ---  1E4 2 ---  1F4 2 --- }
5AAD: 0130 { 1E4 2 x--  1F4 2 x--  1F2 2 x--  182 2 x-- }
5AAE: 0130 { 1F2 2 ---  185 2 ---  1E4 2 ---  1F4 2 --- }
5AAF: ~
5AB0: 0130 { 192 2 ---  1A2 2 ---  193 2 ---  1A3 2 --- }
5AB1: 0130 { 194 2 ---  1A4 2 ---  195 2 ---  1A5 2 --- }
5AB2: 0130 { 196 2 ---  1A6 2 ---  197 2 ---  1A7 2 --- }
5AB3: 0130 { 198 2 ---  1A8 2 ---  196 2 x--  1A6 2 x-- }
5AB4: 0130 { 195 2 x--  1A5 2 x--  194 2 x--  1A4 2 x-- }
5AB5: 0130 { 193 2 x--  1A3 2 x--  192 2 x--  1A2 2 x-- }
5AB6: 0130 { 1BE 2 ---  1CE 2 ---  196 2 x--  1A6 2 x-- }
5AB7: 0130 { 196 2 ---  1A6 2 ---  1BE 2 x--  1CE 2 x-- }
5AB8: 0130 { 1A0 2 ---  1B0 2 ---  1A1 2 ---  1B1 2 --- }
5AB9: 0130 { 1A1 2 x--  1B1 2 x--  1A0 2 x--  1B0 2 x-- }
5ABA: 0025 { 252 2 ---  262 2 ---  253 2 ---  263 2 --- }
5ABB: 0025 { 252 2 ---  262 2 ---  253 2 ---  263 2 --- }
5ABC: 0130 { 192 2 ---  1A2 2 ---  1E5 2 ---  1F5 2 --- }
5ABD: 0130 { 1E5 2 x--  1F5 2 x--  192 2 x--  1A2 2 x-- }
5ABE: 0130 { 193 2 x--  1A3 2 x--  1E5 2 ---  1F5 2 --- }
5ABF: ~
5AC0: 0130 { 1B2 2 ---  1C2 2 ---  1B3 2 ---  1C3 2 --- }
5AC1: 0130 { 1B4 2 ---  1C4 2 ---  1B5 2 ---  1C5 2 --- }
5AC2: 0130 { 1B6 2 ---  1C6 2 ---  1B7 2 ---  1C7 2 --- }
5AC3: 0130 { 1B8 2 ---  1C8 2 ---  1B6 2 x--  1C6 2 x-- }
5AC4: 0130 { 1B5 2 x--  1C5 2 x--  1B4 2 x--  1D8 2 --- }
5AC5: 0130 { 1B3 2 x--  1D9 2 ---  1B2 2 x--  1C2 2 x-- }
5AC6: 0130 { 1DE 2 ---  1EE 2 ---  1B6 2 x--  1C6 2 x-- }
5AC7: 0130 { 1B6 2 ---  1C6 2 ---  1DE 2 x--  1EE 2 x-- }
5AC8: 0130 { 1C0 2 ---  1D0 2 ---  1C1 2 ---  1D1 2 --- }
5AC9: 0130 { 1C1 2 x--  1D1 2 x--  1C0 2 x--  1D0 2 x-- }
5ACA: 0025 { 25F 2 x--  26F 2 x--  25E 2 x--  26E 2 x-- }
5ACB: 0025 { 27E 2 ---  27D 2 x--  27E 2 x--  27C 2 x-- }
5ACC: 0130 { 1B2 2 ---  1C2 2 ---  1E6 2 ---  1F6 2 --- }
5ACD: 0130 { 1E6 2 x--  1F6 2 x--  1B2 2 x--  1C2 2 x-- }
5ACE: 0130 { 1B3 2 x--  1D9 2 ---  1E6 2 ---  1F6 2 --- }
5ACF: ~
5AD0: 0130 { 1D2 2 ---  1E2 2 ---  1D3 2 ---  1E3 2 --- }
5AD1: 0025 { 1D4 2 ---  0F8 2 ---  1D5 2 ---  0F8 2 --- }
5AD2: 0025 { 0F8 2 ---  0F8 2 ---  0F8 2 ---  0F8 2 --- }
5AD3: 0025 { 0F8 2 ---  0F8 2 ---  0F8 2 ---  0F8 2 --- }
5AD4: 0025 { 1D5 2 x--  0F8 2 x--  1D4 2 x--  0F8 2 x-- }
5AD5: 0130 { 1E9 2 ---  1E3 2 x--  1D2 2 x--  1E2 2 x-- }
5AD6: 0130 { 204 2 ---  214 2 ---  205 2 ---  215 2 --- }
5AD7: 0124 { 1CA 6 ---  1DA 6 ---  1CB 6 ---  1DB 6 --- }
5AD8: 0130 { 1E0 2 ---  1F0 2 ---  1E1 2 ---  1F1 2 --- }
5AD9: 0130 { 1E1 2 x--  1F1 2 x--  1E0 2 x--  1F0 2 x-- }
5ADA: 0025 { 253 2 x--  263 2 x--  252 2 x--  262 2 x-- }
5ADB: 0025 { 253 2 x--  263 2 x--  252 2 x--  262 2 x-- }
5ADC: 0130 { 1D2 2 ---  1E2 2 ---  1E7 2 ---  1F7 2 --- }
5ADD: 0130 { 1E7 2 x--  1F7 2 x--  1D2 2 x--  1E2 2 x-- }
5ADE: 0130 { 1E9 2 ---  1E3 2 x--  1E7 2 ---  1F7 2 --- }
5ADF: ~
5AE0: 0025 { 140 7 --p  0B0 7 --p  141 7 --p  0B1 7 --p }
5AE1: 016B { 1CA 6 ---  1DA 6 ---  1CB 6 ---  1DB 6 --- }
5AE2: 0025 { 247 3 x--  257 3 x--  246 3 x--  249 3 x-- }
5AE3: 0025 { 144 2 ---  154 2 ---  145 2 ---  159 2 --- }
5AE4: 0025 { 145 2 x--  15A 2 ---  144 2 x--  154 2 x-- }
5AE5: 002B { 1EA 6 ---  1FA 6 ---  1EB 6 ---  1FB 6 --- }
5AE6: ~
5AE7: ~
5AE8: 0025 { 188 2 ---  18F 2 ---  189 2 ---  18F 2 --- }
5AE9: 0025 { 189 2 x--  18F 2 x--  188 2 x--  18F 2 x-- }
5AEA: ~
5AEB: ~
5AEC: ~
5AED: ~
5AEE: ~
5AEF: ~
5AF0: 0025 { 160 7 --p  170 7 --p  163 7 --p  173 7 --p }
5AF1: 0025 { 164 7 --p  174 7 --p  0F8 2 --p  0F8 2 --p }
5AF2: 0025 { 229 3 x--  239 3 x--  228 3 x--  238 3 x-- }
5AF3: 0025 { 168 2 ---  178 2 ---  169 2 ---  179 2 --- }
5AF4: 0025 { 16A 2 ---  17A 2 ---  16B 2 ---  17B 2 --- }
5AF5: 0025 { 0F8 2 ---  0F8 2 ---  142 2 ---  152 2 --- }
5AF6: 0025 { 143 2 ---  153 2 ---  0F8 2 ---  0F8 2 --- }
5AF7: ~
5AF8: 0025 { 19F 2 ---  18F 2 ---  1AF 2 ---  18F 2 --- }
5AF9: 0025 { 18F 2 x--  1AF 2 ---  18F 2 x--  18F 2 x-- }
5AFA: ~
5AFB: ~
5AFC: ~
5AFD: ~
5AFE: ~
5AFF: ~
