2200: 0049 { 208 2 ---  218 2 ---  209 2 ---  219 2 --- }
2201: 0049 { 209 2 x--  219 2 x--  208 2 x--  218 2 x-- }
2202: 020C { 000 1 ---  010 1 ---  001 1 ---  011 1 --- }
2203: ~
2204: ~
2205: 0025 { 0F8 1 --p  0F8 1 --p  2BD 3 ---  2CD 3 --- }
2206: 0025 { 2BE 3 ---  2CE 3 ---  0F8 1 --p  0F8 1 --p }
2207: 0025 { 0F8 1 x-p  0F8 1 x-p  0F8 1 x-p  08E 3 --- }
2208: 0025 { 0F8 1 x-p  08E 3 x--  0F8 1 x-p  0F8 1 x-p }
2209: 0025 { 0F8 1 --p  082 3 ---  0F8 1 --p  0F8 1 --p }
220A: 0025 { 0F8 1 --p  0AA 3 ---  0F8 1 --p  0AB 3 --- }
220B: 0025 { 0F8 1 x-p  0AB 3 x--  0F8 1 x-p  0AA 3 x-- }
220C: 0025 { 0F8 1 --p  0F8 1 --p  0F8 1 --p  0A6 3 --p }
220D: 0025 { 0F8 1 --p  0A7 3 --p  0F8 1 --p  0F8 1 --p }
220E: 0025 { 0F8 1 --p  0A0 3 --p  0F8 1 --p  0A1 3 --p }
220F: 0025 { 0F8 1 --p  0A2 3 --p  0F8 1 --p  0F8 1 --p }
2210: 0025 { 0F8 1 ---  0F8 1 ---  0F8 1 ---  0F8 1 --- }
2211: 0025 { 0F8 1 ---  102 1 ---  0F8 1 ---  103 1 --- }
2212: 0025 { 0F8 1 ---  104 1 ---  0F8 1 ---  105 1 --- }
2213: 0025 { 0F8 1 ---  106 1 ---  0F8 1 ---  107 1 --- }
2214: 0025 { 0F8 1 ---  108 1 ---  0F8 1 ---  109 1 --- }
2215: 0025 { 0F8 1 ---  10A 1 ---  0F8 1 ---  10B 1 --- }
2216: 0025 { 0F8 1 ---  10C 1 ---  0F8 1 ---  10D 1 --- }
2217: 0025 { 0F8 1 x-p  0BA 3 x--  0F8 1 x-p  0F8 1 x-p }
2218: 0025 { 0F8 1 --p  0F8 1 --p  0F8 1 --p  0BA 3 --- }
2219: 0025 { 092 3 ---  083 3 ---  093 3 ---  084 3 --- }
221A: 0025 { 094 3 ---  085 3 ---  0F8 1 --p  0F8 1 --p }
221B: 0025 { 0F8 1 --p  0F8 1 --p  0F8 1 --p  0A3 3 --p }
221C: 0025 { 0B5 3 --p  0C5 3 --p  0B6 3 --p  0C6 3 --p }
221D: 0025 { 0B7 3 --p  0C7 3 --p  096 3 --p  095 3 --p }
221E: 0025 { 0B0 3 --p  0C0 3 --p  0B1 3 --p  0C1 3 --p }
221F: 0025 { 0B2 3 --p  0C2 3 --p  0F8 1 --p  0C3 3 --p }
2220: 0025 { 110 1 ---  120 1 ---  111 1 ---  121 1 --- }
2221: 0025 { 112 1 ---  122 1 ---  113 1 ---  123 1 --- }
2222: 0025 { 114 1 ---  124 1 ---  115 1 ---  125 1 --- }
2223: 0025 { 116 1 ---  126 1 ---  117 1 ---  127 1 --- }
2224: 0025 { 118 1 ---  128 1 ---  119 1 ---  129 1 --- }
2225: 0025 { 11A 1 ---  12A 1 ---  11B 1 ---  1AD 1 --- }
2226: 0025 { 11C 1 ---  12C 1 ---  11D 1 ---  1AD 1 --- }
2227: 0025 { 11E 1 ---  1AD 1 ---  11F 1 ---  1AD 1 --- }
2228: 0025 { 154 1 ---  164 1 ---  0F8 1 ---  0F8 1 --- }
2229: 0025 { 0F8 1 --p  0F8 1 --p  0F8 1 --p  09E 3 --p }
222A: 0025 { 0F8 1 --p  09F 3 --p  0F8 1 --p  08F 3 --p }
222B: 0025 { 0F8 1 --p  0F8 1 --p  0B3 3 --p  0E4 3 --p }
222C: 0025 { 0D5 3 --p  0E5 3 --p  0D6 3 --p  0E6 3 --p }
222D: 0025 { 0A4 3 --p  0B4 3 --p  0A5 3 --p  0F8 1 --p }
222E: 0025 { 0D0 3 --p  0F3 3 --p  0D1 3 --p  0E1 3 --p }
222F: 0025 { 0D2 3 --p  0E2 3 --p  0E3 3 --p  0D7 3 --p }
2230: 0025 { 130 1 ---  140 1 ---  131 1 ---  141 1 --- }
2231: 0025 { 132 1 ---  142 1 ---  133 1 ---  143 1 --- }
2232: 0025 { 134 1 ---  270 1 ---  135 1 ---  271 1 --- }
2233: 0025 { 136 1 ---  272 1 ---  137 1 ---  273 1 --- }
2234: 0025 { 138 1 ---  274 1 ---  139 1 ---  275 1 --- }
2235: 0025 { 13A 1 ---  14A 1 ---  13B 1 ---  14B 1 --- }
2236: 0025 { 13C 1 ---  14C 1 ---  13D 1 ---  14D 1 --- }
2237: 0025 { 13E 1 ---  14E 1 ---  13F 1 ---  14F 1 --- }
2238: 0025 { 174 1 ---  146 1 ---  0F8 1 ---  0F8 1 --- }
2239: 0025 { 0F8 1 --p  0F8 1 --p  08B 3 --p  09B 3 --p }
223A: 0025 { 08C 3 --p  09C 3 --p  08D 3 --p  09D 3 --p }
223B: 0025 { 0F8 1 ---  0E8 3 ---  0BE 3 ---  0E9 3 --- }
223C: 0025 { 086 3 ---  00E 3 ---  0F8 1 ---  0F8 1 --- }
223D: 020C { 1AD 1 ---  1AD 1 ---  1AD 1 ---  1AD 1 --- }
223E: 0025 { 0F0 3 --p  0F4 3 --p  0F1 3 --p  0F5 3 --p }
223F: 0025 { 0F2 3 --p  0F6 3 --p  0E7 3 --p  0F7 3 --p }
2240: 0025 { 150 1 ---  160 1 ---  151 1 ---  161 1 --- }
2241: 0025 { 152 1 ---  162 1 ---  153 1 ---  163 1 --- }
2242: 0025 { 276 1 ---  27A 1 ---  277 1 ---  27B 1 --- }
2243: 0025 { 000 1 ---  010 1 ---  001 1 ---  011 1 --- }
2244: 0025 { 278 1 ---  27C 1 ---  279 1 ---  27D 1 --- }
2245: 0025 { 15A 1 ---  16A 1 ---  1AD 1 ---  16B 1 --- }
2246: 0025 { 15C 1 ---  16C 1 ---  15D 1 ---  16D 1 --- }
2247: 0025 { 15E 1 ---  16E 1 ---  15F 1 ---  16F 1 --- }
2248: 0025 { 156 1 ---  166 1 ---  0F8 1 ---  0F8 1 --- }
2249: 0025 { 087 3 --p  097 3 --p  088 3 --p  098 3 --p }
224A: 0025 { 089 3 --p  099 3 --p  08A 3 --p  09A 3 --p }
224B: 0025 { 0DE 3 ---  0EE 3 ---  0DF 3 ---  0EF 3 --- }
224C: 0025 { 01E 3 ---  00F 3 ---  0F8 1 ---  0F8 1 --- }
224D: 0130 { 2A0 2 ---  004 2 ---  2A1 2 ---  004 2 --- }
224E: 0130 { 2A2 2 ---  004 2 ---  28B 2 ---  29B 2 --- }
224F: 0130 { 28C 2 ---  29C 2 ---  28D 2 ---  29D 2 --- }
2250: 0025 { 170 1 ---  180 1 ---  171 1 ---  181 1 --- }
2251: 0025 { 172 1 ---  182 1 ---  173 1 ---  183 1 --- }
2252: 0025 { 27E 1 ---  143 1 ---  27F 1 ---  259 1 --- }
2253: 0025 { 255 1 ---  25A 1 ---  256 1 ---  25B 1 --- }
2254: 0025 { 257 1 ---  25C 1 ---  258 1 ---  143 1 --- }
2255: 0025 { 17A 1 ---  18A 1 ---  17B 1 ---  18B 1 --- }
2256: 0025 { 17C 1 ---  18C 1 ---  17D 1 ---  18D 1 --- }
2257: 0025 { 17E 1 ---  18E 1 ---  17F 1 ---  18F 1 --- }
2258: 0025 { 176 1 ---  145 1 ---  0F8 1 ---  0F8 1 --- }
2259: 0025 { 0F8 1 x--  0F8 1 x--  086 3 x--  00E 3 x-- }
225A: 0025 { 0BE 3 x--  0E9 3 x--  0F8 1 x--  0E8 3 x-- }
225B: ~
225C: ~
225D: 0130 { 004 2 ---  2D0 2 ---  004 2 ---  2D1 2 --- }
225E: 0130 { 004 2 ---  004 2 ---  004 2 ---  004 2 --- }
225F: 0130 { 28E 2 ---  29E 2 ---  28F 2 ---  29F 2 --- }
2260: 0025 { 190 1 ---  1A0 1 ---  191 1 ---  1A1 1 --- }
2261: 0025 { 192 1 ---  1A2 1 ---  193 1 ---  1A3 1 --- }
2262: 0106 { 194 1 ---  1A4 1 ---  195 1 ---  1A5 1 --- }
2263: 0106 { 196 1 ---  1A6 1 ---  197 1 ---  1A7 1 --- }
2264: 0106 { 198 1 ---  1A8 1 ---  199 1 ---  1A9 1 --- }
2265: 0025 { 19A 1 ---  1AA 1 ---  19B 1 ---  1AB 1 --- }
2266: 0025 { 19C 1 ---  1AC 1 ---  19D 1 ---  1AD 1 --- }
2267: 0025 { 19E 1 ---  1AE 1 ---  19F 1 ---  1AF 1 --- }
2268: 0025 { 155 1 ---  165 1 ---  0F8 1 ---  0F8 1 --- }
2269: 0025 { 0F8 1 x--  0F8 1 x--  01E 3 x--  00F 3 x-- }
226A: 0025 { 0DF 3 x--  0EF 3 x--  0DE 3 x--  0EE 3 x-- }
226B: ~
226C: 0025 { 004 4 ---  004 4 ---  004 4 ---  004 4 --- }
226D: 0130 { 2E0 2 ---  2F0 2 ---  2E1 2 ---  2F1 2 --- }
226E: 0130 { 004 2 ---  004 2 ---  2DD 2 ---  2ED 2 --- }
226F: 0130 { 2DE 2 ---  2EE 2 ---  2DF 2 ---  2EF 2 --- }
2270: 0025 { 1B0 1 ---  1C0 1 ---  1B1 1 ---  1C1 1 --- }
2271: 0106 { 1B2 1 ---  1C2 1 ---  1B3 1 ---  1C3 1 --- }
2272: 0106 { 1B4 1 ---  1C4 1 ---  1B5 1 ---  1C5 1 --- }
2273: 0106 { 1B6 1 ---  1C6 1 ---  1B7 1 ---  1C7 1 --- }
2274: 0106 { 1B8 1 ---  1C8 1 ---  1B9 1 ---  1C9 1 --- }
2275: 0106 { 1BA 1 ---  1CA 1 ---  1BB 1 ---  1CB 1 --- }
2276: 0025 { 1BC 1 ---  1CC 1 ---  1BD 1 ---  1CD 1 --- }
2277: 0025 { 1BE 1 ---  1CE 1 ---  1BF 1 ---  1CF 1 --- }
2278: 0025 { 175 1 ---  148 1 ---  0F8 1 ---  0F8 1 --- }
2279: 0025 { 0F8 1 x-p  004 3 --p  0F8 1 x-p  005 3 --p }
227A: 0025 { 0F8 1 x-p  006 3 --p  0F8 1 x-p  007 3 --p }
227B: 0025 { 0F8 1 x-p  008 3 --p  0F8 1 x-p  0F8 1 --p }
227C: 0025 { 0F8 1 --p  0F8 1 x-p  0F8 1 --p  008 3 x-p }
227D: 0025 { 0F8 1 --p  007 3 x-p  0F8 1 --p  006 3 x-p }
227E: 0025 { 0F8 1 --p  005 3 x-p  0F8 1 --p  004 3 x-p }
227F: ~
2280: 0025 { 1D0 1 ---  1E0 1 ---  1D1 1 ---  1E1 1 --- }
2281: 0025 { 1D2 1 ---  1E2 1 ---  1D3 1 ---  1E3 1 --- }
2282: 0025 { 1D4 1 ---  1E4 1 ---  1D5 1 ---  1E5 1 --- }
2283: 0025 { 1D6 1 ---  1E6 1 ---  1D7 1 ---  1E7 1 --- }
2284: 0025 { 1D8 1 ---  1E8 1 ---  1D9 1 ---  1E9 1 --- }
2285: 0025 { 1DA 1 ---  1EA 1 ---  1DB 1 ---  1EB 1 --- }
2286: 0025 { 1DC 1 ---  1EC 1 ---  1DD 1 ---  1ED 1 --- }
2287: 0025 { 1DE 1 ---  1EE 1 ---  1DF 1 ---  1EF 1 --- }
2288: 0025 { 158 1 ---  168 1 ---  0F8 1 ---  169 1 --- }
2289: 0130 { 014 3 --p  024 3 --p  015 3 --p  025 3 --p }
228A: 0130 { 016 3 --p  026 3 --p  017 3 --p  027 3 --p }
228B: 0130 { 018 3 --p  1AD 1 ---  265 1 --p  1AD 1 --- }
228C: 0130 { 265 1 x-p  1AD 1 ---  018 3 x-p  1AD 1 --- }
228D: 0130 { 017 3 x-p  027 3 x-p  016 3 x-p  026 3 x-p }
228E: 0130 { 015 3 x-p  025 3 x-p  014 3 x-p  024 3 x-p }
228F: ~
2290: 0025 { 1F0 1 ---  200 1 ---  1F1 1 ---  201 1 --- }
2291: 0025 { 1F2 1 ---  202 1 ---  1F3 1 ---  203 1 --- }
2292: 0025 { 1F4 1 ---  204 1 ---  1F5 1 ---  205 1 --- }
2293: 0025 { 1F6 1 ---  206 1 ---  1F7 1 ---  207 1 --- }
2294: 0025 { 1F8 1 ---  208 1 ---  1F9 1 ---  209 1 --- }
2295: 0025 { 1FA 1 ---  20A 1 ---  1FB 1 ---  20B 1 --- }
2296: 0025 { 1FC 1 ---  20C 1 ---  1FD 1 ---  20D 1 --- }
2297: 0025 { 1FE 1 ---  20E 1 ---  1FF 1 ---  20F 1 --- }
2298: 0025 { 178 1 ---  101 1 ---  179 1 ---  10E 1 --- }
2299: 0130 { 034 3 ---  009 3 ---  035 3 ---  00A 3 --- }
229A: 0130 { 036 3 ---  00B 3 ---  037 3 ---  00C 3 --- }
229B: 0130 { 1AD 1 ---  1AD 1 ---  1AD 1 ---  1AD 1 --- }
229C: 0130 { 1AD 1 ---  1AD 1 ---  1AD 1 ---  1AD 1 --- }
229D: 0130 { 037 3 x--  00C 3 x--  036 3 x--  00B 3 x-- }
229E: 0130 { 035 3 x--  00A 3 x--  034 3 x--  009 3 x-- }
229F: ~
22A0: 0025 { 210 1 ---  220 1 ---  211 1 ---  221 1 --- }
22A1: 0106 { 212 1 ---  222 1 ---  213 1 ---  223 1 --- }
22A2: 0106 { 214 1 ---  224 1 ---  215 1 ---  225 1 --- }
22A3: 0106 { 216 1 ---  226 1 ---  217 1 ---  227 1 --- }
22A4: 0106 { 218 1 ---  228 1 ---  219 1 ---  229 1 --- }
22A5: 0106 { 21A 1 ---  22A 1 ---  21B 1 ---  22B 1 --- }
22A6: 0106 { 21C 1 ---  22C 1 ---  21D 1 ---  22D 1 --- }
22A7: 0106 { 21E 1 ---  22E 1 ---  21F 1 ---  22F 1 --- }
22A8: 0025 { 149 1 ---  12B 1 ---  0F8 1 ---  12D 1 --- }
22A9: 0130 { 019 3 ---  1AD 1 ---  01A 3 ---  1AD 1 --- }
22AA: 0130 { 01B 3 ---  1AD 1 ---  01C 3 ---  1AD 1 --- }
22AB: 0130 { 1AD 1 --p  1AD 1 --p  1AD 1 --p  1AD 1 --p }
22AC: 0130 { 1AD 1 ---  1AD 1 ---  1AD 1 ---  1AD 1 --- }
22AD: 0130 { 01C 3 x--  1AD 1 ---  01B 3 x--  1AD 1 --- }
22AE: 0130 { 01A 3 x--  1AD 1 ---  019 3 x--  1AD 1 --- }
22AF: ~
22B0: 0025 { 230 1 ---  240 1 ---  231 1 ---  241 1 --- }
22B1: 0025 { 232 1 ---  242 1 ---  233 1 ---  243 1 --- }
22B2: 0025 { 234 1 ---  244 1 ---  235 1 ---  245 1 --- }
22B3: 0025 { 236 1 ---  246 1 ---  237 1 ---  247 1 --- }
22B4: 0025 { 238 1 ---  248 1 ---  239 1 ---  249 1 --- }
22B5: 0025 { 23A 1 ---  24A 1 ---  23B 1 ---  24B 1 --- }
22B6: 0025 { 23C 1 ---  24C 1 ---  23D 1 ---  24D 1 --- }
22B7: 0025 { 23E 1 ---  24E 1 ---  23F 1 ---  24F 1 --- }
22B8: 0025 { 12A 1 ---  12F 1 ---  12E 1 ---  15B 1 --- }
22B9: 0025 { 0F8 1 x-p  028 3 --p  0F8 1 x-p  029 3 --p }
22BA: ~
22BB: 0130 { 004 4 x--  004 4 x--  004 4 x--  004 4 x-- }
22BC: 0025 { 0F8 1 --p  029 3 x-p  0F8 1 --p  028 3 x-p }
22BD: 0025 { 2B5 3 x--  2B7 3 x--  2B4 3 x--  2B6 3 x-- }
22BE: 0025 { 2C1 3 x--  2C3 3 x--  2C0 3 x--  2C2 3 x-- }
22BF: 0025 { 2B1 3 x--  2B3 3 x--  2B0 3 x--  2B2 3 x-- }
22C0: 0130 { 260 1 ---  1AD 1 ---  261 1 ---  1AD 1 --- }
22C1: 0130 { 262 1 ---  1AD 1 ---  263 1 ---  1AD 1 --- }
22C2: 0130 { 264 1 ---  1AD 1 ---  265 1 ---  1AD 1 --- }
22C3: 0130 { 266 1 ---  1AD 1 ---  267 1 ---  1AD 1 --- }
22C4: 0130 { 268 1 ---  1AD 1 ---  269 1 ---  1AD 1 --- }
22C5: 0130 { 26A 1 ---  1AD 1 ---  26B 1 ---  1AD 1 --- }
22C6: 0130 { 26C 1 ---  1AD 1 ---  26D 1 ---  1AD 1 --- }
22C7: 0130 { 26E 1 ---  1AD 1 ---  26F 1 ---  1AD 1 --- }
22C8: ~
22C9: 0130 { 038 3 --p  02A 3 --p  039 3 --p  02B 3 --p }
22CA: ~
22CB: 0130 { 004 4 x--  004 4 x--  004 4 x--  004 4 x-- }
22CC: 0130 { 039 3 x-p  02B 3 x-p  038 3 x-p  02A 3 x-p }
22CD: 0025 { 2C5 3 x--  2C7 3 x--  2C4 3 x--  2C6 3 x-- }
22CE: 0025 { 2C3 3 xy-  2C1 3 xy-  2C2 3 xy-  2C0 3 xy- }
22CF: 0025 { 2B3 3 xy-  2B1 3 xy-  2B2 3 xy-  2B0 3 xy- }
22D0: 0130 { 1AD 1 ---  1AD 1 ---  1AD 1 ---  1AD 1 --- }
22D1: 0130 { 263 1 ---  1AD 1 ---  26E 1 x--  1AD 1 --- }
22D2: 0130 { 26A 1 --p  1AD 1 ---  26B 1 --p  1AD 1 --- }
22D3: 0130 { 263 1 --p  1AD 1 ---  26E 1 x-p  1AD 1 --- }
22D4: 0130 { 26E 1 --p  1AD 1 ---  26F 1 --p  1AD 1 --- }
22D5: 0025 { 2B0 3 ---  2B2 3 ---  2B1 3 ---  2B3 3 --- }
22D6: 0025 { 2C0 3 ---  2C2 3 ---  2C1 3 ---  2C3 3 --- }
22D7: 0025 { 2B4 3 ---  2B6 3 ---  2B5 3 ---  2B7 3 --- }
22D8: ~
22D9: 0130 { 03A 3 ---  00D 3 ---  03B 3 ---  01D 3 --- }
22DA: 0130 { 1AD 1 ---  1AD 1 ---  1AD 1 ---  1AD 1 --- }
22DB: 0130 { 1AD 1 ---  1AD 1 ---  1AD 1 ---  1AD 1 --- }
22DC: 0130 { 03B 3 x--  01D 3 x--  03A 3 x--  00D 3 x-- }
22DD: 0025 { 2B0 3 ---  2B2 3 ---  2B1 3 ---  2B3 3 --- }
22DE: 0025 { 2C0 3 ---  2C2 3 ---  2C1 3 ---  2C3 3 --- }
22DF: 0025 { 2B4 3 ---  2B6 3 ---  2B5 3 ---  2B7 3 --- }
22E0: 0025 { 02E 3 ---  03E 3 ---  02F 3 ---  03F 3 --- }
22E1: 0025 { 02C 3 ---  03C 3 ---  185 3 ---  03D 3 --- }
22E2: 0025 { 0F8 1 ---  0F8 1 ---  0F8 1 ---  184 3 --- }
22E3: ~
22E4: ~
22E5: 0025 { 2B2 3 -y-  2B0 3 -y-  2B3 3 -y-  2B1 3 -y- }
22E6: 0025 { 2C2 3 -y-  2C0 3 -y-  2C3 3 -y-  2C1 3 -y- }
22E7: 0025 { 2C4 3 ---  2C6 3 ---  2C5 3 ---  2C7 3 --- }
22E8: ~
22E9: 0130 { 1AD 1 ---  1AD 1 ---  02D 3 ---  1AD 1 --- }
22EA: ~
22EB: 0130 { 004 4 x--  004 4 x--  004 4 x--  004 4 x-- }
22EC: 0130 { 02D 3 x--  1AD 1 ---  1AD 1 ---  1AD 1 --- }
22ED: 0025 { 2B2 3 -y-  2B0 3 -y-  2B3 3 -y-  2B1 3 -y- }
22EE: 0025 { 2C2 3 -y-  2C0 3 -y-  2C3 3 -y-  2C1 3 -y- }
22EF: 0025 { 2C4 3 ---  2C6 3 ---  2C5 3 ---  2C7 3 --- }
22F0: 0025 { 030 3 ---  186 3 ---  031 3 ---  187 3 --- }
22F1: 0025 { 032 3 ---  189 3 ---  033 3 ---  254 3 --- }
22F2: ~
22F3: ~
22F4: ~
22F5: ~
22F6: ~
22F7: ~
22F8: ~
22F9: ~
22FA: ~
22FB: ~
22FC: 0025 { 004 4 ---  004 4 ---  004 4 ---  004 4 --- }
22FD: ~
22FE: ~
22FF: ~
