0300: 0130 { 000 7 ---  010 7 ---  001 7 ---  011 7 --- }
0301: 0130 { 002 7 ---  012 7 ---  003 7 ---  013 7 --- }
0302: 0130 { 004 7 ---  014 7 ---  005 7 ---  015 7 --- }
0303: 0130 { 004 7 ---  014 7 ---  005 7 ---  015 7 --- }
0304: 0130 { 000 5 ---  010 5 ---  001 5 ---  011 5 --- }
0305: 0130 { 002 5 ---  012 5 ---  003 5 ---  013 5 --- }
0306: 0130 { 000 5 ---  010 5 ---  001 5 ---  011 5 --- }
0307: 0130 { 002 5 ---  012 5 ---  003 5 ---  013 5 --- }
0308: 0130 { 004 5 ---  014 5 ---  005 5 ---  015 5 --- }
0309: 0130 { 004 5 ---  014 5 ---  005 5 ---  015 5 --- }
030A: 0130 { 004 5 ---  014 5 ---  005 5 ---  015 5 --- }
030B: 0130 { 004 5 ---  014 5 ---  005 5 ---  015 5 --- }
030C: 0130 { 020 7 ---  020 7 ---  293 3 -y-  292 3 -y- }
030D: 0130 { 293 3 xy-  292 3 xy-  023 7 ---  023 7 --- }
030E: 0130 { 020 7 ---  020 7 ---  292 3 ---  293 3 --- }
030F: 0130 { 292 3 x--  293 3 x--  023 7 ---  023 7 --- }
0310: 0130 { 000 7 ---  010 7 ---  001 7 ---  011 7 --- }
0311: 0130 { 002 7 ---  012 7 ---  003 7 ---  013 7 --- }
0312: 0130 { 024 7 ---  034 7 ---  025 7 ---  035 7 --- }
0313: 0130 { 024 7 ---  034 7 ---  025 7 ---  035 7 --- }
0314: 0130 { 000 5 ---  010 5 ---  001 5 ---  011 5 --- }
0315: 0130 { 002 5 ---  012 5 ---  003 5 ---  013 5 --- }
0316: 0130 { 000 5 ---  010 5 ---  001 5 ---  011 5 --- }
0317: 0130 { 002 5 ---  012 5 ---  003 5 ---  013 5 --- }
0318: 0130 { 024 5 ---  034 5 ---  025 5 ---  035 5 --- }
0319: 0130 { 024 5 ---  034 5 ---  025 5 ---  035 5 --- }
031A: 0130 { 024 5 ---  034 5 ---  025 5 ---  035 5 --- }
031B: 0130 { 024 5 ---  034 5 ---  025 5 ---  035 5 --- }
031C: 0130 { 020 7 ---  020 7 ---  291 3 x--  291 3 xy- }
031D: 0130 { 290 3 x--  290 3 xy-  023 7 ---  023 7 --- }
031E: 0130 { 020 7 ---  020 7 ---  290 3 ---  290 3 -y- }
031F: 0130 { 291 3 ---  291 3 -y-  023 7 ---  023 7 --- }
0320: 0130 { 1F4 7 ---  1F6 7 ---  1F5 7 ---  1F7 7 --- }
0321: 0130 { 1FA 7 ---  1FD 7 ---  1FB 7 ---  1FE 7 --- }
0322: 0130 { 1FB 7 x--  1FE 7 x--  1FA 7 x--  1FD 7 x-- }
0323: ~
0324: 0130 { 1F4 5 ---  1F6 5 ---  1F5 5 ---  1F7 5 --- }
0325: 0130 { 1F4 5 ---  1F6 5 ---  1F5 5 ---  1F7 5 --- }
0326: 0130 { 1FA 5 ---  1FD 5 ---  1FB 5 ---  1FE 5 --- }
0327: 0130 { 1FB 5 x--  1FE 5 x--  1FA 5 x--  1FD 5 x-- }
0328: 0130 { 020 5 ---  020 5 ---  293 3 -y-  292 3 -y- }
0329: 0130 { 293 3 xy-  292 3 xy-  023 5 ---  023 5 --- }
032A: 0130 { 020 5 ---  020 5 ---  292 3 ---  293 3 --- }
032B: 0130 { 292 3 x--  293 3 x--  023 5 ---  023 5 --- }
032C: 0130 { 02E 7 ---  293 3 -y-  02E 7 ---  293 3 xy- }
032D: 0130 { 02E 7 ---  292 3 ---  02E 7 ---  292 3 x-- }
032E: 0130 { 02E 7 ---  291 3 x--  02E 7 ---  290 3 x-- }
032F: 0130 { 02E 7 ---  290 3 ---  02E 7 ---  291 3 --- }
0330: 0130 { 1F6 7 -y-  1F4 7 -y-  1F7 7 -y-  1F5 7 -y- }
0331: ~
0332: ~
0333: ~
0334: 0130 { 1F6 5 -y-  1F4 5 -y-  1F7 5 -y-  1F5 5 -y- }
0335: 0130 { 1F6 5 -y-  1F4 5 -y-  1F7 5 -y-  1F5 5 -y- }
0336: 0130 { 1FA 5 ---  1FD 5 ---  1FB 5 ---  1FE 5 --- }
0337: 0130 { 1FB 5 x--  1FE 5 x--  1FA 5 x--  1FD 5 x-- }
0338: 0130 { 020 5 ---  020 5 ---  291 3 x--  291 3 xy- }
0339: 0130 { 290 3 x--  290 3 xy-  023 5 ---  023 5 --- }
033A: 0130 { 020 5 ---  020 5 ---  290 3 ---  290 3 -y- }
033B: 0130 { 291 3 ---  291 3 -y-  023 5 ---  023 5 --- }
033C: 0130 { 292 3 -y-  03F 7 ---  292 3 xy-  03F 7 --- }
033D: 0130 { 293 3 ---  03F 7 ---  293 3 x--  03F 7 --- }
033E: 0130 { 291 3 xy-  03F 7 ---  290 3 xy-  03F 7 --- }
033F: 0130 { 290 3 -y-  03F 7 ---  291 3 -y-  03F 7 --- }
0340: 0130 { 020 7 ---  020 7 ---  021 7 ---  021 7 --- }
0341: 0130 { 022 7 ---  022 7 ---  023 7 ---  023 7 --- }
0342: 0130 { 02E 7 ---  03E 7 ---  02E 7 ---  03E 7 --- }
0343: 0130 { 02E 5 ---  03E 5 ---  02E 5 ---  03E 5 --- }
0344: 0130 { 1F8 7 ---  1F8 7 ---  1F9 7 ---  1F9 7 --- }
0345: 0130 { 1F8 5 ---  1F8 5 ---  1F9 5 ---  1F9 5 --- }
0346: 0130 { 293 3 -y-  292 3 -y-  293 3 xy-  292 3 xy- }
0347: 0130 { 292 3 ---  293 3 ---  292 3 x--  293 3 x-- }
0348: 0130 { 02E 5 ---  293 3 -y-  02E 5 ---  293 3 xy- }
0349: 0130 { 02E 5 ---  292 3 ---  02E 5 ---  292 3 x-- }
034A: 0130 { 02E 5 ---  291 3 x--  02E 5 ---  290 3 x-- }
034B: 0130 { 02E 5 ---  290 3 ---  02E 5 ---  291 3 --- }
034C: 0025 { 2A8 7 ---  2A8 7 ---  2A6 3 -y-  2A5 3 -y- }
034D: 0025 { 2A6 3 xy-  2A5 3 xy-  2AB 7 ---  2AB 7 --- }
034E: 0025 { 2A8 7 ---  2A8 7 ---  2A5 3 ---  2A6 3 --- }
034F: 0025 { 2A5 3 x--  2A6 3 x--  2AB 7 ---  2AB 7 --- }
0350: 0130 { 020 5 ---  020 5 ---  021 5 ---  021 5 --- }
0351: 0130 { 022 5 ---  022 5 ---  023 5 ---  023 5 --- }
0352: 0130 { 02F 7 ---  03F 7 ---  02F 7 ---  03F 7 --- }
0353: 0130 { 02F 5 ---  03F 5 ---  02F 5 ---  03F 5 --- }
0354: 0130 { 1FC 7 ---  1FF 7 ---  1FC 7 ---  1FF 7 --- }
0355: 0130 { 1FC 5 ---  1FF 5 ---  1FC 5 ---  1FF 5 --- }
0356: 0130 { 291 3 x--  291 3 xy-  290 3 x--  290 3 xy- }
0357: 0130 { 290 3 ---  290 3 -y-  291 3 ---  291 3 -y- }
0358: 0130 { 292 3 -y-  03F 5 ---  292 3 xy-  03F 5 --- }
0359: 0130 { 293 3 ---  03F 5 ---  293 3 x--  03F 5 --- }
035A: 0130 { 291 3 xy-  03F 5 ---  290 3 xy-  03F 5 --- }
035B: 0130 { 290 3 -y-  03F 5 ---  291 3 -y-  03F 5 --- }
035C: 0025 { 2A8 7 ---  2A8 7 ---  296 3 x--  296 3 xy- }
035D: 0025 { 295 3 x--  295 3 xy-  2AB 7 ---  2AB 7 --- }
035E: 0025 { 2A8 7 ---  2A8 7 ---  295 3 ---  295 3 -y- }
035F: 0025 { 296 3 ---  296 3 -y-  2AB 7 ---  2AB 7 --- }
0360: 0130 { 283 6 ---  282 6 ---  281 6 ---  0FE 6 --- }
0361: 0130 { 281 6 ---  0FE 6 ---  280 6 x--  282 6 x-- }
0362: 0130 { 280 6 ---  282 6 ---  281 6 x--  0FE 6 x-- }
0363: 0130 { 281 6 x--  0FE 6 x--  283 6 x--  282 6 x-- }
0364: 0130 { 280 3 ---  282 3 ---  281 3 ---  0FE 3 --- }
0365: 0130 { 281 3 ---  0FE 3 ---  280 3 x--  282 3 x-- }
0366: ~
0367: ~
0368: 0025 { 2A8 5 ---  2A8 5 ---  2A6 3 -y-  2A5 3 -y- }
0369: 0025 { 2A6 3 xy-  2A5 3 xy-  2AB 5 ---  2AB 5 --- }
036A: 0025 { 2A8 5 ---  2A8 5 ---  2A5 3 ---  2A6 3 --- }
036B: 0025 { 2A5 3 x--  2A6 3 x--  2AB 5 ---  2AB 5 --- }
036C: 0025 { 28E 7 ---  2A6 3 -y-  28E 7 ---  2A6 3 xy- }
036D: 0025 { 28E 7 ---  2A5 3 ---  28E 7 ---  2A5 3 x-- }
036E: 0025 { 28E 7 ---  296 3 x--  28E 7 ---  295 3 x-- }
036F: 0025 { 28E 7 ---  295 3 ---  28E 7 ---  296 3 --- }
0370: 0130 { 282 6 ---  280 6 -y-  0FE 6 ---  281 6 -y- }
0371: 0130 { 0FE 6 ---  281 6 -y-  282 6 x--  280 6 xy- }
0372: 0130 { 282 6 ---  280 6 -y-  0FE 6 x--  281 6 xy- }
0373: 0130 { 0FE 6 x--  281 6 xy-  282 6 x--  280 6 xy- }
0374: 0130 { 282 3 ---  280 3 -y-  0FE 3 ---  281 3 -y- }
0375: 0130 { 0FE 3 ---  281 3 -y-  282 3 x--  280 3 xy- }
0376: ~
0377: ~
0378: 0025 { 2A8 5 ---  2A8 5 ---  296 3 x--  296 3 xy- }
0379: 0025 { 295 3 x--  295 3 xy-  2AB 5 ---  2AB 5 --- }
037A: 0025 { 2A8 5 ---  2A8 5 ---  295 3 ---  295 3 -y- }
037B: 0025 { 296 3 ---  296 3 -y-  2AB 5 ---  2AB 5 --- }
037C: 0025 { 2A5 3 -y-  2BE 7 ---  2A5 3 xy-  2BE 7 --- }
037D: 0025 { 2A6 3 ---  2BE 7 ---  2A6 3 x--  2BE 7 --- }
037E: 0025 { 296 3 xy-  2BE 7 ---  295 3 xy-  2BE 7 --- }
037F: 0025 { 295 3 -y-  2BE 7 ---  296 3 -y-  2BE 7 --- }
0380: 0130 { 280 6 ---  282 6 -y-  281 6 ---  0FE 6 -y- }
0381: 0130 { 281 6 ---  0FE 6 -y-  280 6 x--  282 6 xy- }
0382: 0130 { 280 6 ---  282 6 -y-  281 6 x--  0FE 6 xy- }
0383: 0130 { 281 6 x--  0FE 6 xy-  280 6 x--  282 6 xy- }
0384: 0130 { 280 3 ---  280 3 -y-  280 3 x--  280 3 xy- }
0385: ~
0386: ~
0387: ~
0388: 0025 { 28E 5 ---  2A6 3 -y-  28E 5 ---  2A6 3 xy- }
0389: 0025 { 28E 5 ---  2A5 3 ---  28E 5 ---  2A5 3 x-- }
038A: 0025 { 28E 5 ---  296 3 x--  28E 5 ---  295 3 x-- }
038B: 0025 { 28E 5 ---  295 3 ---  28E 5 ---  296 3 --- }
038C: 0025 { 2A6 3 -y-  2A5 3 -y-  2A6 3 xy-  2A5 3 xy- }
038D: 0025 { 2A5 3 ---  2A6 3 ---  2A5 3 x--  2A6 3 x-- }
038E: 0025 { 284 3 ---  286 3 ---  285 3 ---  294 3 --- }
038F: 0025 { 285 3 ---  294 3 ---  284 3 x--  286 3 x-- }
0390: 0130 { 282 6 -y-  283 6 -y-  0FE 6 -y-  281 6 -y- }
0391: 0130 { 0FE 6 -y-  281 6 -y-  282 6 xy-  280 6 xy- }
0392: 0130 { 282 6 -y-  280 6 -y-  0FE 6 xy-  281 6 xy- }
0393: 0130 { 0FE 6 xy-  281 6 xy-  282 6 xy-  283 6 xy- }
0394: 0130 { 1FA 7 ---  1FD 7 ---  1FB 7 ---  1FE 7 --- }
0395: 0130 { 1FB 7 x--  1FE 7 x--  1FA 7 x--  1FD 7 x-- }
0396: 0130 { 1FA 5 ---  1FD 5 ---  1FB 5 ---  1FE 5 --- }
0397: 0130 { 1FB 5 x--  1FE 5 x--  1FA 5 x--  1FD 5 x-- }
0398: 0025 { 2A5 3 -y-  2BE 5 ---  2A5 3 xy-  2BE 5 --- }
0399: 0025 { 2A6 3 ---  2BE 5 ---  2A6 3 x--  2BE 5 --- }
039A: 0025 { 296 3 xy-  2BE 5 ---  295 3 xy-  2BE 5 --- }
039B: 0025 { 295 3 -y-  2BE 5 ---  296 3 -y-  2BE 5 --- }
039C: 0025 { 296 3 x--  296 3 xy-  295 3 x--  295 3 xy- }
039D: 0025 { 295 3 ---  295 3 -y-  296 3 ---  296 3 -y- }
039E: 0025 { 286 3 ---  284 3 -y-  294 3 ---  285 3 -y- }
039F: 0025 { 294 3 ---  285 3 -y-  286 3 x--  284 3 xy- }
03A0: 0130 { 283 6 ---  280 6 -y-  280 6 x--  280 6 xy- }
03A1: 0130 { 280 6 ---  280 6 -y-  283 6 x--  280 6 xy- }
03A2: 0130 { 280 6 ---  280 6 -y-  280 6 x--  280 6 xy- }
03A3: ~
03A4: 0130 { 004 7 ---  014 7 ---  005 7 ---  015 7 --- }
03A5: 0130 { 004 7 ---  014 7 ---  005 7 ---  015 7 --- }
03A6: 0130 { 004 5 ---  014 5 ---  005 5 ---  015 5 --- }
03A7: 0130 { 004 5 ---  014 5 ---  005 5 ---  015 5 --- }
03A8: 0130 { 1F4 7 ---  1F6 7 ---  1F5 7 ---  1F7 7 --- }
03A9: 0130 { 1FA 5 ---  1FD 5 ---  1FB 5 ---  1FE 5 --- }
03AA: 0130 { 1FB 5 x--  1FE 5 x--  1FA 5 x--  1FD 5 x-- }
03AB: 0130 { 1F4 5 ---  1F6 5 ---  1F5 5 ---  1F7 5 --- }
03AC: 0025 { 004 4 ---  004 4 ---  004 4 ---  004 4 --- }
03AD: 0025 { 284 3 ---  284 3 -y-  284 3 x--  284 3 xy- }
03AE: 0025 { 287 6 ---  284 6 -y-  284 6 x--  284 6 xy- }
03AF: 0025 { 284 6 ---  284 6 -y-  287 6 x--  284 6 xy- }
03B0: 0130 { 280 6 ---  283 6 -y-  280 6 x--  280 6 xy- }
03B1: 0130 { 280 6 ---  280 6 -y-  280 6 x--  283 6 xy- }
03B2: ~
03B3: ~
03B4: 0130 { 024 7 ---  034 7 ---  025 7 ---  035 7 --- }
03B5: 0130 { 024 7 ---  034 7 ---  025 7 ---  035 7 --- }
03B6: 0130 { 024 5 ---  034 5 ---  025 5 ---  035 5 --- }
03B7: 0130 { 024 5 ---  034 5 ---  025 5 ---  035 5 --- }
03B8: 0130 { 1F6 7 -y-  1F4 7 -y-  1F7 7 -y-  1F5 7 -y- }
03B9: 0130 { 1FA 7 ---  1FD 7 ---  1FB 7 ---  1FE 7 --- }
03BA: 0130 { 1FB 7 x--  1FE 7 x--  1FA 7 x--  1FD 7 x-- }
03BB: 0130 { 1F6 5 -y-  1F4 5 -y-  1F7 5 -y-  1F5 5 -y- }
03BC: ~
03BD: 0025 { 284 6 ---  284 6 -y-  284 6 x--  284 6 xy- }
03BE: 0025 { 284 6 ---  287 6 -y-  284 6 x--  284 6 xy- }
03BF: 0025 { 284 6 ---  284 6 -y-  284 6 x--  287 6 xy- }
03C0: ~
03C1: ~
03C2: ~
03C3: ~
03C4: 0130 { 000 7 ---  010 7 ---  001 7 ---  011 7 --- }
03C5: 0130 { 002 7 ---  012 7 ---  003 7 ---  013 7 --- }
03C6: 0130 { 000 5 ---  010 5 ---  001 5 ---  011 5 --- }
03C7: 0130 { 002 5 ---  012 5 ---  003 5 ---  013 5 --- }
03C8: 0130 { 004 7 ---  014 7 ---  005 7 ---  015 7 --- }
03C9: 0130 { 004 7 ---  014 7 ---  005 7 ---  015 7 --- }
03CA: 0130 { 004 5 ---  014 5 ---  005 5 ---  015 5 --- }
03CB: 0130 { 004 5 ---  014 5 ---  005 5 ---  015 5 --- }
03CC: 0025 { 287 6 ---  286 6 ---  285 6 x--  294 6 x-- }
03CD: 0025 { 285 6 x--  294 6 x--  284 6 x--  286 6 x-- }
03CE: 0025 { 284 6 ---  286 6 ---  285 6 ---  294 6 --- }
03CF: 0025 { 285 6 ---  294 6 ---  287 6 x--  286 6 x-- }
03D0: ~
03D1: ~
03D2: ~
03D3: ~
03D4: 0130 { 000 7 ---  010 7 ---  001 7 ---  011 7 --- }
03D5: 0130 { 002 7 ---  012 7 ---  003 7 ---  013 7 --- }
03D6: 0130 { 000 5 ---  010 5 ---  001 5 ---  011 5 --- }
03D7: 0130 { 002 5 ---  012 5 ---  003 5 ---  013 5 --- }
03D8: 0130 { 024 7 ---  034 7 ---  025 7 ---  035 7 --- }
03D9: 0130 { 024 7 ---  034 7 ---  025 7 ---  035 7 --- }
03DA: 0130 { 024 5 ---  034 5 ---  025 5 ---  035 5 --- }
03DB: 0130 { 024 5 ---  034 5 ---  025 5 ---  035 5 --- }
03DC: 0025 { 286 6 ---  284 6 -y-  294 6 x--  285 6 xy- }
03DD: 0025 { 294 6 x--  285 6 xy-  286 6 x--  284 6 xy- }
03DE: 0025 { 286 6 ---  284 6 -y-  294 6 ---  285 6 -y- }
03DF: 0025 { 294 6 ---  285 6 -y-  286 6 x--  284 6 xy- }
03E0: 0025 { 288 5 ---  298 5 ---  289 5 ---  299 5 --- }
03E1: 0025 { 28A 5 ---  29A 5 ---  28B 5 ---  29B 5 --- }
03E2: 0025 { 28C 5 ---  29C 5 ---  28D 5 ---  29D 5 --- }
03E3: 0025 { 28C 5 ---  29C 5 ---  28D 5 ---  29D 5 --- }
03E4: 0025 { 2A0 5 ---  2B0 5 ---  2A1 5 ---  2B1 5 --- }
03E5: 0025 { 2A8 5 ---  2A8 5 ---  2A9 5 ---  2A9 5 --- }
03E6: 0025 { 2AA 5 ---  2AA 5 ---  2AB 5 ---  2AB 5 --- }
03E7: 0025 { 28E 5 ---  29E 5 ---  28E 5 ---  29E 5 --- }
03E8: 0025 { 2A8 7 ---  2A8 7 ---  2A9 7 ---  2A9 7 --- }
03E9: 0025 { 2AA 7 ---  2AA 7 ---  2AB 7 ---  2AB 7 --- }
03EA: 0025 { 28E 7 ---  29E 7 ---  28E 7 ---  29E 7 --- }
03EB: 0025 { 2C0 7 ---  2C0 7 ---  2C1 7 ---  2C1 7 --- }
03EC: 0025 { 284 6 ---  286 6 -y-  285 6 x--  294 6 xy- }
03ED: 0025 { 285 6 x--  294 6 xy-  284 6 x--  286 6 xy- }
03EE: 0025 { 284 6 ---  286 6 -y-  285 6 ---  294 6 -y- }
03EF: 0025 { 285 6 ---  294 6 -y-  284 6 x--  286 6 xy- }
03F0: 0025 { 288 5 ---  298 5 ---  289 5 ---  299 5 --- }
03F1: 0025 { 28A 5 ---  29A 5 ---  28B 5 ---  29B 5 --- }
03F2: 0025 { 2AC 5 ---  2BC 5 ---  2AD 5 ---  2BD 5 --- }
03F3: 0025 { 2AC 5 ---  2BC 5 ---  2AD 5 ---  2BD 5 --- }
03F4: 0025 { 2B0 5 -y-  2A0 5 -y-  2B1 5 -y-  2A1 5 -y- }
03F5: 0025 { 2A2 5 ---  2B2 5 ---  2A3 5 ---  2B3 5 --- }
03F6: 0025 { 2A3 5 x--  2B3 5 x--  2A2 5 x--  2B2 5 x-- }
03F7: 0025 { 2AE 5 ---  2BE 5 ---  2AE 5 ---  2BE 5 --- }
03F8: 0025 { 2C0 5 ---  2C0 5 ---  2C1 5 ---  2C1 5 --- }
03F9: 0025 { 2A4 5 ---  2B4 5 ---  2A4 5 ---  2B4 5 --- }
03FA: 0025 { 2AE 7 ---  2BE 7 ---  2AE 7 ---  2BE 7 --- }
03FB: 0025 { 2A4 7 ---  2B4 7 ---  2A4 7 ---  2B4 7 --- }
03FC: 0025 { 286 6 -y-  287 6 -y-  294 6 xy-  285 6 xy- }
03FD: 0025 { 294 6 xy-  285 6 xy-  286 6 xy-  284 6 xy- }
03FE: 0025 { 286 6 -y-  284 6 -y-  294 6 -y-  285 6 -y- }
03FF: 0025 { 294 6 -y-  285 6 -y-  286 6 xy-  287 6 xy- }
