3300: 0025 { 0F8 3 ---  0F8 3 ---  0F8 3 ---  0F8 3 --- }
3301: 0025 { 0F8 3 ---  0F8 3 ---  0F8 3 ---  0F8 3 --- }
3302: ~
3303: ~
3304: 3300 { 0F8 3 ---  169 6 x--  0F8 3 ---  169 6 x-- }
3305: 0025 { 0F8 3 ---  169 6 x--  0F8 3 ---  169 6 x-- }
3306: ~
3307: ~
3308: 0025 { 201 6 ---  207 6 ---  202 6 ---  208 6 --- }
3309: 0025 { 203 6 ---  209 6 ---  204 6 ---  209 6 --- }
330A: 0025 { 205 6 ---  208 6 x--  206 6 ---  208 6 --- }
330B: 0025 { 203 6 ---  20A 6 ---  204 6 ---  20A 6 x-- }
330C: 0025 { 203 6 ---  209 6 ---  204 6 ---  209 6 --- }
330D: 0025 { 205 6 ---  208 6 x--  206 6 ---  208 6 --- }
330E: 0025 { 203 6 ---  20A 6 ---  204 6 ---  20A 6 x-- }
330F: 0025 { 202 6 x--  208 6 x--  201 6 x--  207 6 x-- }
3310: 0130 { 160 2 --p  170 2 --p  161 2 --p  171 2 --p }
3311: 0130 { 166 3 ---  176 3 ---  167 3 ---  177 3 --- }
3312: 0025 { 160 2 --p  170 2 --p  161 2 --p  171 2 --p }
3313: 0025 { 15C 7 ---  16C 7 ---  15D 7 ---  16D 7 --- }
3314: 0130 { 16A 6 ---  17A 6 ---  16B 6 ---  17B 6 --- }
3315: 0105 { 179 3 x--  0F8 3 ---  179 3 x--  0F8 3 --- }
3316: 0025 { 14E 2 ---  15E 2 ---  14F 2 ---  15F 2 --- }
3317: 3301 { 14E 2 ---  15E 2 ---  14F 2 ---  15F 2 --- }
3318: 0025 { 20B 6 ---  211 6 ---  20C 6 ---  212 6 --- }
3319: 0025 { 20D 6 ---  213 6 ---  20E 6 ---  214 6 --- }
331A: 0025 { 20F 6 ---  215 6 ---  20C 6 ---  212 6 --- }
331B: 0025 { 210 6 ---  212 6 x--  210 6 x--  215 6 x-- }
331C: 0025 { 20F 6 ---  215 6 ---  20C 6 ---  212 6 --- }
331D: 0025 { 20D 6 ---  213 6 ---  20E 6 ---  214 6 --- }
331E: 0025 { 210 6 ---  215 6 ---  210 6 x--  212 6 --- }
331F: 0025 { 20C 6 x--  212 6 x--  20B 6 x--  211 6 x-- }
3320: 0130 { 162 2 --p  172 2 --p  163 2 --p  173 2 --p }
3321: 0130 { 164 7 ---  174 7 ---  165 7 ---  175 7 --- }
3322: 0025 { 162 2 --p  172 2 --p  163 2 --p  173 2 --p }
3323: 0025 { 16C 7 ---  16C 7 ---  16D 7 ---  16D 7 --- }
3324: 0130 { 16E 2 ---  17E 2 ---  16F 2 ---  17F 2 --- }
3325: 0025 { 146 3 ---  156 3 ---  147 3 ---  157 3 --- }
3326: ~
3327: ~
3328: 0025 { 200 5 ---  200 5 ---  216 5 ---  218 5 --- }
3329: 0025 { 217 5 ---  219 5 ---  200 5 ---  200 5 --- }
332A: 0025 { 200 5 ---  200 5 ---  216 5 ---  218 5 --- }
332B: 0025 { 217 5 ---  219 5 ---  200 5 ---  200 5 --- }
332C: 0025 { 200 5 ---  200 5 ---  216 5 ---  218 5 --- }
332D: 0025 { 217 5 ---  219 5 ---  200 5 ---  200 5 --- }
332E: 0025 { 200 5 ---  200 5 ---  216 5 ---  218 5 --- }
332F: 0025 { 217 5 ---  219 5 ---  200 5 ---  200 5 --- }
3330: ~
3331: ~
3332: ~
3333: 0025 { 16C 7 ---  17C 7 ---  16D 7 ---  17D 7 --- }
3334: ~
3335: ~
3336: ~
3337: ~
3338: 0025 { 200 5 ---  200 5 ---  21A 5 ---  21C 5 --- }
3339: 0025 { 21B 5 ---  21D 5 ---  200 5 ---  200 5 --- }
333A: 0025 { 200 5 ---  200 5 ---  218 5 ---  21A 5 --- }
333B: 0025 { 219 5 ---  21B 5 ---  200 5 ---  200 5 --- }
333C: 0025 { 200 5 ---  200 5 ---  21A 5 ---  21C 5 --- }
333D: 0025 { 21B 5 ---  21D 5 ---  200 5 ---  200 5 --- }
333E: 0025 { 200 5 ---  200 5 ---  218 5 ---  21A 5 --- }
333F: 0025 { 219 5 ---  21B 5 ---  200 5 ---  200 5 --- }
3340: 0002 { 1C6 7 ---  1D6 7 ---  1C7 7 ---  1D7 7 --- }
3341: 0002 { 1C4 7 --p  0FC 7 --p  1C5 7 --p  0FC 7 --p }
3342: 0002 { 1C4 1 --p  0FC 1 --p  1C5 1 --p  0FC 1 --p }
3343: 0130 { 1C4 1 --p  0FC 1 --p  1C5 1 --p  0FC 1 --p }
3344: 012F { 1C2 6 ---  1D2 6 ---  1C3 6 ---  1D3 6 --- }
3345: ~
3346: 0200 { 0F8 3 ---  0F8 3 ---  0F8 3 ---  0F8 3 --- }
3347: 0002 { 1C4 7 --p  0FC 7 --p  1C5 1 --p  0FC 1 --p }
3348: 0002 { 1C4 1 --p  0FC 1 --p  1C4 7 --p  0FC 7 --p }
3349: ~
334A: ~
334B: ~
334C: ~
334D: ~
334E: ~
334F: ~
3350: 0002 { 1E6 7 ---  1D6 7 ---  1E7 7 ---  1D7 7 --- }
3351: 0002 { 0FC 7 --p  0FC 7 --p  0FC 7 --p  0FC 7 --p }
3352: 0002 { 0FC 1 --p  0FC 1 --p  0FC 1 --p  0FC 1 --p }
3353: 0130 { 0FC 1 --p  0FC 1 --p  0FC 1 --p  0FC 1 --p }
3354: 012F { 1D2 6 -y-  1C2 6 -y-  1D3 6 -y-  1C3 6 -y- }
3355: 0025 { 0F8 3 ---  1D4 3 ---  0F8 3 ---  1D5 3 --- }
3356: 020B { 0F8 3 ---  0F8 3 ---  0F8 3 ---  0F8 3 --- }
3357: 0002 { 0FC 7 --p  0FC 7 --p  0FC 1 --p  0FC 1 --p }
3358: 0002 { 0FC 1 --p  0FC 1 --p  0FC 7 --p  0FC 7 --p }
3359: ~
335A: ~
335B: ~
335C: ~
335D: ~
335E: ~
335F: ~
3360: 0130 { 1C6 1 --p  1D6 1 --p  1C7 1 --p  1D7 1 --p }
3361: 0025 { 1C6 1 --p  1D6 1 --p  1C7 1 --p  1D7 1 --p }
3362: 01E4 { 1C4 1 --p  0FC 1 --p  1C5 1 --p  0FC 1 --p }
3363: 0100 { 1C4 1 --p  0FC 1 --p  1C5 1 --p  0FC 1 --p }
3364: ~
3365: ~
3366: ~
3367: ~
3368: 0025 { 200 5 ---  200 5 ---  218 5 ---  21A 5 --- }
3369: 0025 { 219 5 ---  21B 5 ---  200 5 ---  200 5 --- }
336A: 0025 { 200 5 ---  200 5 ---  218 5 ---  21A 5 --- }
336B: 0025 { 219 5 ---  21B 5 ---  200 5 ---  200 5 --- }
336C: 0025 { 200 5 ---  200 5 ---  21A 5 ---  21C 5 --- }
336D: 0025 { 21B 5 ---  21D 5 ---  200 5 ---  200 5 --- }
336E: 0025 { 200 5 ---  200 5 ---  21A 5 ---  21C 5 --- }
336F: 0025 { 21B 5 ---  21D 5 ---  200 5 ---  200 5 --- }
3370: 0130 { 1E6 1 --p  1D6 1 --p  1E7 1 --p  1D7 1 --p }
3371: 0025 { 1E6 1 --p  1D6 1 --p  1E7 1 --p  1D7 1 --p }
3372: 0135 { 020 5 ---  020 5 ---  021 5 ---  021 5 --- }
3373: 0136 { 022 5 ---  022 5 ---  023 5 ---  023 5 --- }
3374: 0025 { 21D 1 ---  21D 1 ---  21D 1 ---  208 1 --- }
3375: 0025 { 21D 1 ---  20D 1 ---  21D 1 ---  20B 1 --- }
3376: 0025 { 21D 1 ---  219 1 ---  21D 1 ---  20C 1 --- }
3377: 0025 { 21D 1 ---  218 1 ---  21D 1 ---  21D 1 --- }
3378: 0025 { 21D 1 ---  209 1 ---  21D 1 ---  20E 1 --- }
3379: 0025 { 21D 1 ---  20A 1 x--  21D 1 ---  21D 1 --- }
337A: ~
337B: ~
337C: ~
337D: ~
337E: ~
337F: ~
3380: 0066 { 0F8 7 ---  00E 7 ---  0F8 7 ---  00F 7 --- }
3381: 0067 { 0F8 7 ---  08C 7 ---  0F8 7 ---  00B 7 --- }
3382: 0067 { 0F8 7 x--  00B 7 x--  0F8 7 x--  08C 7 x-- }
3383: 0066 { 0F8 7 x--  00F 7 x--  0F8 7 x--  00E 7 x-- }
3384: 0025 { 21D 1 ---  21D 1 ---  208 1 ---  20E 1 --- }
3385: 0025 { 209 1 ---  20F 1 ---  20A 1 ---  21D 1 --- }
3386: 0025 { 20B 1 ---  218 1 ---  21D 1 ---  20C 1 --- }
3387: 0025 { 208 1 ---  21C 1 ---  20D 1 ---  209 1 --- }
3388: 0025 { 20E 1 ---  219 1 ---  20E 1 ---  21A 1 --- }
3389: 0025 { 21B 1 ---  20F 1 ---  21D 1 ---  20E 1 --- }
338A: ~
338B: ~
338C: ~
338D: ~
338E: ~
338F: ~
3390: 0068 { 01E 7 ---  093 5 ---  01F 7 ---  0D5 7 --- }
3391: 0069 { 09C 7 ---  0F8 7 ---  0F8 7 ---  094 5 --- }
3392: 0069 { 0F8 7 x--  094 5 x--  09C 7 x--  0F8 7 x-- }
3393: 0068 { 01F 7 x--  0D5 7 x--  01E 7 x--  093 5 x-- }
3394: ~
3395: ~
3396: ~
3397: ~
3398: ~
3399: ~
339A: ~
339B: ~
339C: 0025 { 0F8 2 -y-  1D1 2 x--  1D1 2 x--  193 2 --- }
339D: 0025 { 1D1 2 ---  193 2 ---  0F8 2 -y-  1D1 2 --- }
339E: ~
339F: ~
33A0: 0025 { 0F8 5 ---  0B2 5 ---  0B0 5 ---  0B3 5 --- }
33A1: 0025 { 0B0 5 ---  0B4 5 ---  0B0 5 ---  0B3 5 --- }
33A2: 0025 { 0B1 5 ---  0B4 5 ---  0F8 5 ---  0B5 5 --- }
33A3: 0025 { 08A 0 ---  08A 0 ---  08A 0 x--  08A 0 x-- }
33A4: ~
33A5: ~
33A6: ~
33A7: ~
33A8: ~
33A9: ~
33AA: ~
33AB: ~
33AC: 0025 { 1D1 2 xy-  0F8 2 ---  193 2 ---  1D1 2 xy- }
33AD: 0025 { 193 2 ---  1D1 2 -y-  1D1 2 -y-  0F8 2 --- }
33AE: ~
33AF: ~
33B0: 0130 { 182 3 ---  192 3 ---  183 3 ---  193 3 --- }
33B1: 0130 { 180 5 ---  190 5 ---  181 5 ---  191 5 --- }
33B2: 012F { 200 7 ---  210 7 ---  201 7 ---  211 7 --- }
33B3: 012F { 202 7 ---  212 7 ---  203 7 ---  213 7 --- }
33B4: 012F { 204 7 ---  214 7 ---  205 7 ---  215 7 --- }
33B5: 012F { 206 7 ---  216 7 ---  207 7 ---  217 7 --- }
33B6: 0130 { 182 0 ---  192 0 ---  183 0 ---  193 0 --- }
33B7: 012F { 058 7 ---  05A 7 ---  059 7 ---  05B 7 --- }
33B8: 0106 { 00D 6 ---  0F8 2 ---  00D 6 ---  075 4 --- }
33B9: ~
33BA: 0106 { 00D 6 ---  075 7 --p  00D 6 ---  0F8 2 --- }
33BB: ~
33BC: 0025 { 1D1 2 xy-  0F8 2 ---  1D1 2 -y-  0F8 2 --- }
33BD: ~
33BE: ~
33BF: ~
33C0: ~
33C1: ~
33C2: ~
33C3: ~
33C4: ~
33C5: ~
33C6: ~
33C7: 0025 { 207 3 x--  217 3 x--  206 3 x--  216 3 x-- }
33C8: 0025 { 205 3 x--  215 3 x--  204 3 x--  214 3 x-- }
33C9: 0025 { 203 7 x--  213 7 x--  202 7 x--  212 7 x-- }
33CA: 0025 { 201 7 x--  211 7 x--  200 7 x--  210 7 x-- }
33CB: ~
33CC: ~
33CD: ~
33CE: ~
33CF: ~
33D0: 0107 { 180 3 ---  1EA 3 ---  181 3 ---  1EB 3 --- }
33D1: 0108 { 181 3 x--  1EB 3 x--  181 3 ---  1EB 3 --- }
33D2: 0109 { 181 3 x--  1EB 3 x--  180 3 x--  1EA 3 x-- }
33D3: 0137 { 184 7 xy-  182 7 xy-  185 7 xy-  182 7 --- }
33D4: 0138 { 184 7 xy-  182 7 xy-  185 7 xy-  182 7 --- }
33D5: ~
33D6: ~
33D7: 0025 { 227 3 x--  237 3 x--  226 3 x--  236 3 x-- }
33D8: 0025 { 225 3 x--  235 3 x--  224 3 x--  234 3 x-- }
33D9: 0025 { 223 7 x--  233 7 x--  222 7 x--  232 7 x-- }
33DA: 0025 { 221 7 x--  231 7 x--  220 7 x--  230 7 x-- }
33DB: ~
33DC: ~
33DD: ~
33DE: ~
33DF: ~
33E0: ~
33E1: ~
33E2: ~
33E3: ~
33E4: ~
33E5: ~
33E6: ~
33E7: 0025 { 247 3 x--  257 3 x--  246 3 x--  256 3 x-- }
33E8: 0025 { 245 3 x--  255 3 x--  244 3 x--  254 3 x-- }
33E9: 0025 { 243 7 x--  253 7 x--  242 7 x--  252 7 x-- }
33EA: 0025 { 241 7 x--  251 7 x--  240 7 x--  250 7 x-- }
33EB: 0025 { 248 5 ---  258 5 ---  249 5 ---  259 5 --- }
33EC: 0025 { 24A 5 ---  25A 5 ---  24B 5 ---  25B 5 --- }
33ED: ~
33EE: ~
33EF: ~
33F0: ~
33F1: ~
33F2: ~
33F3: ~
33F4: ~
33F5: ~
33F6: ~
33F7: 0025 { 267 3 x--  277 3 x--  266 3 x--  276 3 x-- }
33F8: 0025 { 265 3 x--  275 3 x--  264 3 x--  274 3 x-- }
33F9: 0025 { 263 7 x--  273 7 x--  262 7 x--  272 7 x-- }
33FA: 0025 { 261 7 x--  271 7 x--  260 7 x--  270 7 x-- }
33FB: 0025 { 268 5 ---  278 5 ---  269 5 ---  279 5 --- }
33FC: 0025 { 26A 5 ---  27A 5 ---  26B 5 ---  27B 5 --- }
33FD: ~
33FE: ~
33FF: ~
