6500: 19FF { 0A0 2 ---  0A2 2 ---  0A0 2 ---  0A2 2 --- }
6501: 19FF { 0A0 2 ---  0A2 2 ---  0A0 2 ---  0A2 2 --- }
6502: 19FF { 0A0 2 ---  0A2 2 ---  0A1 2 ---  0A2 2 --- }
6503: 19FF { 0A1 2 x--  0A2 2 ---  0A0 2 ---  0A2 2 --- }
6504: 19FF { 0A1 2 x--  0A2 2 ---  0A0 2 ---  0A2 2 --- }
6505: 19FF { 0A0 2 ---  0A2 2 ---  0A0 2 ---  0A2 2 --- }
6506: 19FF { 0A0 2 ---  0A0 2 ---  0A0 2 ---  0A0 2 --- }
6507: 19FF { 0A6 2 ---  0A6 2 ---  0A7 2 ---  0A7 2 --- }
6508: 0105 { 0AF 2 ---  0AF 2 ---  0AF 2 ---  0AF 2 --- }
6509: 19FF { 0F8 2 ---  0F8 2 ---  0A9 2 ---  0A9 2 --- }
650A: 19FF { 0A6 2 ---  0A6 2 ---  0A6 2 ---  0A6 2 --- }
650B: 19FF { 0AA 2 ---  0A6 2 ---  0A7 2 ---  0AB 2 --- }
650C: 19FF { 0F8 2 ---  0AC 2 ---  0F8 2 ---  0AC 2 --- }
650D: 19FF { 0F8 2 ---  0AC 2 ---  0A9 2 ---  0AD 2 --- }
650E: 19FF { 0AA 2 ---  0AE 2 ---  0AA 2 ---  0AE 2 --- }
650F: 19FF { 0B0 2 ---  0A2 2 ---  0A0 2 ---  0A2 2 --- }
6510: 19FF { 0A0 2 ---  0A2 2 ---  0A0 2 ---  0A2 2 --- }
6511: 19FF { 0A0 2 ---  0A2 2 ---  0B1 2 ---  0A2 2 --- }
6512: 19FF { 0B2 2 ---  0B4 2 ---  0B3 2 ---  0B5 2 --- }
6513: 19FF { 0B6 2 ---  0B6 2 ---  0B7 2 ---  0B7 2 --- }
6514: 19FF { 0BA 2 ---  0BC 2 ---  0BB 2 ---  0BD 2 --- }
6515: 0020 { 1B2 1 ---  1B6 1 ---  1B3 1 ---  1B7 1 --- }
6516: 0020 { 1B4 1 ---  1B8 1 ---  1B5 1 ---  1B9 1 --- }
6517: 19FF { 0A6 2 ---  0A6 2 ---  0A3 2 ---  0A7 2 --- }
6518: 19FF { 0A4 2 ---  0F8 2 ---  0A4 2 ---  0F8 2 --- }
6519: 19FF { 0A4 2 ---  0F8 2 ---  0A5 2 ---  0A9 2 --- }
651A: 19FF { 0BE 2 ---  0CE 2 ---  0BF 2 ---  0CF 2 --- }
651B: 19FF { 0BF 2 x--  0CF 2 x--  0BE 2 x--  0CE 2 x-- }
651C: 002F { 0A4 2 ---  0F8 2 ---  0A4 2 ---  074 4 --- }
651D: 0031 { 0F8 2 ---  0AC 2 ---  077 4 ---  0AC 2 --- }
651E: 0032 { 0A4 2 ---  074 7 --p  0A4 2 ---  0F8 6 --- }
651F: 0034 { 077 7 --p  0AC 2 ---  0F8 6 ---  0AC 2 --- }
6520: 0025 { 180 1 ---  18A 1 ---  181 1 ---  18B 1 --- }
6521: 0025 { 182 1 ---  18C 1 ---  183 1 ---  18D 1 --- }
6522: 0025 { 184 1 ---  18E 1 ---  185 1 ---  18F 1 --- }
6523: 0025 { 186 1 ---  190 1 ---  187 1 ---  191 1 --- }
6524: 0025 { 188 1 ---  192 1 ---  189 1 ---  193 1 --- }
6525: 0020 { 1BA 1 ---  1BE 1 ---  1BB 1 ---  1BF 1 --- }
6526: 0020 { 1BC 1 ---  1C0 1 ---  1BD 1 ---  1C1 1 --- }
6527: 0130 { 0E9 1 ---  0E9 1 ---  0E9 1 ---  0E9 1 --- }
6528: 0130 { 0B8 2 ---  0B9 2 ---  0B9 2 ---  0B8 2 --- }
6529: 0130 { 0F4 0 ---  0F4 0 ---  0F5 0 ---  0F5 0 --- }
652A: 0130 { 1CA 4 ---  1DA 4 ---  1CB 4 ---  1DB 4 --- }
652B: 0130 { 1CC 4 ---  1DC 4 ---  1CD 4 ---  1DD 4 --- }
652C: 0130 { 1CE 4 ---  1DE 4 ---  1D8 4 ---  1D9 4 --- }
652D: 0130 { 1CE 4 ---  1DE 4 ---  1CF 4 ---  1DF 4 --- }
652E: 0025 { 1D4 1 ---  1D6 1 ---  1D5 1 ---  1D7 1 --- }
652F: 0004 { 0F8 4 ---  04C 1 --p  0F8 4 ---  04D 1 --p }
6530: 0025 { 194 1 ---  19E 1 ---  195 1 ---  19F 1 --- }
6531: 0025 { 196 1 ---  1A0 1 ---  197 1 ---  1A1 1 --- }
6532: 0025 { 198 1 ---  19C 1 ---  199 1 ---  1A2 1 --- }
6533: 0025 { 19A 1 ---  1A3 1 ---  19B 1 ---  1A4 1 --- }
6534: 0025 { 19C 1 ---  19C 1 ---  19D 1 ---  1A5 1 --- }
6535: 0020 { 1C2 1 ---  1C6 1 ---  1C3 1 ---  1C7 1 --- }
6536: 0020 { 1C4 1 ---  1C8 1 ---  1C5 1 ---  1C9 1 --- }
6537: 0025 { 1E4 2 ---  1E6 2 ---  1E5 2 ---  1E7 2 --- }
6538: 0100 { 1E8 2 ---  1EA 2 ---  1E9 2 ---  1EB 2 --- }
6539: 0130 { 1EA 2 ---  1EC 2 ---  1EB 2 ---  1ED 2 --- }
653A: ~
653B: 0130 { 1A6 2 ---  1A8 2 ---  1A7 2 ---  1A9 2 --- }
653C: 0130 { 1AA 2 ---  1AC 2 ---  1AB 2 ---  1AD 2 --- }
653D: 0130 { 1AE 2 ---  1B0 2 ---  1AF 2 ---  1B1 2 --- }
653E: 0025 { 1E0 1 ---  1E2 1 ---  1E1 1 ---  1E3 1 --- }
653F: 0005 { 04E 1 --p  0FC 1 --p  04F 1 --p  0FC 1 --p }
6540: 0025 { 108 7 ---  110 7 ---  109 7 ---  111 7 --- }
6541: 0025 { 10A 7 ---  112 7 ---  109 7 ---  113 7 --- }
6542: 0025 { 109 7 ---  104 7 ---  10B 7 ---  114 7 --- }
6543: 0025 { 10C 7 ---  115 7 ---  109 7 ---  116 7 --- }
6544: 0025 { 109 7 ---  117 7 ---  109 7 ---  118 7 --- }
6545: 0025 { 10D 7 ---  119 7 ---  10E 7 ---  11A 7 --- }
6546: 0025 { 10E 7 ---  11A 7 ---  10E 7 ---  11A 7 --- }
6547: 0025 { 10F 7 ---  11B 7 ---  108 7 x--  110 7 x-- }
6548: 0025 { 163 5 ---  169 7 ---  164 7 ---  16A 7 --- }
6549: 0025 { 165 7 ---  16B 5 ---  165 7 ---  16C 5 --- }
654A: 0025 { 165 7 ---  16D 5 ---  166 5 ---  16E 5 --- }
654B: 0025 { 167 5 ---  0FE 5 ---  167 5 ---  0FE 5 --- }
654C: 0025 { 167 5 ---  0FE 5 ---  167 5 ---  16F 5 --- }
654D: 0025 { 167 5 ---  170 5 ---  167 5 ---  171 5 --- }
654E: 0025 { 167 5 ---  172 5 ---  167 5 ---  173 5 --- }
654F: 0025 { 167 5 ---  174 5 ---  168 5 ---  175 5 --- }
6550: 0025 { 110 7 ---  127 7 ---  11C 7 ---  128 7 --- }
6551: 0025 { 11D 7 ---  129 7 ---  11E 7 ---  12A 7 --- }
6552: 0025 { 104 7 ---  12B 7 ---  11F 7 ---  129 7 --- }
6553: 0025 { 120 7 ---  129 7 ---  121 7 ---  12C 7 --- }
6554: 0025 { 122 7 ---  12D 7 ---  123 5 ---  12E 5 --- }
6555: 0025 { 124 7 ---  12F 7 ---  125 7 ---  130 7 --- }
6556: 0025 { 125 7 ---  131 7 ---  125 7 ---  132 7 --- }
6557: 0025 { 126 7 ---  133 7 ---  110 7 x--  110 7 x-- }
6558: 0025 { 169 7 ---  169 7 ---  176 5 ---  180 7 --- }
6559: 0025 { 16D 5 ---  181 5 ---  2D0 7 ---  182 4 --- }
655A: 0025 { 177 5 ---  183 7 ---  16E 5 ---  16E 5 --- }
655B: 0025 { 178 5 ---  184 5 ---  179 5 ---  185 5 --- }
655C: 0025 { 17A 5 ---  186 5 ---  17B 5 ---  187 5 --- }
655D: 0025 { 17C 5 ---  0FE 5 ---  17C 5 ---  0FE 5 --- }
655E: 0025 { 17D 5 ---  188 5 ---  17E 5 ---  189 5 --- }
655F: 0025 { 17F 5 ---  18A 5 ---  175 5 ---  175 5 --- }
6560: 0025 { 134 7 ---  134 7 ---  135 7 ---  13D 7 --- }
6561: 0025 { 135 7 ---  13E 7 ---  135 7 ---  13F 7 --- }
6562: 0025 { 135 7 ---  140 7 ---  135 7 ---  141 7 --- }
6563: 0025 { 135 7 ---  142 7 ---  136 7 ---  143 7 --- }
6564: 0025 { 137 7 ---  144 7 ---  138 5 ---  145 5 --- }
6565: 0025 { 12F 7 ---  12F 7 ---  139 7 ---  146 7 --- }
6566: 0025 { 13A 7 ---  147 7 ---  13B 7 ---  148 7 --- }
6567: 0025 { 13C 7 ---  149 7 ---  110 7 x--  110 7 x-- }
6568: 0025 { 169 7 ---  197 5 ---  18B 4 ---  198 5 --- }
6569: 0025 { 18C 4 ---  199 4 ---  18D 4 ---  19A 5 --- }
656A: 0025 { 18E 4 ---  19B 5 ---  16E 5 ---  19C 5 --- }
656B: 0025 { 18F 5 ---  19D 5 ---  190 5 ---  19E 5 --- }
656C: 0025 { 191 5 ---  199 4 x--  192 5 ---  19F 5 --- }
656D: 0025 { 0FE 5 ---  0FE 5 ---  178 5 ---  0FE 5 --- }
656E: 0025 { 193 5 ---  1A0 5 ---  194 5 ---  199 4 --- }
656F: 0025 { 195 5 ---  1A1 5 ---  196 5 ---  175 5 --- }
6570: 0025 { 134 7 ---  154 7 ---  14A 7 ---  155 7 --- }
6571: 0025 { 14B 7 ---  155 7 ---  14C 7 ---  155 7 --- }
6572: 0025 { 14D 7 ---  155 7 ---  14E 7 ---  155 7 --- }
6573: 0025 { 14F 7 ---  155 7 ---  150 7 ---  156 7 --- }
6574: 0025 { 151 7 ---  157 7 ---  152 7 ---  157 7 --- }
6575: 0025 { 12F 7 ---  158 7 ---  2F1 7 ---  159 7 --- }
6576: 0025 { 2F1 7 ---  159 7 ---  2F1 7 ---  159 7 --- }
6577: 0025 { 153 7 ---  15A 7 ---  110 7 x--  15B 7 --- }
6578: 0025 { 175 5 x--  1A2 5 ---  1A0 5 ---  1A3 5 --- }
6579: 0025 { 199 4 ---  1A4 4 ---  1A1 5 ---  1A5 5 --- }
657A: 0025 { 0FE 5 ---  1A6 5 ---  0FE 5 ---  1A6 5 --- }
657B: 0025 { 19D 5 ---  1A7 5 ---  19E 5 ---  1A8 5 --- }
657C: 0025 { 199 4 x--  1A4 4 x--  19F 5 ---  1A9 5 --- }
657D: 0025 { 0FE 5 ---  1A6 5 ---  0FE 5 ---  1A6 5 --- }
657E: 0025 { 1A0 5 ---  1A3 5 ---  199 4 ---  1A4 4 --- }
657F: 0025 { 1A1 5 ---  1A5 5 ---  175 5 ---  1A2 5 x-- }
6580: 0025 { 1B2 4 ---  1BC 4 ---  1B3 7 ---  1BD 7 --- }
6581: 0025 { 1B4 7 ---  1BD 7 x--  1B5 4 ---  0A6 4 --- }
6582: 0025 { 1B6 4 ---  1BE 4 ---  1B7 4 ---  1BF 4 --- }
6583: 0025 { 1B8 4 ---  1C0 4 ---  1B5 4 ---  0A6 4 --- }
6584: 0025 { 1B5 4 ---  0A6 4 ---  1B5 4 ---  1C1 4 --- }
6585: 0025 { 1B9 4 ---  1C2 4 ---  1BA 4 ---  1C3 4 --- }
6586: 0025 { 1B5 4 ---  1C4 4 ---  1B5 4 ---  0A6 4 --- }
6587: 0025 { 1B5 4 ---  0A6 4 ---  1BB 4 ---  1C5 4 --- }
6588: 0025 { 108 4 ---  10A 4 ---  109 4 ---  10B 4 --- }
6589: 0025 { 109 4 ---  10C 4 ---  109 4 ---  10D 4 --- }
658A: 0025 { 109 4 ---  10E 4 ---  109 4 ---  10F 4 --- }
658B: 0025 { 109 4 ---  110 7 ---  109 4 ---  111 5 --- }
658C: 0025 { 109 4 ---  112 4 ---  109 4 ---  113 4 --- }
658D: 0025 { 109 4 ---  114 5 ---  109 4 ---  115 4 --- }
658E: 0025 { 109 4 ---  116 4 ---  109 4 ---  117 4 --- }
658F: 0025 { 109 4 ---  118 4 ---  108 4 x--  10A 4 x-- }
6590: 0025 { 1C6 4 ---  1C5 4 x--  1C7 7 ---  1D1 4 --- }
6591: 0025 { 1C8 7 ---  1D2 4 ---  1C9 4 ---  1D3 4 --- }
6592: 0025 { 1CA 4 ---  1D4 4 ---  1CB 4 ---  1D5 7 --- }
6593: 0025 { 1CC 4 ---  1D6 7 ---  1C9 4 ---  1D7 7 --- }
6594: 0025 { 0A6 4 ---  0A6 4 ---  1CD 4 ---  0A6 4 --- }
6595: 0025 { 1CE 4 ---  1D8 4 ---  1CF 4 ---  1D9 4 --- }
6596: 0025 { 1D0 4 ---  0A6 4 ---  0A6 4 ---  0A6 4 --- }
6597: 0025 { 0A6 4 ---  0A6 4 ---  1C5 4 ---  1C5 4 --- }
6598: 0025 { 10A 4 ---  10A 4 ---  119 4 ---  125 4 --- }
6599: 0025 { 11A 4 ---  11A 4 ---  0F9 4 ---  0F9 4 --- }
659A: 0025 { 11A 4 x--  11A 4 x--  11B 4 ---  126 4 --- }
659B: 0025 { 110 7 -y-  127 4 ---  11C 5 ---  128 4 --- }
659C: 0025 { 11D 5 ---  286 4 ---  11E 5 ---  129 4 --- }
659D: 0025 { 11F 5 ---  12A 4 ---  120 7 ---  12B 7 --- }
659E: 0025 { 121 5 ---  12C 5 ---  122 5 ---  12D 5 --- }
659F: 0025 { 123 5 ---  123 5 ---  124 7 ---  12E 7 --- }
65A0: 0025 { 1C5 4 x--  1C5 4 x--  1DA 4 ---  1E7 4 --- }
65A1: 0025 { 1DB 4 ---  1E8 4 ---  1DC 4 ---  1E9 4 --- }
65A2: 0025 { 1BE 4 -y-  1EA 4 ---  1DD 7 ---  1EB 4 --- }
65A3: 0025 { 1DE 7 ---  1EC 4 ---  1DF 7 ---  1ED 4 --- }
65A4: 0025 { 1E0 4 ---  1EE 4 ---  1E1 4 ---  1EF 4 --- }
65A5: 0025 { 1E2 4 ---  1F0 4 ---  1E3 4 ---  1F1 4 --- }
65A6: 0025 { 1E1 4 ---  1EF 4 ---  1E4 4 ---  1F2 4 --- }
65A7: 0025 { 1E5 4 ---  1F3 4 ---  1E6 4 ---  1F4 4 --- }
65A8: 0025 { 10A 4 ---  10A 4 ---  12F 4 ---  13B 4 --- }
65A9: 0025 { 11A 4 ---  13C 4 ---  0F9 4 ---  13D 4 --- }
65AA: 0025 { 11A 4 x--  13E 4 ---  130 4 ---  13F 4 --- }
65AB: 0025 { 131 4 ---  140 4 ---  132 4 ---  128 4 -y- }
65AC: 0025 { 133 4 ---  286 4 ---  134 5 ---  141 5 --- }
65AD: 0025 { 135 5 ---  142 5 ---  136 7 ---  143 5 --- }
65AE: 0025 { 137 5 ---  144 4 ---  138 5 ---  145 4 --- }
65AF: 0025 { 139 5 ---  146 5 ---  13A 7 ---  147 7 --- }
65B0: 0025 { 1C5 4 x--  1F6 4 ---  0A6 4 ---  1F7 4 --- }
65B1: 0025 { 0A6 4 ---  1F7 4 ---  0A6 4 ---  1F7 4 --- }
65B2: 0025 { 1F5 4 ---  1F8 4 ---  0A6 4 ---  1F7 4 --- }
65B3: 0025 { 0A6 4 ---  1F7 4 ---  0A6 4 ---  1F7 4 --- }
65B4: 0025 { 1EE 4 -y-  1F9 4 ---  1EF 4 -y-  1FA 4 --- }
65B5: 0025 { 1F0 4 -y-  1FB 4 ---  1F1 4 -y-  1FC 4 --- }
65B6: 0025 { 1EF 4 -y-  1FA 4 ---  1F2 4 -y-  1FD 4 --- }
65B7: 0025 { 1F3 4 -y-  1FE 4 ---  1F4 4 ---  1FF 4 --- }
65B8: 0025 { 10A 4 ---  14F 4 ---  148 4 ---  150 4 --- }
65B9: 0025 { 149 4 ---  150 4 ---  14A 4 ---  150 4 --- }
65BA: 0025 { 14B 4 ---  150 4 ---  14C 4 ---  150 4 --- }
65BB: 0025 { 286 4 ---  150 4 ---  286 4 ---  150 4 --- }
65BC: 0025 { 286 4 ---  150 4 ---  286 4 ---  150 4 --- }
65BD: 0025 { 286 4 ---  150 4 ---  286 4 ---  150 4 --- }
65BE: 0025 { 286 4 ---  150 4 ---  14D 4 ---  150 4 --- }
65BF: 0025 { 14E 4 ---  150 4 ---  10A 4 x--  14F 4 x-- }
65C0: 0025 { 15B 7 ---  162 7 ---  15C 7 ---  163 7 --- }
65C1: 0025 { 15D 7 ---  164 7 ---  15D 7 ---  2D0 7 --- }
65C2: 0025 { 15E 7 ---  165 7 ---  15D 7 ---  2D0 7 --- }
65C3: 0025 { 15D 7 ---  166 7 ---  15F 7 ---  167 7 --- }
65C4: 0025 { 160 7 ---  168 7 ---  15D 7 ---  169 7 --- }
65C5: 0025 { 15D 7 ---  2D0 7 ---  15E 7 x--  165 7 x-- }
65C6: 0025 { 15D 7 ---  2D0 7 ---  15D 7 ---  164 7 x-- }
65C7: 0025 { 161 7 ---  168 7 ---  15B 7 x--  162 7 x-- }
65C8: 0025 { 1BC 4 ---  1C9 4 ---  1BD 4 ---  1CA 4 --- }
65C9: 0025 { 1BE 4 ---  1CB 4 ---  1BF 4 ---  1CC 4 --- }
65CA: 0025 { 1C0 4 ---  1CD 4 ---  1C1 4 ---  1CE 4 --- }
65CB: 0025 { 1C2 4 ---  1CF 4 ---  1C3 4 ---  1D0 4 --- }
65CC: 0025 { 1C4 4 ---  1D0 4 ---  1C5 4 ---  1D0 4 --- }
65CD: 0025 { 1C6 4 ---  1D0 4 ---  1C7 4 ---  1D0 4 --- }
65CE: 0025 { 1C8 4 ---  1D1 4 ---  1C8 4 ---  1D2 4 --- }
65CF: 0025 { 1C8 4 ---  1D3 4 ---  1BC 4 x--  1D4 4 --- }
65D0: 0025 { 16A 7 ---  16E 4 ---  16B 7 ---  16F 4 --- }
65D1: 0025 { 16C 7 ---  16F 4 ---  2D0 7 ---  2D0 7 --- }
65D2: 0025 { 16D 7 ---  170 7 ---  2D0 7 ---  2D0 7 --- }
65D3: 0025 { 2D0 7 ---  2D0 7 ---  16C 7 x--  16F 4 --- }
65D4: 0025 { 16B 7 x--  16F 4 ---  2D0 7 ---  2D0 7 --- }
65D5: 0025 { 2D0 7 ---  2D0 7 ---  16D 7 x--  170 7 x-- }
65D6: 0025 { 2D0 7 ---  2D0 7 ---  16C 7 x--  171 4 --- }
65D7: 0025 { 16B 7 x--  172 4 ---  16A 7 x--  173 4 --- }
65D8: 0025 { 1D5 4 ---  1E4 4 ---  1D6 4 ---  1E5 4 --- }
65D9: 0025 { 1D7 4 ---  1E6 4 ---  1D8 4 ---  1B5 4 --- }
65DA: 0025 { 1D9 4 ---  1B5 4 ---  1DA 4 ---  1E7 4 --- }
65DB: 0025 { 1DB 4 ---  1E8 4 ---  1DC 4 ---  1E9 4 --- }
65DC: 0025 { 1DD 4 ---  0A6 4 ---  1DD 4 ---  1EA 4 --- }
65DD: 0025 { 1DE 4 ---  1EB 4 ---  1DF 4 ---  1EC 4 --- }
65DE: 0025 { 1E0 4 ---  1ED 4 ---  1E1 7 ---  1EE 4 --- }
65DF: 0025 { 1E2 7 ---  1EF 4 ---  1E3 4 ---  1F0 4 --- }
65E0: 0025 { 174 7 ---  182 7 ---  175 7 ---  183 7 --- }
65E1: 0025 { 176 7 ---  184 7 ---  177 7 ---  185 7 --- }
65E2: 0025 { 178 7 ---  186 7 ---  179 7 ---  187 7 --- }
65E3: 0025 { 17A 7 ---  188 7 ---  176 7 ---  189 7 --- }
65E4: 0025 { 17B 7 ---  18A 7 ---  179 7 ---  18B 7 --- }
65E5: 0025 { 17C 7 ---  18C 7 ---  17D 7 ---  18D 7 --- }
65E6: 0025 { 17E 7 ---  18E 7 ---  17F 7 ---  18F 7 --- }
65E7: 0025 { 180 7 ---  190 7 ---  181 7 ---  191 7 --- }
65E8: 0025 { 1F1 4 ---  1F1 4 ---  1F2 7 ---  200 7 --- }
65E9: 0025 { 1F3 4 ---  201 4 ---  1F4 4 ---  202 4 --- }
65EA: 0025 { 1F5 4 ---  203 4 ---  1F6 4 ---  204 4 --- }
65EB: 0025 { 1F7 4 ---  205 4 ---  1F8 4 ---  206 4 --- }
65EC: 0025 { 1F9 4 ---  206 4 x--  1FA 4 ---  207 4 --- }
65ED: 0025 { 1F8 4 ---  208 4 ---  1FB 4 ---  1B5 4 --- }
65EE: 0025 { 1FC 4 ---  1B5 4 ---  1FD 4 ---  1E7 4 --- }
65EF: 0025 { 1FE 4 ---  1B6 4 x--  1FF 4 ---  1D4 4 --- }
65F0: 0025 { 182 7 ---  1A1 7 ---  192 7 ---  1A2 7 --- }
65F1: 0025 { 193 7 ---  1A3 7 ---  194 7 ---  1A4 7 --- }
65F2: 0025 { 195 7 ---  1A5 7 ---  196 7 ---  1A6 7 --- }
65F3: 0025 { 197 7 ---  1A7 7 ---  198 7 ---  1A8 7 --- }
65F4: 0025 { 199 7 ---  1A9 7 ---  19A 7 ---  1AA 7 --- }
65F5: 0025 { 19B 7 ---  1AB 7 ---  19C 7 ---  1AC 7 --- }
65F6: 0025 { 19D 7 ---  1AD 7 ---  19E 7 ---  1AE 7 --- }
65F7: 0025 { 19F 7 ---  1AF 7 ---  1A0 7 ---  1B0 7 --- }
65F8: 0025 { 1FF 4 x--  212 4 ---  1B8 4 -y-  213 4 --- }
65F9: 0025 { 209 4 ---  214 4 ---  20A 4 ---  215 4 --- }
65FA: 0025 { 20B 4 ---  216 4 ---  20C 4 ---  216 4 --- }
65FB: 0025 { 20D 4 ---  216 4 ---  20E 4 ---  216 4 --- }
65FC: 0025 { 20E 4 ---  216 4 ---  20E 4 ---  216 4 --- }
65FD: 0025 { 20E 4 ---  216 4 ---  20F 4 ---  217 4 --- }
65FE: 0025 { 1B5 4 ---  218 4 ---  210 4 ---  219 4 --- }
65FF: 0025 { 211 4 ---  219 4 ---  1D4 4 ---  21A 4 --- }
