7B00: 0130 { 000 7 ---  000 7 ---  001 7 ---  00E 7 --- }
7B01: 0130 { 000 7 ---  000 7 ---  003 7 ---  00F 7 --- }
7B02: 0130 { 000 7 ---  000 7 ---  005 7 ---  011 7 --- }
7B03: 0130 { 000 7 ---  000 7 ---  007 7 ---  000 7 --- }
7B04: 0130 { 000 7 ---  000 7 ---  009 7 ---  014 7 --- }
7B05: 0130 { 000 7 ---  000 7 ---  00B 7 ---  016 7 --- }
7B06: 0130 { 000 7 ---  000 7 ---  00C 7 ---  000 7 --- }
7B07: 0130 { 000 7 ---  000 7 ---  00D 7 ---  019 7 --- }
7B08: 0130 { 000 7 ---  000 7 ---  000 7 ---  000 7 --- }
7B09: 0130 { 000 7 ---  000 7 ---  01B 7 ---  02A 7 --- }
7B0A: 0130 { 000 7 ---  000 7 ---  01D 7 ---  02C 7 --- }
7B0B: 0130 { 000 7 ---  000 7 ---  01F 7 ---  02E 7 --- }
7B0C: 0130 { 000 7 ---  000 7 ---  021 7 ---  02D 7 x-- }
7B0D: 0130 { 000 7 ---  000 7 ---  023 7 ---  02F 7 --- }
7B0E: 0130 { 000 7 ---  000 7 ---  018 7 -y-  017 7 --- }
7B0F: 0130 { 000 7 ---  000 7 ---  026 7 ---  000 7 --- }
7B10: 0130 { 000 7 ---  000 7 ---  002 7 ---  000 7 --- }
7B11: 0130 { 000 7 ---  000 7 ---  004 7 ---  010 7 --- }
7B12: 0130 { 000 7 ---  000 7 ---  006 7 ---  012 7 --- }
7B13: 0130 { 000 7 ---  000 7 ---  008 7 ---  013 7 --- }
7B14: 0130 { 000 7 ---  000 7 ---  00A 7 ---  015 7 --- }
7B15: 0130 { 000 7 ---  000 7 ---  000 7 ---  017 7 --- }
7B16: 0130 { 000 7 ---  000 7 ---  000 7 ---  018 7 --- }
7B17: 0130 { 000 7 ---  000 7 ---  000 7 ---  000 7 --- }
7B18: 0130 { 000 7 ---  000 7 ---  01A 7 ---  029 7 --- }
7B19: 0130 { 000 7 ---  000 7 ---  01C 7 ---  02B 7 --- }
7B1A: 0130 { 000 7 ---  000 7 ---  01E 7 ---  02D 7 --- }
7B1B: 0130 { 000 7 ---  000 7 ---  020 7 ---  029 7 --- }
7B1C: 0130 { 000 7 ---  000 7 ---  022 7 ---  029 7 --- }
7B1D: 0130 { 000 7 ---  000 7 ---  024 7 ---  030 7 --- }
7B1E: 0130 { 000 7 ---  000 7 ---  025 7 ---  031 7 --- }
7B1F: 0130 { 000 7 ---  000 7 ---  000 7 ---  000 7 --- }
7B20: 0130 { 000 7 ---  000 7 ---  028 7 ---  033 7 --- }
7B21: 0130 { 000 7 ---  000 7 ---  035 7 ---  043 7 --- }
7B22: 0130 { 000 7 ---  000 7 ---  037 7 ---  045 7 --- }
7B23: 0130 { 000 7 ---  000 7 ---  039 7 ---  047 7 --- }
7B24: 0130 { 000 7 ---  000 7 ---  03A 7 ---  029 7 --- }
7B25: 0130 { 000 7 ---  000 7 ---  03C 7 ---  02A 7 --- }
7B26: 0130 { 000 7 ---  000 7 ---  03E 7 ---  043 7 --- }
7B27: 0130 { 000 7 ---  000 7 ---  040 7 ---  043 7 --- }
7B28: 0130 { 000 7 ---  000 7 ---  01A 7 ---  029 7 --- }
7B29: 0130 { 000 7 ---  000 7 ---  01A 7 ---  057 7 --- }
7B2A: 0130 { 000 7 ---  000 7 ---  04C 7 ---  059 7 --- }
7B2B: 0130 { 000 7 ---  000 7 ---  04D 7 ---  029 7 --- }
7B2C: 0130 { 000 7 ---  000 7 ---  04F 7 ---  05C 7 --- }
7B2D: 0130 { 000 7 ---  000 7 ---  051 7 ---  05A 7 --- }
7B2E: 0130 { 000 7 ---  000 7 ---  053 7 ---  05D 7 --- }
7B2F: 0130 { 000 7 ---  000 7 ---  055 7 ---  05F 7 --- }
7B30: 0130 { 000 7 ---  000 7 ---  027 7 ---  032 7 --- }
7B31: 0130 { 000 7 ---  000 7 ---  034 7 ---  042 7 --- }
7B32: 0130 { 000 7 ---  000 7 ---  036 7 ---  044 7 --- }
7B33: 0130 { 000 7 ---  000 7 ---  038 7 ---  046 7 --- }
7B34: 0130 { 000 7 ---  000 7 ---  039 7 ---  048 7 --- }
7B35: 0130 { 000 7 ---  000 7 ---  03B 7 ---  043 7 --- }
7B36: 0130 { 000 7 ---  000 7 ---  03D 7 ---  02E 7 --- }
7B37: 0130 { 000 7 ---  000 7 ---  03F 7 ---  047 7 --- }
7B38: 0130 { 000 7 ---  000 7 ---  041 7 ---  049 7 --- }
7B39: 0130 { 000 7 ---  000 7 ---  04A 7 ---  048 7 --- }
7B3A: 0130 { 000 7 ---  000 7 ---  04B 7 ---  058 7 --- }
7B3B: 0130 { 000 7 ---  000 7 ---  03C 7 ---  05A 7 --- }
7B3C: 0130 { 000 7 ---  000 7 ---  04E 7 ---  05B 7 --- }
7B3D: 0130 { 000 7 ---  000 7 ---  050 7 ---  043 7 --- }
7B3E: 0130 { 000 7 ---  000 7 ---  052 7 ---  02B 7 --- }
7B3F: 0130 { 000 7 ---  000 7 ---  054 7 ---  05E 7 --- }
7B40: 0130 { 000 7 ---  000 7 ---  000 7 ---  060 7 --- }
7B41: 0130 { 000 7 ---  000 7 ---  062 7 ---  06F 7 --- }
7B42: 0130 { 000 7 ---  000 7 ---  064 7 ---  064 7 -y- }
7B43: 0130 { 000 7 ---  000 7 ---  029 7 -y-  070 7 --- }
7B44: 0130 { 000 7 ---  000 7 ---  067 7 ---  072 7 --- }
7B45: 0130 { 000 7 ---  000 7 ---  069 7 ---  02A 7 --- }
7B46: 0130 { 000 7 ---  000 7 ---  06B 7 ---  058 7 --- }
7B47: 0130 { 000 7 ---  000 7 ---  06D 7 ---  074 7 --- }
7B48: 0130 { 000 7 ---  000 7 ---  029 7 -y-  029 7 --- }
7B49: 0130 { 000 7 ---  000 7 ---  06F 7 -y-  07F 7 --- }
7B4A: 0130 { 000 7 ---  000 7 ---  076 7 ---  02C 7 --- }
7B4B: 0130 { 000 7 ---  000 7 ---  043 7 -y-  06F 7 --- }
7B4C: 0130 { 000 7 ---  000 7 ---  078 7 ---  1F2 7 --- }
7B4D: 0130 { 000 7 ---  000 7 ---  043 7 -y-  1F3 7 --- }
7B4E: 0130 { 000 7 ---  000 7 ---  07B 7 ---  1F5 7 --- }
7B4F: 0130 { 000 7 ---  000 7 ---  07B 7 x--  1F5 7 x-- }
7B50: 0130 { 000 7 ---  000 7 ---  056 7 ---  000 7 --- }
7B51: 0130 { 000 7 ---  000 7 ---  061 7 ---  000 7 --- }
7B52: 0130 { 000 7 ---  000 7 ---  063 7 ---  06E 7 -y- }
7B53: 0130 { 000 7 ---  000 7 ---  065 7 ---  06F 7 --- }
7B54: 0130 { 000 7 ---  000 7 ---  066 7 ---  071 7 --- }
7B55: 0130 { 000 7 ---  000 7 ---  068 7 ---  043 7 --- }
7B56: 0130 { 000 7 ---  000 7 ---  06A 7 ---  073 7 --- }
7B57: 0130 { 000 7 ---  000 7 ---  06C 7 ---  02A 7 --- }
7B58: 0130 { 000 7 ---  000 7 ---  06E 7 ---  043 7 --- }
7B59: 0130 { 000 7 ---  000 7 ---  06E 7 ---  07E 7 --- }
7B5A: 0130 { 000 7 ---  000 7 ---  075 7 ---  048 7 --- }
7B5B: 0130 { 000 7 ---  000 7 ---  077 7 ---  1F0 7 --- }
7B5C: 0130 { 000 7 ---  000 7 ---  043 7 -y-  1F1 7 --- }
7B5D: 0130 { 000 7 ---  000 7 ---  079 7 ---  079 7 -y- }
7B5E: 0130 { 000 7 ---  000 7 ---  07A 7 ---  1F4 7 --- }
7B5F: 0130 { 000 7 ---  000 7 ---  07C 7 ---  05A 7 --- }
7B60: ~
7B61: ~
7B62: ~
7B63: ~
7B64: ~
7B65: ~
7B66: ~
7B67: ~
7B68: ~
7B69: ~
7B6A: ~
7B6B: ~
7B6C: ~
7B6D: ~
7B6E: ~
7B6F: ~
7B70: ~
7B71: ~
7B72: ~
7B73: ~
7B74: ~
7B75: ~
7B76: ~
7B77: ~
7B78: ~
7B79: ~
7B7A: ~
7B7B: ~
7B7C: ~
7B7D: ~
7B7E: ~
7B7F: ~
7B80: ~
7B81: ~
7B82: ~
7B83: ~
7B84: ~
7B85: ~
7B86: ~
7B87: ~
7B88: ~
7B89: ~
7B8A: ~
7B8B: ~
7B8C: ~
7B8D: ~
7B8E: ~
7B8F: ~
7B90: ~
7B91: ~
7B92: ~
7B93: ~
7B94: ~
7B95: ~
7B96: ~
7B97: ~
7B98: ~
7B99: ~
7B9A: ~
7B9B: ~
7B9C: ~
7B9D: ~
7B9E: ~
7B9F: ~
7BA0: ~
7BA1: ~
7BA2: ~
7BA3: ~
7BA4: ~
7BA5: ~
7BA6: ~
7BA7: ~
7BA8: ~
7BA9: ~
7BAA: ~
7BAB: ~
7BAC: ~
7BAD: ~
7BAE: ~
7BAF: ~
7BB0: ~
7BB1: ~
7BB2: ~
7BB3: ~
7BB4: ~
7BB5: ~
7BB6: ~
7BB7: ~
7BB8: ~
7BB9: ~
7BBA: ~
7BBB: ~
7BBC: ~
7BBD: ~
7BBE: ~
7BBF: ~
7BC0: ~
7BC1: ~
7BC2: ~
7BC3: ~
7BC4: ~
7BC5: ~
7BC6: ~
7BC7: ~
7BC8: ~
7BC9: ~
7BCA: ~
7BCB: ~
7BCC: ~
7BCD: ~
7BCE: ~
7BCF: ~
7BD0: ~
7BD1: ~
7BD2: ~
7BD3: ~
7BD4: ~
7BD5: ~
7BD6: ~
7BD7: ~
7BD8: ~
7BD9: ~
7BDA: ~
7BDB: ~
7BDC: ~
7BDD: ~
7BDE: ~
7BDF: ~
7BE0: ~
7BE1: ~
7BE2: ~
7BE3: ~
7BE4: ~
7BE5: ~
7BE6: ~
7BE7: ~
7BE8: ~
7BE9: ~
7BEA: ~
7BEB: ~
7BEC: ~
7BED: ~
7BEE: ~
7BEF: ~
7BF0: ~
7BF1: ~
7BF2: ~
7BF3: ~
7BF4: ~
7BF5: ~
7BF6: ~
7BF7: ~
7BF8: ~
7BF9: ~
7BFA: ~
7BFB: ~
7BFC: ~
7BFD: ~
7BFE: ~
7BFF: ~
