2600: 0100 { 202 0 ---  212 0 ---  203 0 ---  213 0 --- }
2601: 0025 { 212 0 ---  214 0 ---  213 0 ---  215 0 --- }
2602: 0182 { 225 0 x--  212 0 ---  224 0 x--  23A 0 x-- }
2603: 0187 { 235 0 x--  239 0 x--  234 0 x--  238 0 x-- }
2604: 018C { 0F8 0 ---  237 0 x--  0F8 0 ---  236 0 x-- }
2605: 0191 { 0F8 0 ---  235 0 x--  0F8 0 ---  234 0 x-- }
2606: 016E { 0F8 0 x--  234 0 ---  0F8 0 x--  235 0 --- }
2607: 0173 { 0F8 0 x--  236 0 ---  0F8 0 x--  237 0 --- }
2608: 0178 { 234 0 ---  238 0 ---  235 0 ---  239 0 --- }
2609: 017D { 224 0 ---  23A 0 ---  225 0 ---  212 0 x-- }
260A: 01AF { 207 0 x--  217 0 x--  0F8 0 ---  216 0 x-- }
260B: 01A1 { 0F8 0 x--  216 0 ---  207 0 ---  217 0 --- }
260C: 01EC { 192 0 -y-  186 0 -y-  193 0 -y-  195 0 -y- }
260D: ~
260E: ~
260F: 01ED { 192 0 -y-  194 0 -y-  193 0 -y-  186 0 xy- }
2610: 0130 { 200 0 ---  210 0 ---  203 0 ---  213 0 --- }
2611: 0130 { 203 0 x--  213 0 x--  200 0 x--  210 0 x-- }
2612: 0195 { 0F8 0 ---  21B 0 ---  0F8 0 ---  21C 0 --- }
2613: 019B { 21B 0 ---  21D 0 ---  20E 0 ---  21E 0 --- }
2614: 01E4 { 227 0 ---  214 0 ---  213 0 ---  215 0 --- }
2615: 01E2 { 213 0 x--  215 0 x--  227 0 x--  214 0 x-- }
2616: 0130 { 204 0 ---  210 0 ---  215 0 ---  213 0 --- }
2617: 0130 { 215 0 x--  213 0 x--  204 0 x--  210 0 x-- }
2618: 01A0 { 20E 0 x--  21E 0 x--  21B 0 x--  21D 0 x-- }
2619: 01A5 { 0F8 0 x--  21C 0 x--  0F8 0 x--  21B 0 x-- }
261A: 01E4 { 214 0 ---  212 0 ---  206 0 x--  213 0 --- }
261B: 01E2 { 206 0 ---  213 0 x--  214 0 x--  212 0 x-- }
261C: 01C6 { 21B 0 -y-  0F8 0 ---  21C 0 -y-  0F8 0 --- }
261D: 01C7 { 21D 0 -y-  21B 0 -y-  21E 0 -y-  20E 0 -y- }
261E: 01C8 { 21E 0 xy-  20E 0 xy-  21D 0 xy-  21B 0 xy- }
261F: 01C9 { 21C 0 xy-  0F8 0 ---  21B 0 xy-  0F8 0 --- }
2620: 0100 { 201 0 ---  240 0 ---  203 0 ---  213 0 --- }
2621: 0100 { 203 0 x--  213 0 x--  201 0 x--  240 0 x-- }
2622: 0025 { 250 0 ---  240 0 ---  214 0 ---  213 0 --- }
2623: 0025 { 214 0 x--  213 0 x--  250 0 x--  240 0 x-- }
2624: ~
2625: ~
2626: ~
2627: ~
2628: 01C4 { 216 0 -y-  0F8 0 x--  217 0 -y-  207 0 -y- }
2629: 01C5 { 217 0 xy-  207 0 xy-  216 0 xy-  0F8 0 x-- }
262A: 01CA { 0F8 0 x--  0F8 0 x--  241 0 ---  251 0 --- }
262B: 01CC { 241 0 x--  251 0 x--  0F8 0 x--  0F8 0 x-- }
262C: ~
262D: ~
262E: ~
262F: ~
2630: 0130 { 210 0 -y-  200 0 -y-  213 0 -y-  203 0 -y- }
2631: 0130 { 212 0 -y-  202 0 -y-  213 0 -y-  203 0 -y- }
2632: 0130 { 213 0 xy-  203 0 xy-  210 0 xy-  200 0 xy- }
2633: 01E4 { 214 0 -y-  227 0 -y-  215 0 -y-  213 0 -y- }
2634: 01E2 { 215 0 xy-  213 0 xy-  214 0 xy-  227 0 xy- }
2635: 0100 { 20D 0 ---  240 0 ---  203 0 ---  213 0 --- }
2636: 0100 { 203 0 x--  213 0 x--  20D 0 x--  240 0 x-- }
2637: 0130 { 211 0 ---  210 0 ---  203 0 ---  213 0 --- }
2638: 0130 { 203 0 x--  213 0 x--  211 0 x--  210 0 x-- }
2639: 0130 { 212 0 ---  214 0 ---  213 0 ---  215 0 --- }
263A: 01CB { 241 0 ---  251 0 ---  242 0 ---  252 0 --- }
263B: 01CD { 242 0 x--  252 0 x--  241 0 x--  251 0 x-- }
263C: ~
263D: ~
263E: ~
263F: ~
2640: ~
2641: ~
2642: ~
2643: ~
2644: ~
2645: ~
2646: ~
2647: ~
2648: ~
2649: ~
264A: 01F1 { 242 0 ---  252 0 ---  215 0 ---  213 0 --- }
264B: 01F2 { 214 0 ---  212 0 ---  242 0 x--  252 0 x-- }
264C: ~
264D: ~
264E: ~
264F: ~
2650: ~
2651: ~
2652: ~
2653: ~
2654: ~
2655: ~
2656: ~
2657: ~
2658: ~
2659: ~
265A: ~
265B: ~
265C: ~
265D: ~
265E: ~
265F: ~
2660: ~
2661: ~
2662: ~
2663: ~
2664: ~
2665: ~
2666: ~
2667: ~
2668: ~
2669: ~
266A: ~
266B: ~
266C: ~
266D: ~
266E: ~
266F: ~
2670: 0025 { 004 4 ---  004 4 ---  004 4 ---  004 4 --- }
2671: 0025 { 004 4 ---  004 4 ---  004 4 ---  004 4 --- }
2672: 0025 { 004 4 ---  004 4 ---  004 4 ---  004 4 --- }
2673: 0025 { 004 4 ---  004 4 ---  004 4 ---  004 4 --- }
2674: 0025 { 004 4 ---  004 4 ---  004 4 ---  004 4 --- }
2675: 0025 { 004 4 ---  004 4 ---  004 4 ---  004 4 --- }
2676: ~
2677: ~
2678: ~
2679: ~
267A: ~
267B: ~
267C: ~
267D: ~
267E: ~
267F: ~
2680: 0025 { 004 4 ---  004 4 ---  004 4 ---  004 4 --- }
2681: 0025 { 004 4 ---  004 4 ---  004 4 ---  004 4 --- }
2682: 0025 { 004 4 ---  004 4 ---  004 4 ---  004 4 --- }
2683: 0025 { 004 4 ---  004 4 ---  004 4 ---  004 4 --- }
2684: 0025 { 004 4 ---  004 4 ---  004 4 ---  004 4 --- }
2685: 0025 { 004 4 ---  004 4 ---  004 4 ---  004 4 --- }
2686: ~
2687: ~
2688: ~
2689: ~
268A: ~
268B: ~
268C: ~
268D: ~
268E: ~
268F: ~
2690: 0025 { 004 4 ---  004 4 ---  004 4 ---  004 4 --- }
2691: 0025 { 004 4 ---  004 4 ---  004 4 ---  004 4 --- }
2692: 0025 { 004 4 ---  004 4 ---  004 4 ---  004 4 --- }
2693: 0025 { 004 4 ---  004 4 ---  004 4 ---  004 4 --- }
2694: ~
2695: ~
2696: ~
2697: ~
2698: ~
2699: ~
269A: ~
269B: ~
269C: ~
269D: ~
269E: ~
269F: ~
26A0: 0025 { 180 2 ---  190 2 ---  181 2 ---  191 2 --- }
26A1: 0025 { 181 2 ---  191 2 ---  181 2 ---  191 2 --- }
26A2: 0025 { 181 2 ---  191 2 ---  182 2 ---  192 2 --- }
26A3: 0025 { 180 2 ---  1A0 2 ---  181 2 ---  1A1 2 --- }
26A4: 0025 { 181 2 ---  1A1 2 ---  181 2 ---  1A1 2 --- }
26A5: 0025 { 181 2 ---  1A1 2 ---  182 2 ---  1A2 2 --- }
26A6: 0130 { 183 2 ---  193 2 ---  184 2 ---  194 2 --- }
26A7: 0130 { 184 2 ---  194 2 ---  184 2 ---  194 2 --- }
26A8: 0130 { 184 2 ---  194 2 ---  185 2 ---  195 2 --- }
26A9: 0130 { 183 2 ---  1A3 2 ---  184 2 ---  1A4 2 --- }
26AA: 0130 { 184 2 ---  1A4 2 ---  184 2 ---  1A4 2 --- }
26AB: 0130 { 184 2 ---  1A4 2 ---  185 2 ---  1A5 2 --- }
26AC: 0025 { 190 2 ---  190 2 ---  191 2 ---  191 2 --- }
26AD: 0025 { 191 2 ---  191 2 ---  191 2 ---  191 2 --- }
26AE: 0025 { 191 2 ---  191 2 ---  192 2 ---  192 2 --- }
26AF: ~
26B0: 0025 { 190 2 ---  190 2 ---  191 2 ---  191 2 --- }
26B1: 0025 { 191 2 ---  191 2 ---  191 2 ---  191 2 --- }
26B2: 0025 { 191 2 ---  191 2 ---  192 2 ---  192 2 --- }
26B3: 0025 { 180 2 ---  190 2 ---  182 2 ---  192 2 --- }
26B4: 0025 { 190 2 ---  190 2 ---  192 2 ---  192 2 --- }
26B5: 0025 { 190 2 ---  1A0 2 ---  192 2 ---  1A2 2 --- }
26B6: 0130 { 193 2 ---  193 2 ---  194 2 ---  194 2 --- }
26B7: 0130 { 194 2 ---  194 2 ---  194 2 ---  194 2 --- }
26B8: 0130 { 194 2 ---  194 2 ---  195 2 ---  195 2 --- }
26B9: 0130 { 183 2 ---  193 2 ---  185 2 ---  195 2 --- }
26BA: 0130 { 193 2 ---  193 2 ---  195 2 ---  195 2 --- }
26BB: 0130 { 193 2 ---  1A3 2 ---  195 2 ---  1A5 2 --- }
26BC: 0025 { 18C 2 ---  18E 2 ---  18D 2 ---  18F 2 --- }
26BD: ~
26BE: ~
26BF: ~
26C0: 0025 { 190 2 ---  1A0 2 ---  191 2 ---  1A1 2 --- }
26C1: 0025 { 191 2 ---  1A1 2 ---  191 2 ---  1A1 2 --- }
26C2: 0025 { 191 2 ---  1A1 2 ---  192 2 ---  1A2 2 --- }
26C3: 0025 { 180 2 ---  1A0 2 ---  182 2 ---  1A2 2 --- }
26C4: 0020 { 18C 2 ---  19C 2 ---  18D 2 ---  19D 2 --- }
26C5: 0020 { 1AC 2 ---  1BC 2 ---  1AD 2 ---  1BD 2 --- }
26C6: 0130 { 193 2 ---  1A3 2 ---  194 2 ---  1A4 2 --- }
26C7: 0130 { 194 2 ---  1A4 2 ---  194 2 ---  1A4 2 --- }
26C8: 0130 { 194 2 ---  1A4 2 ---  195 2 ---  1A5 2 --- }
26C9: 0130 { 183 2 ---  1A3 2 ---  185 2 ---  1A5 2 --- }
26CA: 0025 { 18C 2 ---  19C 2 ---  18D 2 ---  19D 2 --- }
26CB: 0025 { 1AC 2 ---  1BC 2 ---  1AD 2 ---  1BD 2 --- }
26CC: 0025 { 19E 2 ---  1BC 2 ---  19F 2 ---  1BD 2 --- }
26CD: ~
26CE: ~
26CF: ~
26D0: 0130 { 186 2 ---  196 2 ---  187 2 ---  197 2 --- }
26D1: 0130 { 187 2 ---  197 2 ---  187 2 ---  197 2 --- }
26D2: 0130 { 187 2 ---  197 2 ---  188 2 ---  198 2 --- }
26D3: 0130 { 186 2 ---  1A6 2 ---  187 2 ---  1A7 2 --- }
26D4: 0130 { 187 2 ---  1A7 2 ---  187 2 ---  1A7 2 --- }
26D5: 0130 { 187 2 ---  1A7 2 ---  188 2 ---  1A8 2 --- }
26D6: 0130 { 189 2 ---  199 2 ---  18A 2 ---  19A 2 --- }
26D7: 0130 { 18A 2 ---  19A 2 ---  18A 2 ---  19A 2 --- }
26D8: 0130 { 18A 2 ---  19A 2 ---  18B 2 ---  19B 2 --- }
26D9: 0130 { 189 2 ---  1A9 2 ---  18A 2 ---  1AA 2 --- }
26DA: 0130 { 18A 2 ---  1AA 2 ---  18A 2 ---  1AA 2 --- }
26DB: 0130 { 18A 2 ---  1AA 2 ---  18B 2 ---  1AB 2 --- }
26DC: ~
26DD: ~
26DE: ~
26DF: ~
26E0: 0130 { 196 2 ---  196 2 ---  197 2 ---  197 2 --- }
26E1: 0130 { 197 2 ---  197 2 ---  197 2 ---  197 2 --- }
26E2: 0130 { 197 2 ---  197 2 ---  198 2 ---  198 2 --- }
26E3: 0130 { 186 2 ---  196 2 ---  188 2 ---  198 2 --- }
26E4: 0130 { 196 2 ---  196 2 ---  198 2 ---  198 2 --- }
26E5: 0130 { 196 2 ---  1A6 2 ---  198 2 ---  1A8 2 --- }
26E6: 0130 { 199 2 ---  199 2 ---  19A 2 ---  19A 2 --- }
26E7: 0130 { 19A 2 ---  19A 2 ---  19A 2 ---  19A 2 --- }
26E8: 0130 { 19A 2 ---  19A 2 ---  19B 2 ---  19B 2 --- }
26E9: 0130 { 189 2 ---  199 2 ---  18B 2 ---  19B 2 --- }
26EA: 0130 { 199 2 ---  199 2 ---  19B 2 ---  19B 2 --- }
26EB: 0130 { 199 2 ---  1A9 2 ---  19B 2 ---  1AB 2 --- }
26EC: ~
26ED: ~
26EE: ~
26EF: ~
26F0: 0130 { 196 2 ---  1A6 2 ---  197 2 ---  1A7 2 --- }
26F1: 0130 { 197 2 ---  1A7 2 ---  197 2 ---  1A7 2 --- }
26F2: 0130 { 197 2 ---  1A7 2 ---  198 2 ---  1A8 2 --- }
26F3: 0130 { 186 2 ---  1A6 2 ---  188 2 ---  1A8 2 --- }
26F4: 0130 { 190 2 ---  1A0 2 ---  191 2 ---  1A1 2 --- }
26F5: 0130 { 191 2 ---  1A1 2 ---  191 2 ---  1A1 2 --- }
26F6: 0130 { 199 2 ---  1A9 2 ---  19A 2 ---  1AA 2 --- }
26F7: 0130 { 19A 2 ---  1AA 2 ---  19A 2 ---  1AA 2 --- }
26F8: 0130 { 19A 2 ---  1AA 2 ---  19B 2 ---  1AB 2 --- }
26F9: 0130 { 189 2 ---  1A9 2 ---  18B 2 ---  1AB 2 --- }
26FA: 0130 { 181 2 ---  1A1 2 ---  182 2 ---  1A2 2 --- }
26FB: 0130 { 190 2 ---  190 2 ---  192 2 ---  192 2 --- }
26FC: ~
26FD: ~
26FE: ~
26FF: ~
