1E00: 0130 { 000 0 ---  000 0 ---  001 0 ---  001 0 --- }
1E01: 01E2 { 2A6 2 ---  2B2 2 ---  2B5 2 ---  2B3 2 --- }
1E02: 01E4 { 2B4 2 ---  2B2 2 ---  2A6 2 x--  2B3 2 --- }
1E03: 01EC { 2B2 2 -y-  2A6 2 -y-  2B3 2 -y-  2B5 2 -y- }
1E04: 01ED { 2B2 2 -y-  2B4 2 -y-  2B3 2 -y-  2A6 2 xy- }
1E05: 003F { 266 2 ---  276 2 ---  267 2 ---  277 2 --- }
1E06: 0130 { 025 0 ---  025 0 ---  025 0 ---  025 0 --- }
1E07: 0044 { 2B2 2 -y-  2B4 2 -y-  2B3 2 -y-  2B5 2 -y- }
1E08: 0100 { 2A2 2 ---  2B2 2 ---  2A3 2 ---  2B3 2 --- }
1E09: 0145 { 2A0 2 ---  2B0 2 ---  2A3 2 ---  2B3 2 --- }
1E0A: 0148 { 2A2 2 ---  2B2 2 ---  2A0 2 x--  2B0 2 x-- }
1E0B: 014B { 2A4 2 ---  2B0 2 ---  2B5 2 ---  2B3 2 --- }
1E0C: 014C { 2B4 2 ---  2B2 2 ---  2A4 2 x--  2B0 2 x-- }
1E0D: 014D { 2B0 2 -y-  2A0 2 -y-  2B3 2 -y-  2A3 2 -y- }
1E0E: 014E { 2B2 2 -y-  2A2 2 -y-  2B3 2 -y-  2A3 2 -y- }
1E0F: 014F { 2B2 2 -y-  2A2 2 -y-  2B0 2 xy-  2A0 2 xy- }
1E10: 003F { 277 2 xy-  267 2 xy-  276 2 xy-  266 2 xy- }
1E11: ~
1E12: ~
1E13: ~
1E14: ~
1E15: ~
1E16: 0130 { 02D 0 -y-  026 0 -y-  002 0 -y-  001 0 -y- }
1E17: 0130 { 002 0 xy-  001 0 xy-  02D 0 xy-  026 0 xy- }
1E18: 0130 { 001 0 x--  002 0 x--  026 0 x--  02D 0 x-- }
1E19: 61CE { 0C3 7 x--  0D3 7 x--  0C2 7 x--  0D2 7 x-- }
1E1A: 61DE { 0C2 7 ---  0D2 7 ---  0C3 7 ---  0D3 7 --- }
1E1B: 0135 { 020 5 ---  020 5 ---  021 5 ---  021 5 --- }
1E1C: 0136 { 022 5 ---  022 5 ---  023 5 ---  023 5 --- }
1E1D: 0137 { 010 5 -y-  000 5 -y-  011 5 -y-  001 5 -y- }
1E1E: 0138 { 012 5 -y-  002 5 -y-  013 5 -y-  003 5 -y- }
1E1F: 0130 { 000 0 ---  000 0 ---  000 0 ---  000 0 --- }
1E20: 0130 { 180 2 ---  190 2 ---  182 2 ---  192 2 --- }
1E21: 0130 { 181 2 ---  191 2 ---  182 2 ---  192 2 --- }
1E22: 0130 { 183 2 ---  193 2 ---  184 2 ---  194 2 --- }
1E23: 0130 { 184 2 ---  194 2 ---  185 2 ---  195 2 --- }
1E24: 0130 { 246 6 ---  256 6 ---  241 6 ---  251 6 --- }
1E25: 0130 { 240 6 ---  250 6 ---  241 6 ---  251 6 --- }
1E26: 0130 { 240 6 ---  250 6 ---  247 6 ---  257 6 --- }
1E27: 0130 { 27A 2 -y-  26A 2 -y-  27B 2 -y-  26B 2 -y- }
1E28: 012F { 24A 3 ---  25A 3 ---  24B 3 ---  25B 3 --- }
1E29: 014E { 192 2 -y-  182 2 -y-  193 2 -y-  183 2 -y- }
1E2A: 014F { 192 2 -y-  182 2 -y-  190 2 xy-  180 2 xy- }
1E2B: 0130 { 248 5 ---  258 5 ---  249 5 ---  259 5 --- }
1E2C: 0130 { 24A 5 ---  25A 5 ---  24B 5 ---  25B 5 --- }
1E2D: ~
1E2E: 0130 { 0F8 4 ---  0F8 4 ---  0F8 4 ---  0F8 4 --- }
1E2F: ~
1E30: 0130 { 18C 2 ---  19C 2 ---  18F 2 ---  19F 2 --- }
1E31: ~
1E32: ~
1E33: 0130 { 248 3 ---  258 3 ---  249 3 ---  259 3 --- }
1E34: 0130 { 244 6 ---  254 6 ---  243 6 ---  253 6 --- }
1E35: 0130 { 242 6 ---  252 6 ---  243 6 ---  253 6 --- }
1E36: 0130 { 242 6 ---  252 6 ---  245 6 ---  255 6 --- }
1E37: 0130 { 27B 2 xy-  26B 2 xy-  27A 2 xy-  26A 2 xy- }
1E38: 0006 { 244 4 ---  254 4 ---  245 4 ---  255 4 --- }
1E39: ~
1E3A: 0130 { 0FA 1 ---  0FA 1 ---  0FA 1 ---  0FA 1 --- }
1E3B: 0130 { 268 5 ---  278 5 ---  269 5 ---  279 5 --- }
1E3C: 0130 { 26A 5 ---  27A 5 ---  26B 5 ---  27B 5 --- }
1E3D: 0026 { 0F8 4 ---  00C 4 ---  0F8 4 ---  00C 4 x-- }
1E3E: 0130 { 2C6 6 ---  2D6 6 ---  2C7 6 ---  2D7 6 --- }
1E3F: 0026 { 0F8 4 ---  00C 4 ---  0F8 4 ---  00C 4 x-- }
1E40: 0130 { 19C 2 ---  1AC 2 ---  19F 2 ---  1AF 2 --- }
1E41: 012F { 26C 2 ---  27C 2 ---  26D 2 ---  27D 2 --- }
1E42: 0130 { 26E 2 ---  27E 2 ---  26F 2 ---  27F 2 --- }
1E43: 0130 { 204 3 ---  208 3 ---  205 3 ---  209 3 --- }
1E44: 0130 { 20C 3 ---  20E 3 ---  20D 3 ---  20F 3 --- }
1E45: 0130 { 206 3 ---  20A 3 ---  207 3 ---  20B 3 --- }
1E46: 0130 { 1A2 2 ---  1B2 2 ---  1A3 2 ---  1B3 2 --- }
1E47: 0130 { 1A4 2 ---  1B4 2 ---  1A5 2 ---  1B5 2 --- }
1E48: 0130 { 04A 3 --p  0FB 3 --p  04B 3 --p  0FB 3 --p }
1E49: 0130 { 05C 6 ---  05E 6 ---  05D 6 ---  05F 6 --- }
1E4A: 0002 { 0F8 4 ---  0F8 4 ---  0F8 4 ---  0F8 4 --- }
1E4B: 0002 { 030 4 ---  032 4 ---  031 4 ---  033 4 --- }
1E4C: 0205 { 030 4 ---  032 4 ---  031 4 ---  033 4 --- }
1E4D: 0100 { 0C8 7 ---  0D8 7 ---  0C9 7 ---  0D9 7 --- }
1E4E: 0130 { 2E6 6 ---  2F6 6 ---  2E7 6 ---  2F7 6 --- }
1E4F: 0222 { 01C 7 -y-  01C 7 ---  01C 7 xy-  01C 7 x-- }
1E50: 0130 { 1BC 2 ---  1CC 2 ---  1BF 2 ---  1CF 2 --- }
1E51: 0130 { 21D 3 ---  22D 3 ---  21C 3 ---  22C 3 --- }
1E52: 0130 { 220 7 ---  222 7 ---  221 7 ---  223 7 --- }
1E53: 0130 { 29A 4 ---  2AA 4 ---  29B 4 ---  2AB 4 --- }
1E54: 0130 { 0FB 4 ---  2AC 4 ---  29C 4 ---  0FB 4 -y- }
1E55: 0130 { 21C 3 x--  22C 3 x--  21D 3 x--  22D 3 x-- }
1E56: 01CF { 048 2 x--  049 2 x--  0F8 7 ---  048 2 x-- }
1E57: 01CE { 0F8 7 ---  044 2 ---  044 2 ---  045 2 --- }
1E58: 0025 { 07A 0 --p  08A 0 --p  07B 0 --p  08B 0 --p }
1E59: 0025 { 07C 0 --p  08C 0 --p  07D 0 --p  08D 0 --p }
1E5A: 0025 { 07E 0 --p  08E 0 --p  07F 0 --p  08F 0 --p }
1E5B: 0025 { 080 0 --p  090 0 --p  081 0 --p  091 0 --p }
1E5C: 0025 { 082 0 --p  092 0 --p  083 0 --p  093 0 --p }
1E5D: 0025 { 084 0 --p  094 0 --p  085 0 --p  095 0 --p }
1E5E: 0025 { 086 0 --p  096 0 --p  087 0 --p  097 0 --p }
1E5F: 0025 { 088 0 --p  098 0 --p  089 0 --p  099 0 --p }
1E60: 0130 { 1BC 2 ---  1DC 2 ---  1CF 2 ---  1DF 2 --- }
1E61: 0130 { 23E 3 ---  24E 3 ---  21E 3 ---  22E 3 --- }
1E62: 0130 { 224 7 ---  224 7 ---  225 7 ---  225 7 --- }
1E63: 0130 { 0FB 4 -y-  29C 4 xy-  2BB 4 ---  0FB 4 -y- }
1E64: 0130 { 2BC 4 ---  0FB 4 -y-  0FB 4 -y-  29C 4 -y- }
1E65: 0130 { 21E 3 x--  22E 3 x--  23E 3 x--  24E 3 x-- }
1E66: 01F4 { 04B 2 x--  2B2 2 ---  049 2 x--  04B 2 x-- }
1E67: 01F3 { 045 2 ---  047 2 ---  047 2 ---  2B3 2 --- }
1E68: 0130 { 09A 0 --p  0AA 0 --p  09B 0 --p  0AB 0 --p }
1E69: 0130 { 09C 0 --p  0AC 0 --p  09D 0 --p  0AD 0 --p }
1E6A: 0130 { 09E 0 --p  0AE 0 --p  09F 0 --p  0AF 0 --p }
1E6B: 0130 { 0A0 0 --p  0B0 0 --p  0A1 0 --p  0B1 0 --p }
1E6C: 0130 { 0A2 0 --p  0B2 0 --p  0A3 0 --p  0B3 0 --p }
1E6D: 0130 { 0A4 0 --p  0B4 0 --p  0A5 0 --p  0B5 0 --p }
1E6E: 0130 { 0A6 0 --p  0B6 0 --p  0A7 0 --p  0B7 0 --p }
1E6F: 0130 { 0A8 0 --p  0B8 0 --p  0A9 0 --p  0B8 0 --p }
1E70: 020C { 264 3 ---  274 3 ---  265 3 ---  275 3 --- }
1E71: 0130 { 23D 3 ---  24D 3 ---  23C 3 ---  24C 3 --- }
1E72: 0130 { 222 7 -y-  220 7 -y-  223 7 -y-  221 7 -y- }
1E73: 0096 { 0F8 7 ---  29E 7 ---  0F8 7 ---  29F 7 --- }
1E74: ~
1E75: 0130 { 23C 3 x--  24C 3 x--  23D 3 x--  24D 3 x-- }
1E76: 0130 { 240 1 ---  250 1 ---  241 1 ---  252 1 --- }
1E77: 0130 { 242 1 ---  252 1 ---  243 1 ---  253 1 --- }
1E78: 0025 { 1AE 0 --p  02B 0 -yp  1AF 0 --p  02B 0 -yp }
1E79: 0025 { 1B0 0 --p  1BB 0 --p  1B1 0 --p  096 0 x-p }
1E7A: 0025 { 196 0 --p  1A4 0 --p  197 3 --p  1A5 3 --p }
1E7B: 0025 { 198 3 --p  1A6 3 --p  199 0 --p  1A7 0 --p }
1E7C: 0025 { 1B5 0 --p  1BF 0 --p  1B6 0 --p  1C0 0 --p }
1E7D: 0025 { 07E 0 --p  1C1 0 --p  07E 0 --p  1C2 0 --p }
1E7E: 0025 { 1B7 0 --p  1C3 0 --p  1B8 0 --p  1C4 0 --p }
1E7F: 0025 { 1B9 0 --p  1C5 0 --p  1BA 0 --p  1C6 0 --p }
1E80: ~
1E81: ~
1E82: ~
1E83: 0097 { 29F 7 xy-  0F8 7 ---  29E 7 xy-  0F8 7 --- }
1E84: ~
1E85: 0025 { 0FB 4 ---  0FB 4 ---  0FB 4 ---  0FB 4 --- }
1E86: 0130 { 250 1 -y-  240 1 -y-  252 1 -y-  241 1 -y- }
1E87: 0130 { 252 1 -y-  242 1 -y-  253 1 -y-  243 1 -y- }
1E88: 0130 { 1C7 0 --p  0B8 0 --p  1C8 0 --p  0B8 0 --p }
1E89: 0130 { 1C9 0 --p  1D7 0 --p  1CA 0 --p  1D8 0 --p }
1E8A: 0130 { 1CB 0 --p  1D9 0 --p  1CC 3 --p  1DA 0 --p }
1E8B: 0130 { 1CD 3 --p  1DB 0 --p  1CE 0 --p  1DC 0 --p }
1E8C: 0130 { 1CF 0 --p  1DD 0 --p  1D0 0 --p  1DE 0 --p }
1E8D: 0130 { 1D1 0 --p  1DE 0 --p  1D2 0 --p  1DE 0 --p }
1E8E: 0130 { 1D3 0 --p  1DE 0 --p  1D4 0 --p  1DF 0 --p }
1E8F: 0130 { 1D5 0 --p  1E0 0 --p  1D6 0 --p  1E1 0 --p }
1E90: 0025 { 000 0 --p  010 0 --p  001 0 --p  011 0 --p }
1E91: 0025 { 002 0 --p  012 0 --p  003 0 --p  013 0 --p }
1E92: 0025 { 004 0 --p  014 0 --p  005 0 --p  015 0 --p }
1E93: 0025 { 006 0 --p  016 0 --p  007 0 --p  017 0 --p }
1E94: 0025 { 008 0 --p  018 0 --p  009 0 --p  019 0 --p }
1E95: 0025 { 00A 0 --p  01A 0 --p  00B 0 --p  01B 0 --p }
1E96: 0025 { 00C 0 --p  01C 0 --p  00D 0 --p  01C 0 --p }
1E97: 0025 { 00E 0 --p  01C 0 --p  00F 0 --p  01C 0 --p }
1E98: 0025 { 0B9 0 --p  01C 0 --p  0BA 0 --p  01C 0 --p }
1E99: 0025 { 0BB 0 --p  01C 0 --p  0BC 0 --p  01C 0 --p }
1E9A: 0025 { 0BC 0 --p  0C7 0 --p  0BD 0 --p  0C8 0 --p }
1E9B: 0025 { 0BE 0 --p  0C9 0 --p  0BF 0 --p  0CA 0 --p }
1E9C: 0025 { 0C0 0 --p  0CB 0 --p  0C1 0 --p  0CC 0 --p }
1E9D: 0025 { 0C2 0 --p  0CD 0 --p  0C3 0 --p  0CE 0 --p }
1E9E: 0025 { 0C3 0 --p  0CF 0 --p  0C4 0 --p  0D0 0 --p }
1E9F: 0025 { 0C5 0 --p  0D1 0 --p  0C6 0 --p  0D2 0 --p }
1EA0: 0025 { 01D 0 --p  02D 0 --p  01E 0 --p  02E 0 --p }
1EA1: 0025 { 01F 0 --p  02F 0 --p  020 0 --p  030 0 --p }
1EA2: 0025 { 021 0 --p  031 0 --p  022 0 --p  032 0 --p }
1EA3: 0025 { 023 0 --p  033 0 --p  024 0 --p  034 0 --p }
1EA4: 0025 { 025 0 --p  035 0 --p  026 0 --p  036 0 --p }
1EA5: 0025 { 027 0 --p  037 0 --p  028 0 --p  038 0 --p }
1EA6: 0025 { 029 0 --p  039 0 --p  02A 0 --p  03A 0 --p }
1EA7: 0025 { 02B 0 --p  03B 0 --p  02C 0 --p  03C 0 --p }
1EA8: 0025 { 0D3 0 --p  0E2 0 --p  02B 0 --p  0E3 0 --p }
1EA9: 0025 { 0D4 0 --p  0E4 0 --p  0D5 0 --p  0E5 0 --p }
1EAA: 0025 { 0D6 0 --p  0E6 0 --p  0D7 0 --p  0E7 0 --p }
1EAB: 0025 { 0D8 0 --p  0E8 0 --p  0D9 0 --p  0E9 0 --p }
1EAC: 0025 { 0DA 0 --p  0EA 0 --p  0DB 0 --p  0EB 0 --p }
1EAD: 0025 { 0DC 0 --p  0EC 0 --p  0DD 0 --p  0ED 0 --p }
1EAE: 0025 { 0DE 0 --p  0EE 0 --p  0DF 0 --p  0EF 0 --p }
1EAF: 0025 { 0E0 0 --p  0F0 0 --p  0E1 0 --p  0F1 0 --p }
1EB0: 0025 { 03D 0 --p  04D 0 --p  03E 0 --p  04E 0 --p }
1EB1: 0025 { 03F 0 --p  04F 0 --p  040 0 --p  050 0 --p }
1EB2: 0025 { 041 0 --p  051 0 --p  042 0 --p  052 0 --p }
1EB3: 0025 { 043 0 --p  053 0 --p  044 0 --p  054 0 --p }
1EB4: 0025 { 045 0 --p  055 0 --p  046 0 --p  056 0 --p }
1EB5: 0025 { 047 0 --p  057 0 --p  048 0 --p  058 0 --p }
1EB6: 0025 { 049 0 --p  059 0 --p  04A 0 --p  05A 0 --p }
1EB7: 0025 { 04B 0 --p  05B 0 --p  04C 0 --p  05C 0 --p }
1EB8: 0025 { 0F2 0 --p  182 0 --p  0F3 0 --p  183 0 --p }
1EB9: 0025 { 0F4 0 --p  184 0 --p  0F5 0 --p  185 0 --p }
1EBA: 0025 { 0F6 0 --p  186 0 --p  0F7 3 --p  187 3 --p }
1EBB: 0025 { 0F8 3 --p  188 3 --p  0F9 0 --p  189 0 --p }
1EBC: 0025 { 0FA 0 --p  18A 0 --p  0FB 0 --p  18B 0 --p }
1EBD: 0025 { 0FC 0 --p  18C 0 --p  0FD 0 --p  18D 0 --p }
1EBE: 0025 { 0FE 0 --p  18E 0 --p  0FF 0 --p  18F 0 --p }
1EBF: 0025 { 180 0 --p  190 0 --p  181 0 --p  191 0 --p }
1EC0: 0025 { 05D 0 --p  06B 0 --p  05E 0 --p  06C 0 --p }
1EC1: 0025 { 05F 0 --p  06D 0 --p  060 0 --p  06E 0 --p }
1EC2: 0025 { 061 0 --p  06F 0 --p  062 0 --p  070 0 --p }
1EC3: 0025 { 063 0 --p  071 0 --p  064 0 --p  072 0 --p }
1EC4: 0025 { 065 0 --p  073 0 --p  066 0 --p  074 0 --p }
1EC5: 0025 { 067 0 --p  075 0 --p  068 0 --p  076 0 --p }
1EC6: 0025 { 069 0 --p  077 0 --p  06A 0 --p  078 0 --p }
1EC7: 0025 { 03B 0 --p  03B 0 --p  04C 0 --p  079 0 --p }
1EC8: 0025 { 192 0 --p  03B 0 --p  193 0 --p  183 0 --p }
1EC9: 0025 { 194 0 --p  1A2 0 --p  195 0 --p  1A3 0 --p }
1ECA: 0025 { 1B2 0 --p  1BC 0 --p  1B3 3 --p  1BD 3 --p }
1ECB: 0025 { 188 3 --p  198 3 --p  1B4 0 --p  1BE 0 --p }
1ECC: 0025 { 19A 0 --p  1A8 0 --p  19B 0 --p  1A9 0 --p }
1ECD: 0025 { 19C 0 --p  1AA 0 --p  19D 0 --p  1AB 0 --p }
1ECE: 0025 { 19E 0 --p  07E 0 --p  19F 0 --p  1A9 0 --p }
1ECF: 0025 { 1A0 0 --p  1AC 0 --p  1A1 0 --p  1AD 0 --p }
1ED0: 0130 { 283 1 ---  291 1 ---  284 1 ---  294 1 --- }
1ED1: 0130 { 2A2 1 ---  2B2 1 ---  288 1 ---  2B3 1 --- }
1ED2: 0130 { 288 1 ---  298 1 ---  28D 1 ---  29D 1 --- }
1ED3: 0130 { 280 1 ---  290 1 ---  288 1 ---  2B3 1 --- }
1ED4: 0130 { 288 1 ---  298 1 ---  28E 1 ---  296 1 --- }
1ED5: 0130 { 28D 1 ---  29D 1 ---  293 1 -y-  293 1 --- }
1ED6: ~
1ED7: 0025 { 1E2 4 --p  1E2 4 --p  1E2 4 --p  1E2 4 --p }
1ED8: 0025 { 23C 2 ---  24C 2 ---  23D 2 ---  24D 2 --- }
1ED9: 0025 { 23E 2 ---  24E 2 ---  23F 2 ---  24F 2 --- }
1EDA: 0130 { 0FB 4 ---  0FB 4 ---  0FB 4 ---  0FB 4 --- }
1EDB: 0025 { 1A1 3 x--  1B1 3 x--  1A0 3 x--  1B0 3 x-- }
1EDC: 0025 { 1A0 3 ---  1B0 3 ---  1A1 3 ---  1B1 3 --- }
1EDD: 0130 { 26E 3 ---  27E 3 ---  26F 3 ---  27F 3 --- }
1EDE: 0130 { 26F 3 ---  27F 3 ---  26F 3 ---  27F 3 --- }
1EDF: 0130 { 26F 3 x--  27F 3 x--  26E 3 x--  27E 3 x-- }
1EE0: 0000 { 200 7 ---  210 7 ---  201 7 ---  211 7 --- }
1EE1: 0100 { 182 2 --p  192 2 --p  183 2 --p  193 2 --p }
1EE2: 01E4 { 194 2 --p  192 2 --p  186 2 x-p  193 2 --p }
1EE3: 01E4 { 186 2 --p  193 2 x-p  194 2 x-p  192 2 x-p }
1EE4: 01E4 { 193 2 xyp  186 2 -yp  192 2 xyp  194 2 xyp }
1EE5: ~
1EE6: 0025 { 24A 6 ---  25A 6 ---  24B 6 ---  25B 6 --- }
1EE7: 001F { 24A 6 ---  25A 6 ---  24B 6 ---  25B 6 --- }
1EE8: 0025 { 25C 2 ---  0F8 2 ---  25D 2 ---  26D 2 --- }
1EE9: 0025 { 25E 2 ---  0F8 2 ---  25F 2 ---  0F8 2 --- }
1EEA: 01AA { 0F8 3 ---  254 3 ---  245 3 ---  255 3 --- }
1EEB: 0025 { 1C1 3 x--  1C1 3 xy-  1C0 3 x--  1C0 3 xy- }
1EEC: 0025 { 1C0 3 ---  1C0 3 -y-  1C1 3 ---  1C1 3 -y- }
1EED: ~
1EEE: ~
1EEF: ~
1EF0: 0002 { 0FD 7 ---  0FD 7 ---  0FD 7 ---  0FD 7 --- }
1EF1: 003F { 194 2 --p  192 2 --p  195 2 --p  193 2 --p }
1EF2: ~
1EF3: ~
1EF4: ~
1EF5: ~
1EF6: 0025 { 26A 6 ---  26A 6 ---  26B 6 ---  26B 6 --- }
1EF7: 0020 { 26A 6 ---  26A 6 ---  26B 6 ---  26B 6 --- }
1EF8: 0025 { 0F8 2 ---  0F8 2 ---  27D 2 ---  27D 2 --- }
1EF9: 0025 { 0F8 2 ---  0F8 2 ---  0F8 2 ---  0F8 2 --- }
1EFA: 01AF { 245 3 x--  255 3 x--  0F8 3 x--  254 3 x-- }
1EFB: 0025 { 1B1 3 xy-  1A1 3 xy-  1B0 3 xy-  1A0 3 xy- }
1EFC: 0025 { 1B0 3 -y-  1A0 3 -y-  1B1 3 -y-  1A1 3 -y- }
1EFD: ~
1EFE: ~
1EFF: ~
