2C00: 01AA { 0F8 2 ---  201 2 ---  200 2 ---  202 2 --- }
2C01: 0130 { 206 1 x--  207 1 x--  205 1 x--  204 1 -y- }
2C02: 0130 { 203 1 ---  204 1 xy-  204 1 ---  203 1 xy- }
2C03: 0130 { 205 1 ---  204 1 xy-  206 1 ---  207 1 --- }
2C04: 0130 { 20C 1 ---  20D 1 ---  20D 1 xy-  20C 1 xy- }
2C05: 0130 { 207 1 xy-  206 1 xy-  204 1 ---  205 1 xy- }
2C06: 0130 { 204 1 x--  205 1 -y-  207 1 -y-  206 1 -y- }
2C07: 0025 { 0F8 2 ---  0F8 2 ---  0F8 2 ---  0F8 2 --- }
2C08: 0025 { 278 7 ---  278 7 ---  0F8 7 ---  0F8 7 --- }
2C09: 0025 { 0F8 7 ---  0F8 7 ---  278 7 ---  278 7 --- }
2C0A: 0025 { 100 3 ---  110 3 ---  101 3 ---  111 3 --- }
2C0B: 0025 { 102 3 ---  112 3 ---  07F 3 ---  07F 3 --- }
2C0C: 0025 { 120 3 ---  130 3 ---  121 3 ---  131 3 --- }
2C0D: 0025 { 122 3 ---  132 3 ---  07F 3 ---  07F 3 --- }
2C0E: 0025 { 07F 4 ---  07F 4 ---  103 4 ---  113 4 --- }
2C0F: 0025 { 104 4 ---  114 4 ---  105 4 ---  115 4 --- }
2C10: 0025 { 106 4 ---  116 4 ---  107 4 ---  117 4 --- }
2C11: 0025 { 07F 4 ---  07F 4 ---  123 4 ---  133 4 --- }
2C12: 0025 { 124 4 ---  134 4 ---  125 4 ---  135 4 --- }
2C13: 0025 { 126 4 ---  136 4 ---  127 4 ---  137 4 --- }
2C14: 0025 { 108 5 ---  118 5 ---  109 5 ---  119 5 --- }
2C15: 0025 { 10A 5 ---  11A 5 ---  10B 5 ---  11B 5 --- }
2C16: 0025 { 10C 5 ---  11C 5 ---  10D 5 ---  11D 5 --- }
2C17: 0025 { 10E 5 ---  11E 0 ---  10F 5 ---  11F 0 --- }
2C18: 0025 { 128 5 ---  138 5 ---  129 5 ---  139 5 --- }
2C19: 0025 { 12A 3 ---  13A 3 ---  12B 3 ---  13B 3 --- }
2C1A: 0025 { 12C 5 ---  13C 5 ---  12D 5 ---  13D 5 --- }
2C1B: 0025 { 12E 0 ---  13E 0 ---  12F 0 ---  13F 0 --- }
2C1C: 0025 { 148 5 ---  158 5 ---  149 5 ---  159 5 --- }
2C1D: 0025 { 14A 5 ---  15A 5 ---  14B 5 ---  15B 5 --- }
2C1E: 0025 { 14C 5 ---  15C 5 ---  14D 5 ---  15D 5 --- }
2C1F: 0025 { 14E 0 ---  15E 0 ---  14F 0 ---  15F 0 --- }
2C20: 0025 { 168 5 ---  07F 5 ---  169 5 ---  140 5 --- }
2C21: 0025 { 16A 5 ---  141 5 ---  16B 5 ---  142 5 --- }
2C22: 0025 { 16C 5 ---  143 5 ---  16D 5 ---  144 5 --- }
2C23: 0025 { 16E 5 ---  145 5 ---  16F 5 ---  07F 5 --- }
2C24: 003F { 030 7 ---  032 7 ---  031 7 ---  033 7 --- }
2C25: 0025 { 156 5 ---  166 5 ---  157 5 ---  167 5 --- }
2C26: 0025 { 160 3 ---  170 3 ---  161 3 ---  171 3 --- }
2C27: 0025 { 162 4 ---  172 4 ---  163 4 ---  173 4 --- }
2C28: 0025 { 164 5 ---  174 5 ---  165 5 ---  175 5 --- }
2C29: 0025 { 156 3 ---  166 3 ---  157 3 ---  167 3 --- }
2C2A: 0025 { 160 4 ---  170 4 ---  161 4 ---  171 4 --- }
2C2B: 0025 { 162 5 ---  172 5 ---  163 5 ---  173 5 --- }
2C2C: 0708 { 100 2 ---  110 2 ---  101 2 ---  111 2 --- }
2C2D: 0708 { 102 2 ---  112 2 ---  103 2 ---  113 2 --- }
2C2E: 003F { 10C 4 ---  11C 4 ---  10D 4 ---  11D 4 --- }
2C2F: 0100 { 10A 4 ---  11A 4 ---  10B 4 ---  11B 4 --- }
2C30: 0130 { 208 6 ---  20A 6 ---  209 6 ---  20B 6 --- }
2C31: 0130 { 20E 3 ---  210 3 ---  20F 3 ---  211 3 --- }
2C32: 0130 { 212 5 ---  214 5 ---  213 5 ---  215 5 --- }
2C33: 0130 { 216 6 ---  218 6 ---  217 6 ---  219 6 --- }
2C34: 0130 { 21A 6 ---  21C 6 ---  21B 6 ---  21D 6 --- }
2C35: 0025 { 0F8 0 ---  21E 5 ---  0F8 0 ---  21F 5 --- }
2C36: 0025 { 220 5 ---  223 5 ---  221 5 ---  224 5 --- }
2C37: 0025 { 221 5 x--  225 5 ---  222 5 ---  226 5 --- }
2C38: 0025 { 227 5 ---  229 5 ---  228 5 ---  22A 5 --- }
2C39: 0025 { 229 5 ---  229 5 ---  22A 5 ---  22A 5 --- }
2C3A: 0105 { 22C 7 x--  22E 5 x--  22B 7 x--  22D 5 x-- }
2C3B: 0105 { 22B 7 ---  22D 5 ---  22C 7 ---  22D 5 --- }
2C3C: 0020 { 231 3 x--  233 3 x--  230 3 x--  232 3 x-- }
2C3D: 0020 { 230 3 ---  232 3 ---  231 3 ---  233 3 --- }
2C3E: 0130 { 22F 4 ---  237 4 ---  236 4 ---  238 4 --- }
2C3F: 0004 { 15C 1 --p  15E 1 --p  15D 1 --p  15F 1 --p }
2C40: 0126 { 200 6 ---  202 6 ---  201 6 ---  203 6 --- }
2C41: 0025 { 0F8 5 ---  181 5 ---  0F8 5 ---  182 5 --- }
2C42: 0025 { 0CA 5 ---  0CE 5 ---  0CB 5 ---  0AC 5 --- }
2C43: 0025 { 0CD 5 xy-  0AD 5 ---  0CC 5 xy-  0CF 5 xy- }
2C44: 0004 { 0FB 3 ---  0FB 3 ---  0FB 3 ---  0FB 3 --- }
2C45: ~
2C46: 0025 { 19A 2 ---  1AA 2 ---  19B 2 ---  1AB 2 --- }
2C47: ~
2C48: 003F { 1CD 2 ---  1ED 2 ---  1CE 2 ---  1EE 2 --- }
2C49: 003F { 1CE 2 ---  1EE 2 ---  1CE 2 ---  1EE 2 --- }
2C4A: 003F { 1CE 2 ---  1EE 2 ---  1CF 2 ---  1EF 2 --- }
2C4B: 003F { 1CD 2 ---  1ED 2 ---  1CF 2 ---  1EF 2 --- }
2C4C: 0020 { 235 3 x--  235 3 xy-  234 3 x--  234 3 xy- }
2C4D: 0020 { 234 3 ---  234 3 -y-  235 3 ---  235 3 -y- }
2C4E: 0130 { 239 4 ---  23B 4 ---  23A 4 ---  23C 4 --- }
2C4F: 0005 { 0FC 1 --p  0FC 1 --p  0FC 1 --p  0FC 1 --p }
2C50: 0025 { 0F8 5 ---  0F8 5 ---  190 5 ---  1A0 5 --- }
2C51: 012F { 191 5 ---  1A1 5 ---  192 5 ---  1A2 5 --- }
2C52: 0025 { 0CF 5 ---  0CC 5 ---  0BC 5 ---  0CD 5 --- }
2C53: 0025 { 0BD 5 ---  0CB 5 xy-  0CE 5 xy-  0CA 5 xy- }
2C54: 0106 { 180 2 ---  1D0 2 ---  181 2 ---  191 2 --- }
2C55: 0106 { 180 2 ---  191 2 ---  181 2 ---  1D1 2 --- }
2C56: 0025 { 1BA 2 ---  1BA 2 ---  1BB 2 ---  1BB 2 --- }
2C57: 0130 { 186 5 ---  196 5 ---  187 5 ---  197 5 --- }
2C58: 0130 { 188 5 ---  198 5 ---  189 5 ---  199 5 --- }
2C59: 0130 { 18A 5 ---  19A 5 ---  18B 5 ---  19B 5 --- }
2C5A: 0130 { 18C 5 ---  19C 5 ---  18D 5 ---  19D 5 --- }
2C5B: 003F { 1CD 2 ---  1DD 2 ---  1CF 2 ---  1DF 2 --- }
2C5C: 0020 { 233 3 xy-  231 3 xy-  232 3 xy-  230 3 xy- }
2C5D: 0020 { 232 3 -y-  230 3 -y-  233 3 -y-  231 3 -y- }
2C5E: 0130 { 1A1 2 ---  182 2 ---  1A1 2 ---  1A0 2 --- }
2C5F: 0130 { 1A1 2 ---  1A2 2 ---  1A1 2 ---  182 2 --- }
2C60: 012A { 210 6 ---  212 6 ---  211 6 ---  213 6 --- }
2C61: 0025 { 1B1 5 ---  0F8 5 ---  1B2 5 ---  0F8 5 --- }
2C62: 0025 { 0F8 5 ---  0F8 5 ---  08C 5 ---  08C 5 --- }
2C63: 0025 { 09C 5 ---  09C 5 ---  0F8 5 ---  0F8 5 --- }
2C64: 003F { 1C0 2 ---  1C0 2 ---  1A1 2 ---  1A1 2 --- }
2C65: 003F { 1A1 2 ---  1A1 2 ---  1C1 2 ---  1C1 2 --- }
2C66: 0025 { 1BA 2 ---  1CA 2 ---  1BB 2 ---  1CB 2 --- }
2C67: 0130 { 1A6 5 ---  1B6 5 ---  1A7 5 ---  1B7 5 --- }
2C68: 0130 { 1A8 5 ---  1B8 5 ---  1A9 5 ---  1B9 5 --- }
2C69: 0130 { 1AA 5 ---  1BA 5 ---  1AB 5 ---  1BB 5 --- }
2C6A: 0130 { 1AC 5 ---  1BC 5 ---  1AD 5 ---  1BD 5 --- }
2C6B: 003F { 1DD 2 ---  1DD 2 ---  1DF 2 ---  1DF 2 --- }
2C6C: 002B { 1D7 6 ---  1E7 6 ---  1D8 6 ---  1E8 6 --- }
2C6D: 003F { 1A1 2 ---  1CD 2 ---  1CD 2 ---  1A6 2 --- }
2C6E: 003F { 1CE 2 ---  1DE 2 ---  1CE 2 ---  1DE 2 --- }
2C6F: 003F { 1CF 2 ---  1A5 2 ---  1A1 2 ---  1CF 2 --- }
2C70: 0025 { 20C 2 ---  206 2 ---  0F8 0 ---  209 2 --- }
2C71: 0025 { 206 2 ---  206 2 ---  0F8 0 ---  0F8 0 --- }
2C72: 0025 { 206 2 ---  207 2 ---  0F8 0 ---  208 2 --- }
2C73: 0025 { 0F8 0 ---  208 2 ---  0F8 0 ---  208 2 --- }
2C74: 0025 { 209 2 ---  208 2 ---  0F8 0 ---  20A 2 --- }
2C75: 0025 { 0F8 0 ---  20B 2 ---  0F8 0 ---  0F8 0 --- }
2C76: 0025 { 209 2 ---  0F8 0 ---  0F8 0 ---  209 2 --- }
2C77: 0130 { 1C6 5 ---  1D6 5 ---  1C7 5 ---  1D7 5 --- }
2C78: 0130 { 1C8 5 ---  1D8 5 ---  1C9 5 ---  1D9 5 --- }
2C79: 0130 { 1CA 5 ---  1DA 5 ---  1CB 5 ---  1DB 5 --- }
2C7A: 0130 { 1CC 5 ---  1DC 5 ---  1CD 5 ---  1DD 5 --- }
2C7B: 003F { 1DD 2 ---  1ED 2 ---  1DF 2 ---  1EF 2 --- }
2C7C: 0130 { 1C8 5 ---  1F8 5 ---  1C9 5 ---  1F9 5 --- }
2C7D: 003F { 1DD 2 ---  1DD 2 ---  1DE 2 ---  1DE 2 --- }
2C7E: 003F { 1DE 2 ---  1DE 2 ---  1DE 2 ---  1DE 2 --- }
2C7F: 003F { 1DE 2 ---  1DE 2 ---  1DF 2 ---  1DF 2 --- }
2C80: 0130 { 1C0 5 ---  1D0 5 ---  1A7 5 ---  1B7 5 --- }
2C81: 020C { 209 2 ---  208 2 ---  0F8 0 ---  20A 2 --- }
2C82: 020C { 200 2 ---  202 2 ---  201 2 ---  203 2 --- }
2C83: 0025 { 1B3 4 ---  1C3 4 ---  1B4 4 ---  1C2 4 --- }
2C84: 003F { 183 2 ---  191 2 ---  1A0 2 ---  193 2 --- }
2C85: 003F { 1A2 2 ---  194 2 ---  183 2 ---  191 2 --- }
2C86: 003F { 195 2 ---  1A5 2 ---  196 2 ---  1A6 2 --- }
2C87: 0130 { 186 6 ---  196 6 ---  187 6 ---  197 6 --- }
2C88: 0130 { 188 6 ---  198 6 ---  189 6 ---  199 6 --- }
2C89: 0130 { 18A 6 ---  19A 6 ---  18B 6 ---  19B 6 --- }
2C8A: 0130 { 18C 6 ---  19C 6 ---  18D 6 ---  19D 6 --- }
2C8B: 003F { 1DE 2 ---  1DE 2 ---  1DE 2 ---  195 2 --- }
2C8C: 003F { 1DE 2 ---  196 2 ---  1DE 2 ---  1DE 2 --- }
2C8D: 003F { 1ED 2 ---  1A1 2 ---  196 2 ---  1ED 2 --- }
2C8E: 003F { 1DE 2 ---  1EE 2 ---  1DE 2 ---  1EE 2 --- }
2C8F: 003F { 195 2 ---  1EF 2 ---  1EF 2 ---  1A1 2 --- }
2C90: 0130 { 1C0 6 ---  1D0 6 ---  1A7 6 ---  1B7 6 --- }
2C91: 0130 { 1AC 6 ---  1BC 6 ---  1C1 6 ---  1D1 6 --- }
2C92: 020C { 0FB 2 ---  0FB 2 ---  0FB 2 ---  0FB 2 --- }
2C93: 0025 { 1D3 4 ---  1E5 4 ---  1D2 4 ---  1E6 4 --- }
2C94: 003F { 1B1 2 ---  182 2 ---  1A3 2 ---  1A0 2 --- }
2C95: 003F { 1A4 2 ---  1A2 2 ---  1B1 2 ---  182 2 --- }
2C96: 0025 { 0F8 5 ---  1B7 6 ---  0F8 5 ---  1B8 6 --- }
2C97: 0130 { 1A6 6 ---  1B6 6 ---  1A7 6 ---  1B7 6 --- }
2C98: 0130 { 1A8 6 ---  1B8 6 ---  1A9 6 ---  1B9 6 --- }
2C99: 0130 { 1AA 6 ---  1BA 6 ---  1AB 6 ---  1BB 6 --- }
2C9A: 0130 { 1AC 6 ---  1BC 6 ---  1AD 6 ---  1BD 6 --- }
2C9B: 003F { 1DE 2 ---  1DE 2 ---  1A5 2 ---  1DE 2 --- }
2C9C: 003F { 1A6 2 ---  1DE 2 ---  1DE 2 ---  1DE 2 --- }
2C9D: 0130 { 1CA 6 ---  1FA 6 ---  1CB 6 ---  1FB 6 --- }
2C9E: 0106 { 1AC 2 ---  1BE 2 ---  1AD 2 ---  1BD 2 --- }
2C9F: 0106 { 1AE 2 ---  1BE 2 ---  1AF 2 ---  1BD 2 --- }
2CA0: 0025 { 200 2 ---  202 2 ---  201 2 ---  203 2 --- }
2CA1: 0025 { 0FB 2 ---  0FB 2 ---  0FB 2 ---  0FB 2 --- }
2CA2: 0025 { 200 2 ---  202 2 ---  201 2 ---  203 2 --- }
2CA3: 0025 { 200 2 ---  202 2 ---  201 2 ---  203 2 --- }
2CA4: 0130 { 204 2 ---  0FD 2 ---  204 2 ---  0FD 2 --- }
2CA5: ~
2CA6: 0025 { 1E0 2 ---  1F0 2 ---  1E1 2 ---  1F1 2 --- }
2CA7: 0130 { 1C6 6 ---  1D6 6 ---  1C7 6 ---  1D7 6 --- }
2CA8: 0130 { 1C8 6 ---  1D8 6 ---  1C9 6 ---  1D9 6 --- }
2CA9: 0130 { 1CA 6 ---  1DA 6 ---  1CB 6 ---  1DB 6 --- }
2CAA: 0130 { 1CC 6 ---  1DC 6 ---  1CD 6 ---  1DD 6 --- }
2CAB: 003F { 1A6 2 ---  1DE 2 ---  1DE 2 ---  195 2 --- }
2CAC: 003F { 1DE 2 ---  196 2 ---  1A5 2 ---  1DE 2 --- }
2CAD: 0130 { 1AC 2 ---  1BC 2 ---  1AF 2 ---  1BD 2 --- }
2CAE: 0106 { 1AC 2 ---  1BE 2 ---  1AF 2 ---  1BD 2 --- }
2CAF: 0025 { 1D5 4 ---  1E5 4 ---  1D6 4 ---  1E6 4 --- }
2CB0: 0025 { 200 2 ---  202 2 ---  201 2 ---  203 2 --- }
2CB1: 0025 { 200 2 ---  202 2 ---  201 2 ---  203 2 --- }
2CB2: 0025 { 200 2 ---  202 2 ---  201 2 ---  203 2 --- }
2CB3: 0025 { 0FB 2 ---  0FB 2 ---  0FB 2 ---  0FB 2 --- }
2CB4: 0130 { 0FD 2 ---  0FD 2 ---  0FD 2 ---  0FD 2 --- }
2CB5: 0130 { 0FD 2 ---  0FD 2 ---  205 2 ---  205 2 --- }
2CB6: 0025 { 1F0 2 ---  1F0 2 ---  1F1 2 ---  1F1 2 --- }
2CB7: 0196 { 0F8 2 ---  188 2 ---  0F8 2 ---  189 2 --- }
2CB8: 019B { 188 2 ---  185 2 ---  189 2 ---  193 2 --- }
2CB9: 01A0 { 18A 2 ---  194 2 ---  18B 2 ---  186 2 --- }
2CBA: 01A5 { 0F8 2 ---  18A 2 ---  0F8 2 ---  18B 2 --- }
2CBB: 01AA { 0F8 2 ---  184 2 ---  184 2 ---  185 2 --- }
2CBC: 01AF { 187 2 ---  186 2 ---  0F8 2 ---  187 2 --- }
2CBD: 0106 { 1B5 2 ---  1BC 2 ---  1AD 2 ---  1BD 2 --- }
2CBE: 0106 { 1AE 2 ---  1BE 2 ---  1AD 2 ---  1BD 2 --- }
2CBF: 0106 { 1AE 2 ---  1BE 2 ---  1B6 2 ---  1BF 2 --- }
2CC0: 0025 { 200 2 ---  202 2 ---  201 2 ---  203 2 --- }
2CC1: 0025 { 200 2 ---  202 2 ---  201 2 ---  203 2 --- }
2CC2: 0025 { 0FB 2 ---  0FB 2 ---  0FB 2 ---  0FB 2 --- }
2CC3: 0025 { 200 2 ---  202 2 ---  201 2 ---  203 2 --- }
2CC4: 0130 { 0FD 2 ---  20E 2 ---  0FD 2 ---  20E 2 --- }
2CC5: 0130 { 0FD 2 ---  20E 2 ---  205 2 ---  20D 2 --- }
2CC6: 0025 { 1F0 2 ---  1F2 2 ---  1F1 2 ---  1F3 2 --- }
2CC7: 01DE { 185 2 ---  1A1 2 ---  193 2 ---  1A1 2 --- }
2CC8: 003F { 1A1 2 ---  1A1 2 ---  1A1 2 ---  1A1 2 --- }
2CC9: 003F { 1A1 2 ---  1A1 2 ---  1A1 2 ---  1A1 2 --- }
2CCA: 01E0 { 194 2 ---  1A1 2 ---  186 2 ---  1A1 2 --- }
2CCB: 01E2 { 185 2 ---  1A1 2 ---  193 2 ---  1A1 2 --- }
2CCC: 01E4 { 194 2 ---  1A1 2 ---  186 2 ---  1A1 2 --- }
2CCD: 0025 { 18C 2 ---  19C 2 ---  18D 2 ---  19D 2 --- }
2CCE: 0025 { 18E 2 ---  19E 2 ---  18D 2 ---  19D 2 --- }
2CCF: 0025 { 18E 2 ---  19E 2 ---  18F 2 ---  19F 2 --- }
2CD0: 0025 { 0FB 2 ---  0FB 2 ---  0FB 2 ---  0FB 2 --- }
2CD1: 0025 { 200 2 ---  202 2 ---  201 2 ---  203 2 --- }
2CD2: 0025 { 200 2 ---  202 2 ---  201 2 ---  203 2 --- }
2CD3: 0025 { 200 2 ---  202 2 ---  201 2 ---  203 2 --- }
2CD4: 0130 { 186 2 ---  196 2 ---  187 2 ---  197 2 --- }
2CD5: 0100 { 188 2 ---  198 2 ---  189 2 ---  199 2 --- }
2CD6: 0130 { 18A 2 ---  19A 2 ---  18B 2 ---  19B 2 --- }
2CD7: 0130 { 18C 2 ---  19C 2 ---  18D 2 ---  19D 2 --- }
2CD8: 0130 { 18E 2 ---  19E 2 ---  18F 2 ---  19F 2 --- }
2CD9: 01AA { 1E0 2 ---  1F0 2 ---  1E1 2 ---  1F1 2 --- }
2CDA: 0000 { 04C 0 --p  04E 0 --p  04D 0 --p  04F 0 --p }
2CDB: 0025 { 0F8 5 ---  1C7 2 ---  0F8 5 ---  1C7 2 x-- }
2CDC: 0025 { 0F8 5 ---  1B7 5 ---  0F8 5 ---  1B8 5 --- }
2CDD: 0130 { 180 2 ---  182 2 ---  181 2 ---  190 2 --- }
2CDE: 0100 { 180 2 ---  191 2 ---  181 2 ---  191 2 --- }
2CDF: 0130 { 180 2 ---  192 2 ---  181 2 ---  182 2 --- }
2CE0: 0025 { 279 7 ---  279 7 ---  279 7 ---  279 7 --- }
2CE1: 013D { 02E 6 ---  03E 6 ---  02E 6 ---  03E 6 --- }
2CE2: 013B { 005 6 x--  015 6 x--  004 6 x--  014 6 x-- }
2CE3: ~
2CE4: 0130 { 1A6 2 ---  1B6 2 ---  1A7 2 ---  1B7 2 --- }
2CE5: 0025 { 1A8 2 ---  1B8 2 ---  1A9 2 ---  1B9 2 --- }
2CE6: 0130 { 1AA 2 ---  1BA 2 ---  1AB 2 ---  1BB 2 --- }
2CE7: 0130 { 1AC 2 ---  1BC 2 ---  1AD 2 ---  1BD 2 --- }
2CE8: 0130 { 1AE 2 ---  1BE 2 ---  1AF 2 ---  1BF 2 --- }
2CE9: 01E2 { 1E2 2 ---  1F2 2 ---  1E3 2 ---  1F3 2 --- }
2CEA: 020C { 1E0 0 --p  1E0 0 --p  1E0 0 --p  1E0 0 --p }
2CEB: 0025 { 197 2 ---  1A7 2 ---  198 2 ---  1A8 2 --- }
2CEC: 0025 { 1E2 2 ---  0F8 5 ---  1E2 2 ---  0F8 5 --- }
2CED: 0130 { 183 2 ---  182 2 ---  1A0 2 ---  1A0 2 --- }
2CEE: 2B79 { 1A1 2 ---  1A1 2 ---  1A1 2 ---  1A1 2 --- }
2CEF: 0130 { 1A2 2 ---  1A2 2 ---  183 2 ---  182 2 --- }
2CF0: 0025 { 202 4 ---  212 4 ---  203 4 ---  213 4 --- }
2CF1: 013E { 02F 6 ---  03F 6 ---  02F 6 ---  03F 6 --- }
2CF2: 013C { 025 6 x--  035 6 x--  024 6 x--  034 6 x-- }
2CF3: ~
2CF4: 0130 { 1C6 2 ---  1D6 2 ---  1C7 2 ---  1D7 2 --- }
2CF5: 0130 { 1C8 2 ---  1D8 2 ---  1C9 2 ---  1D9 2 --- }
2CF6: 0130 { 1CA 2 ---  1DA 2 ---  1CB 2 ---  1DB 2 --- }
2CF7: ~
2CF8: ~
2CF9: ~
2CFA: ~
2CFB: ~
2CFC: ~
2CFD: 0130 { 183 2 ---  180 2 ---  1B0 2 ---  181 2 --- }
2CFE: 0130 { 1B1 2 ---  180 2 ---  1B1 2 ---  181 2 --- }
2CFF: 0130 { 1B2 2 ---  180 2 ---  183 2 ---  181 2 --- }
