2E00: 0025 { 200 7 ---  200 7 ---  200 7 ---  200 7 --- }
2E01: 0025 { 200 7 ---  209 7 ---  200 7 ---  20A 7 --- }
2E02: 0025 { 201 7 ---  20B 7 ---  202 7 ---  20C 7 --- }
2E03: 0025 { 203 7 ---  20D 7 ---  204 7 ---  20E 7 --- }
2E04: 0025 { 205 7 ---  20F 7 ---  206 7 ---  210 7 --- }
2E05: 0025 { 207 7 ---  211 7 ---  208 7 ---  212 7 --- }
2E06: 0025 { 200 7 ---  213 7 ---  200 7 ---  214 7 --- }
2E07: 0025 { 200 7 ---  14C 7 ---  200 7 ---  200 7 --- }
2E08: 0025 { 215 7 ---  222 7 ---  216 7 ---  223 7 --- }
2E09: 0025 { 217 7 ---  224 7 ---  218 7 ---  225 7 --- }
2E0A: 0025 { 219 7 ---  226 7 ---  21A 7 ---  227 7 --- }
2E0B: 0025 { 21B 7 ---  228 7 ---  21C 7 ---  229 7 --- }
2E0C: 0025 { 21D 7 ---  22A 7 ---  21E 7 ---  22B 7 --- }
2E0D: 0025 { 21F 7 ---  22C 7 ---  220 7 ---  22D 7 --- }
2E0E: 0025 { 221 7 ---  22E 7 ---  200 7 ---  22F 7 --- }
2E0F: 0025 { 14D 7 ---  200 7 ---  200 7 ---  200 7 --- }
2E10: 0025 { 230 7 ---  23E 7 ---  231 7 ---  23F 7 --- }
2E11: 0025 { 232 7 ---  240 7 ---  233 7 ---  241 7 --- }
2E12: 0025 { 234 7 ---  242 7 ---  235 7 ---  243 7 --- }
2E13: 0025 { 236 7 ---  244 7 ---  237 7 ---  245 7 --- }
2E14: 0025 { 238 7 ---  246 7 ---  239 7 ---  247 7 --- }
2E15: 0025 { 23A 7 ---  248 7 ---  23B 7 ---  249 7 --- }
2E16: 0025 { 23C 7 ---  24A 7 ---  23D 7 ---  24B 7 --- }
2E17: 0025 { 14E 7 ---  200 7 ---  200 7 ---  200 7 --- }
2E18: 0025 { 24C 7 ---  25A 7 ---  24D 7 ---  25B 7 --- }
2E19: 0025 { 24E 7 ---  25C 7 ---  24F 7 ---  25D 7 --- }
2E1A: 0025 { 250 7 ---  25E 7 ---  251 7 ---  25F 7 --- }
2E1B: 0025 { 252 7 ---  260 7 ---  253 7 ---  261 7 --- }
2E1C: 0025 { 254 7 ---  262 7 ---  255 7 ---  263 7 --- }
2E1D: 0025 { 256 7 ---  264 7 ---  257 7 ---  265 7 --- }
2E1E: 0025 { 258 7 ---  266 7 ---  259 7 ---  267 7 --- }
2E1F: 0025 { 200 7 ---  200 7 ---  200 7 ---  276 7 --- }
2E20: 0025 { 268 7 ---  277 7 ---  269 7 ---  278 7 --- }
2E21: 0025 { 26A 7 ---  279 7 ---  26B 7 ---  27A 7 --- }
2E22: 0025 { 26C 7 ---  27B 7 ---  26D 7 ---  27C 7 --- }
2E23: 0025 { 26E 7 ---  27D 7 ---  26F 7 ---  27E 7 --- }
2E24: 0025 { 270 7 ---  27F 7 ---  271 7 ---  280 7 --- }
2E25: 0025 { 272 7 ---  281 7 ---  273 7 ---  282 7 --- }
2E26: 0025 { 274 7 ---  283 7 ---  275 7 ---  284 7 --- }
2E27: 0025 { 200 7 ---  294 7 ---  285 7 ---  295 7 --- }
2E28: 0025 { 286 7 ---  296 7 ---  287 7 ---  297 7 --- }
2E29: 0025 { 288 7 ---  298 7 ---  289 7 ---  299 7 --- }
2E2A: 0025 { 28A 7 ---  29A 7 ---  28B 7 ---  29B 7 --- }
2E2B: 0025 { 28C 7 ---  29C 7 ---  28D 7 ---  29D 7 --- }
2E2C: 0025 { 28E 7 ---  29E 7 ---  28F 7 ---  29F 7 --- }
2E2D: 0025 { 290 7 ---  2A0 7 ---  291 7 ---  2A1 7 --- }
2E2E: 0025 { 292 7 ---  2A2 7 ---  293 7 ---  2A3 7 --- }
2E2F: 0025 { 2A4 7 ---  2B4 7 ---  2A5 7 ---  2B5 7 --- }
2E30: 0025 { 2A6 7 ---  2B6 7 ---  2A7 7 ---  2B7 7 --- }
2E31: 0025 { 2A8 7 ---  2B8 7 ---  2A9 7 ---  2B9 7 --- }
2E32: 0025 { 2AA 7 ---  2BA 7 ---  2AB 7 ---  2BB 7 --- }
2E33: 0025 { 2AC 7 ---  2BC 7 ---  2AD 7 ---  2BD 7 --- }
2E34: 0025 { 2AE 7 ---  2BE 7 ---  2AF 7 ---  2BF 7 --- }
2E35: 0025 { 2B0 7 ---  2C0 7 ---  2B1 7 ---  2C1 7 --- }
2E36: 0025 { 2B2 7 ---  2C2 7 ---  2B3 7 ---  2C3 7 --- }
2E37: 0025 { 2C4 7 ---  2D4 7 ---  2C5 7 ---  2D5 7 --- }
2E38: 0025 { 2C6 7 ---  2D6 7 ---  2C7 7 ---  2D7 7 --- }
2E39: 0025 { 2C8 7 ---  2D8 7 ---  2C9 7 ---  2D9 7 --- }
2E3A: 0025 { 2CA 7 ---  2DA 7 ---  2CB 7 ---  2DB 7 --- }
2E3B: 0025 { 2CC 7 ---  2DC 7 ---  2CD 7 ---  2DD 7 --- }
2E3C: 0025 { 2CE 7 ---  2DE 7 ---  2CF 7 ---  2DF 7 --- }
2E3D: 0025 { 2D0 7 ---  2E0 7 ---  2D1 7 ---  2E1 7 --- }
2E3E: 0025 { 2D2 7 ---  2E2 7 ---  2D3 7 ---  2E3 7 --- }
2E3F: 0025 { 2E4 7 ---  200 7 ---  2E5 7 ---  2F4 7 --- }
2E40: 0025 { 2E6 7 ---  2F5 7 ---  2E7 7 ---  200 7 --- }
2E41: 0025 { 2E8 7 ---  2F6 7 ---  2E9 7 ---  2F7 7 --- }
2E42: 0025 { 2EA 7 ---  2F8 7 ---  2EB 7 ---  2F9 7 --- }
2E43: 0025 { 2EC 7 ---  2FA 7 ---  2ED 7 ---  2FB 7 --- }
2E44: 0025 { 2EE 7 ---  2FC 7 ---  2EF 7 ---  2FD 7 --- }
2E45: 0025 { 2F0 7 ---  2FE 7 ---  2F1 7 ---  2FF 7 --- }
2E46: 0025 { 2F2 7 ---  140 7 ---  2F3 7 ---  141 7 --- }
2E47: 0025 { 200 7 ---  200 7 ---  142 7 ---  200 7 --- }
2E48: 0025 { 143 7 ---  200 7 ---  144 7 ---  200 7 --- }
2E49: 0025 { 145 7 ---  200 7 ---  200 7 ---  200 7 --- }
2E4A: 0025 { 146 7 ---  147 7 ---  200 7 ---  200 7 --- }
2E4B: 0025 { 148 7 ---  149 7 ---  200 7 ---  200 7 --- }
2E4C: 0025 { 14A 7 ---  14B 7 ---  200 7 ---  200 7 --- }
2E4D: 0025 { 200 7 ---  200 7 ---  200 7 ---  200 7 --- }
2E4E: 0025 { 200 7 ---  200 7 ---  200 7 ---  200 7 --- }
2E4F: 0025 { 200 7 ---  200 7 ---  200 7 ---  200 7 --- }
2E50: 0133 { 000 1 ---  010 1 ---  001 1 ---  011 1 --- }
2E51: 0134 { 002 1 ---  012 1 ---  003 1 ---  013 1 --- }
2E52: 0133 { 000 3 ---  010 3 ---  001 3 ---  011 3 --- }
2E53: 0134 { 002 3 ---  012 3 ---  003 3 ---  013 3 --- }
2E54: 0133 { 000 4 ---  010 4 ---  001 4 ---  011 4 --- }
2E55: 0134 { 002 4 ---  012 4 ---  003 4 ---  013 4 --- }
2E56: 0133 { 000 5 ---  010 5 ---  001 5 ---  011 5 --- }
2E57: 0134 { 002 5 ---  012 5 ---  003 5 ---  013 5 --- }
2E58: 0133 { 000 6 ---  010 6 ---  001 6 ---  011 6 --- }
2E59: 0134 { 002 6 ---  012 6 ---  003 6 ---  013 6 --- }
2E5A: 0133 { 000 7 ---  010 7 ---  001 7 ---  011 7 --- }
2E5B: 0134 { 002 7 ---  012 7 ---  003 7 ---  013 7 --- }
2E5C: ~
2E5D: ~
2E5E: ~
2E5F: ~
2E60: 0135 { 020 1 ---  020 1 ---  021 1 ---  021 1 --- }
2E61: 0136 { 022 1 ---  022 1 ---  023 1 ---  023 1 --- }
2E62: 0135 { 020 3 ---  020 3 ---  021 3 ---  021 3 --- }
2E63: 0136 { 022 3 ---  022 3 ---  023 3 ---  023 3 --- }
2E64: 0135 { 020 4 ---  020 4 ---  021 4 ---  021 4 --- }
2E65: 0136 { 022 4 ---  022 4 ---  023 4 ---  023 4 --- }
2E66: 0135 { 020 5 ---  020 5 ---  021 5 ---  021 5 --- }
2E67: 0136 { 022 5 ---  022 5 ---  023 5 ---  023 5 --- }
2E68: 0135 { 020 6 ---  020 6 ---  021 6 ---  021 6 --- }
2E69: 0136 { 022 6 ---  022 6 ---  023 6 ---  023 6 --- }
2E6A: 0135 { 020 7 ---  020 7 ---  021 7 ---  021 7 --- }
2E6B: 0136 { 022 7 ---  022 7 ---  023 7 ---  023 7 --- }
2E6C: ~
2E6D: ~
2E6E: ~
2E6F: ~
2E70: 0025 { 082 0 ---  08B 0 ---  083 0 ---  08C 0 --- }
2E71: 0025 { 084 0 ---  08D 0 ---  085 0 ---  08E 0 --- }
2E72: 0025 { 086 0 ---  08F 0 ---  087 0 ---  092 0 --- }
2E73: 0025 { 086 0 ---  093 0 ---  086 0 x--  093 0 x-- }
2E74: 0025 { 088 0 ---  094 0 ---  085 0 ---  08E 0 --- }
2E75: 0025 { 089 0 ---  095 0 ---  086 0 x--  096 0 --- }
2E76: 0025 { 085 0 ---  08E 0 ---  085 0 ---  08E 0 --- }
2E77: 0025 { 085 0 ---  08E 0 ---  08A 0 ---  097 0 --- }
2E78: 0025 { 0A8 7 ---  0B8 7 ---  0A9 7 ---  0B9 7 --- }
2E79: 0025 { 0C8 7 ---  0D8 7 ---  0C9 7 ---  0D9 7 --- }
2E7A: ~
2E7B: ~
2E7C: ~
2E7D: ~
2E7E: ~
2E7F: ~
2E80: 0025 { 08B 0 ---  0A8 0 ---  099 0 ---  0C0 0 --- }
2E81: 0025 { 09A 0 ---  0C0 0 ---  09A 0 ---  0C0 0 --- }
2E82: 0025 { 09B 0 ---  0C0 0 ---  09C 0 ---  0C0 0 --- }
2E83: 0025 { 09D 0 ---  0C0 0 ---  09D 0 ---  0C0 0 --- }
2E84: 0025 { 09C 0 x--  0C0 0 ---  09C 0 ---  0C0 0 --- }
2E85: 0025 { 09E 0 ---  0C0 0 ---  09F 0 ---  0C0 0 --- }
2E86: 0025 { 09A 0 ---  0C0 0 ---  09A 0 ---  0C0 0 --- }
2E87: 0025 { 09A 0 ---  0C0 0 ---  097 0 ---  0A8 0 x-- }
2E88: 0020 { 0AD 7 x--  0BD 7 x--  0AC 7 x--  0BC 7 x-- }
2E89: 0020 { 0AC 7 ---  0BC 7 ---  0AD 7 ---  0BD 7 --- }
2E8A: ~
2E8B: ~
2E8C: ~
2E8D: ~
2E8E: ~
2E8F: ~
2E90: 0025 { 0C1 0 ---  0C3 0 ---  0C2 0 ---  0C4 0 --- }
2E91: 0025 { 0C2 0 ---  0E7 0 ---  0C2 0 ---  0E7 0 --- }
2E92: 0025 { 0C2 0 ---  0E7 0 ---  0C2 0 ---  0E7 0 --- }
2E93: 0025 { 0C2 0 ---  0E7 0 ---  0C2 0 ---  0E7 0 --- }
2E94: 0025 { 0C2 0 ---  0E7 0 ---  0C2 0 ---  0E7 0 --- }
2E95: 0025 { 0C2 0 ---  0E7 0 ---  0C2 0 ---  0E7 0 --- }
2E96: 0025 { 0C2 0 ---  0E7 0 ---  0C2 0 ---  0E7 0 --- }
2E97: 0025 { 0C2 0 ---  0E7 0 ---  0C1 0 x--  0C5 0 --- }
2E98: 0020 { 0CD 7 x--  0CD 7 xy-  0CC 7 x--  0CC 7 xy- }
2E99: 0020 { 0CC 7 ---  0CC 7 -y-  0CD 7 ---  0CD 7 -y- }
2E9A: ~
2E9B: ~
2E9C: ~
2E9D: ~
2E9E: ~
2E9F: ~
2EA0: 0025 { 0C3 0 ---  0C3 0 ---  0E8 0 x--  0E8 0 x-- }
2EA1: 0025 { 0C6 0 ---  0FE 0 ---  0C6 0 x--  0FE 0 --- }
2EA2: 0025 { 0FE 0 ---  0FE 0 ---  0FE 0 ---  0FE 0 --- }
2EA3: 0025 { 0FE 0 ---  0FE 0 ---  0FE 0 ---  0FE 0 --- }
2EA4: 0025 { 0FE 0 ---  0FE 0 ---  0FE 0 ---  0FE 0 --- }
2EA5: 0025 { 0FE 0 ---  0FE 0 ---  0FE 0 ---  0FE 0 --- }
2EA6: 0025 { 0C7 0 ---  0FE 0 ---  0F0 0 xy-  0FE 0 --- }
2EA7: 0025 { 0FE 0 ---  0FE 0 ---  0C8 0 ---  0C8 0 --- }
2EA8: 0020 { 0BD 7 xy-  0AD 7 xy-  0BC 7 xy-  0AC 7 xy- }
2EA9: 0020 { 0BC 7 -y-  0AC 7 -y-  0BD 7 -y-  0AD 7 -y- }
2EAA: ~
2EAB: ~
2EAC: ~
2EAD: ~
2EAE: ~
2EAF: ~
2EB0: 0025 { 0C3 0 ---  0C3 0 ---  0E8 0 x--  0E8 0 x-- }
2EB1: 0025 { 0FE 0 ---  0FE 0 ---  0FE 0 ---  0FE 0 --- }
2EB2: 0025 { 0FE 0 ---  0FE 0 ---  0FE 0 ---  0FE 0 --- }
2EB3: 0025 { 0FE 0 ---  0FE 0 ---  0FE 0 ---  0FE 0 --- }
2EB4: 0025 { 0C9 0 ---  0CD 0 ---  0CA 0 ---  0D0 0 --- }
2EB5: 0025 { 0CB 0 ---  0D1 0 ---  0FE 0 ---  0FE 0 --- }
2EB6: 0025 { 0FE 0 ---  0FE 0 ---  0FE 0 ---  0FE 0 --- }
2EB7: 0025 { 0FE 0 ---  0FE 0 ---  0C8 0 ---  0C8 0 --- }
2EB8: ~
2EB9: ~
2EBA: ~
2EBB: ~
2EBC: ~
2EBD: ~
2EBE: ~
2EBF: ~
2EC0: 0025 { 0C3 0 ---  0C1 0 -y-  0D4 0 ---  0DE 0 --- }
2EC1: 0025 { 0CC 0 x--  0DF 0 ---  0FE 0 ---  0E0 0 --- }
2EC2: 0025 { 0FE 0 ---  0E0 0 ---  0D9 0 ---  0E0 0 --- }
2EC3: 0025 { 0CC 0 x--  0DF 0 ---  0FE 0 ---  0E0 0 --- }
2EC4: 0025 { 0D6 0 ---  0E1 0 ---  0D7 0 ---  0E4 0 --- }
2EC5: 0025 { 0D8 0 ---  0E5 0 ---  0FE 0 ---  0E0 0 --- }
2EC6: 0025 { 0FE 0 ---  0E0 0 ---  0D5 0 ---  0E0 0 --- }
2EC7: 0025 { 0FE 0 ---  0E0 0 ---  0C8 0 ---  0E6 0 --- }
2EC8: 0025 { 0F8 4 ---  0F8 4 ---  1A1 2 x--  1A1 2 xy- }
2EC9: 0025 { 0F8 4 ---  0F8 4 ---  1A1 2 x--  1A2 2 --- }
2ECA: 0025 { 0F8 4 -y-  0F8 4 -y-  1A2 2 -y-  1A1 2 xy- }
2ECB: 0025 { 1CE 2 ---  1D5 2 ---  0F8 4 ---  1CB 2 --- }
2ECC: 020C { 1E2 5 ---  1F2 5 ---  1E3 5 ---  1F3 5 --- }
2ECD: 0025 { 0F8 4 ---  1CD 2 ---  0F8 4 ---  1CE 2 --- }
2ECE: ~
2ECF: ~
2ED0: 0025 { 1CF 2 ---  1D2 2 ---  1C0 2 ---  1D4 2 --- }
2ED1: 0025 { 1D1 2 ---  1C1 2 ---  1D1 2 ---  1CB 2 --- }
2ED2: 0025 { 1CE 2 ---  1D5 2 ---  1D3 2 ---  1CB 2 --- }
2ED3: 0025 { 0F8 4 ---  0F8 4 ---  1C3 2 ---  1C0 2 --- }
2ED4: 0025 { 1C0 2 ---  1C1 2 ---  1D1 2 ---  1D8 2 --- }
2ED5: 0025 { 1CA 2 ---  1D2 2 ---  1DA 2 x--  1D2 2 --- }
2ED6: 0100 { 180 2 ---  0F8 4 ---  180 2 x--  0F8 4 --- }
2ED7: 0130 { 0F8 4 -y-  180 2 -y-  0F8 4 -y-  180 2 xy- }
2ED8: 0025 { 191 2 ---  1A1 2 ---  192 2 ---  1A1 2 x-- }
2ED9: 0025 { 0F8 4 x--  0F8 4 x--  190 2 x--  190 2 x-- }
2EDA: 0025 { 0F8 4 ---  184 2 ---  0F8 4 ---  184 2 xy- }
2EDB: 0025 { 184 2 ---  0F8 4 ---  184 2 xy-  0F8 4 --- }
2EDC: 0025 { 185 2 ---  0F8 4 ---  186 2 ---  0F8 4 --- }
2EDD: 0025 { 187 2 ---  187 2 xy-  0F8 4 ---  0F8 4 --- }
2EDE: 0025 { 0F8 4 ---  197 2 ---  0F8 4 ---  198 2 --- }
2EDF: 0025 { 199 2 ---  1A9 2 ---  19A 2 ---  1AA 2 --- }
2EE0: 0025 { 188 2 ---  188 2 ---  188 2 ---  188 2 --- }
2EE1: 0025 { 189 2 ---  189 2 ---  189 2 ---  189 2 --- }
2EE2: 0025 { 18A 2 ---  18A 2 ---  18A 2 ---  18A 2 --- }
2EE3: 0025 { 18B 2 ---  18B 2 ---  18B 2 ---  18B 2 --- }
2EE4: 0025 { 18C 2 ---  18C 2 ---  18C 2 ---  18C 2 --- }
2EE5: 0025 { 18D 2 ---  18D 2 ---  18D 2 ---  18D 2 --- }
2EE6: 0025 { 18E 2 ---  18E 2 ---  18E 2 ---  18E 2 --- }
2EE7: 0025 { 18F 2 ---  18F 2 ---  18F 2 ---  18F 2 --- }
2EE8: 0020 { 1A2 2 x--  1B1 2 ---  1A2 2 ---  1B1 2 x-- }
2EE9: 003F { 1DA 2 ---  0F8 4 ---  0F8 4 ---  0F8 4 --- }
2EEA: 0025 { 191 2 ---  1A4 2 ---  186 2 ---  0F8 4 --- }
2EEB: 0130 { 195 2 ---  195 2 -y-  195 2 x--  195 2 xy- }
2EEC: 0025 { 1C4 2 ---  1CD 2 ---  1D7 2 ---  1C4 2 --- }
2EED: 0025 { 0F8 4 ---  0F8 4 ---  187 2 ---  187 2 xy- }
2EEE: 0025 { 1A7 2 ---  1B7 2 ---  1A8 2 ---  1B8 2 --- }
2EEF: 0025 { 196 2 ---  196 2 -y-  196 2 x--  196 2 xy- }
2EF0: 0025 { 1C0 0 ---  1C2 0 ---  1CB 0 ---  1CE 0 --- }
2EF1: 0025 { 1CB 0 ---  1CB 0 ---  0F8 0 ---  1CE 0 --- }
2EF2: 0025 { 1DC 0 ---  1D1 0 ---  0F8 0 ---  1D2 0 --- }
2EF3: 0025 { 0F8 0 ---  0F8 0 ---  1D6 2 ---  0F8 0 --- }
2EF4: 0025 { 1C4 2 ---  1D3 2 ---  1CD 2 ---  1CE 2 --- }
2EF5: 0025 { 1D3 2 ---  0F8 0 ---  0F8 0 ---  0F8 0 --- }
2EF6: 0025 { 19E 2 ---  19E 2 ---  19E 2 ---  19E 2 --- }
2EF7: 0025 { 19F 2 ---  19F 2 ---  19F 2 ---  19F 2 --- }
2EF8: 0025 { 1D2 2 ---  1C4 2 ---  1C8 2 ---  1D7 2 --- }
2EF9: 0025 { 1C3 2 ---  1C8 2 ---  1C4 2 ---  1D3 2 --- }
2EFA: 0025 { 1A4 2 ---  1A4 2 -y-  0F8 4 ---  0F8 4 --- }
2EFB: 0025 { 1C8 2 ---  1D7 2 ---  1D3 2 ---  1D3 2 --- }
2EFC: 0025 { 0F8 4 ---  0F8 4 ---  1D3 2 ---  1CB 2 --- }
2EFD: 0025 { 185 2 ---  0F8 4 ---  191 2 x--  1A1 2 x-- }
2EFE: 0130 { 0F8 4 ---  0F8 4 ---  181 2 ---  181 2 -y- }
2EFF: 0130 { 181 2 x--  181 2 xy-  0F8 4 x--  0F8 4 x-- }
