2500: 0025 { 0F8 3 ---  0F8 3 x--  0F8 3 ---  0F8 3 --- }
2501: 0025 { 0F8 3 -y-  201 3 ---  0F8 3 -y-  0F8 3 --- }
2502: 0025 { 0F8 3 ---  202 3 ---  0F8 3 ---  203 3 --- }
2503: 0025 { 0F8 3 ---  0F8 3 x--  0F8 3 x--  0F8 3 --- }
2504: 0025 { 0F8 3 ---  0F8 3 ---  0F8 3 -y-  0F8 3 --- }
2505: 0025 { 0F8 3 -y-  0F8 3 -y-  0F8 3 ---  0F8 3 --- }
2506: 0025 { 0F8 3 ---  204 3 ---  0F8 3 ---  205 3 --- }
2507: 0025 { 0F8 3 x--  206 3 ---  0F8 3 x--  207 3 --- }
2508: 0025 { 0F8 3 ---  208 3 ---  0F8 3 -y-  265 3 --- }
2509: 0025 { 0F8 3 ---  266 3 ---  0F8 3 ---  267 3 --- }
250A: 0025 { 0F8 3 -y-  268 3 ---  0F8 3 ---  269 3 --- }
250B: 0025 { 0F8 3 ---  26A 3 ---  0F8 3 ---  26B 3 --- }
250C: 0025 { 0F8 3 x--  26C 3 ---  0F8 3 x--  26D 3 --- }
250D: 0025 { 0F8 3 ---  26E 3 ---  0F8 3 -y-  26F 3 --- }
250E: 0025 { 0F8 3 ---  270 3 ---  0F8 3 ---  26F 3 --- }
250F: 0025 { 0F8 3 ---  272 3 ---  0F8 3 ---  273 3 --- }
2510: 0025 { 0F8 3 -y-  0F8 3 ---  0F8 3 ---  0F8 3 --- }
2511: 0025 { 209 3 ---  20E 3 ---  20A 3 ---  20F 3 --- }
2512: 0025 { 20B 3 ---  210 3 ---  20C 3 ---  211 3 --- }
2513: 0025 { 0F8 3 x--  0F8 3 ---  0F8 3 ---  0F8 3 --- }
2514: 0025 { 0F8 3 x--  0F8 3 ---  0F8 3 ---  0F8 3 --- }
2515: 0025 { 0F8 3 ---  0F8 3 ---  0F8 3 -y-  0F8 3 -y- }
2516: 0025 { 0F8 3 xyp  0F8 3 xyp  0F8 3 xyp  0F8 3 xyp }
2517: 0025 { 0F8 3 xyp  0F8 3 xyp  0F8 3 xyp  212 3 --- }
2518: 0025 { 218 3 ---  213 3 ---  274 3 ---  27D 3 --- }
2519: 0025 { 275 3 ---  27E 3 ---  276 3 ---  27F 3 --- }
251A: 0025 { 277 3 ---  280 3 ---  278 3 ---  280 3 --- }
251B: 0025 { 279 3 ---  281 3 ---  27A 3 ---  282 3 --- }
251C: 0025 { 27B 3 ---  283 3 ---  27C 3 ---  284 3 --- }
251D: 0025 { 0F8 3 ---  285 3 ---  0F8 3 x--  0F8 3 x-- }
251E: 0025 { 0F8 3 ---  0F8 3 ---  0F8 3 ---  0F8 3 --- }
251F: 0025 { 0F8 3 ---  0F8 3 ---  0F8 3 x--  0F8 3 --- }
2520: 0025 { 0F8 3 x--  0F8 3 -y-  0F8 3 ---  21D 3 --- }
2521: 0025 { 214 3 ---  21E 3 ---  215 3 ---  21F 3 --- }
2522: 0025 { 216 3 ---  220 3 ---  217 3 ---  221 3 --- }
2523: 0025 { 0F8 3 ---  222 3 ---  0F8 3 ---  223 3 --- }
2524: 0025 { 0F8 3 x--  224 3 ---  0F8 3 ---  225 3 --- }
2525: 0025 { 0F8 3 ---  226 3 ---  0F8 3 ---  227 3 --- }
2526: 0025 { 218 3 ---  228 3 ---  219 3 ---  229 3 --- }
2527: 0025 { 21A 3 ---  22A 3 ---  21B 3 ---  22B 3 --- }
2528: 0025 { 21B 3 ---  22B 3 ---  21C 3 ---  293 3 --- }
2529: 0025 { 288 3 ---  294 3 ---  289 3 ---  295 3 --- }
252A: 0025 { 28A 3 ---  295 3 ---  28B 3 ---  296 3 --- }
252B: 0025 { 28C 3 ---  297 3 ---  28D 3 ---  295 3 --- }
252C: 0025 { 28E 3 ---  295 3 ---  28F 3 ---  298 3 --- }
252D: 0025 { 290 3 ---  299 3 ---  291 3 ---  29A 3 --- }
252E: 0025 { 292 3 ---  29B 3 ---  0F8 3 ---  0F8 3 --- }
252F: 0025 { 0F8 3 ---  0F8 3 x--  0F8 3 ---  0F8 3 --- }
2530: 0025 { 0F8 3 ---  0F8 3 -y-  22C 3 ---  0F8 3 --- }
2531: 0025 { 22D 3 ---  23A 3 ---  22E 3 ---  23B 3 --- }
2532: 0025 { 22F 3 ---  23C 3 ---  230 3 ---  23D 3 --- }
2533: 0025 { 231 3 ---  23E 3 ---  232 3 ---  23F 3 --- }
2534: 0025 { 233 3 ---  240 3 ---  234 3 ---  241 3 --- }
2535: 0025 { 235 3 ---  242 3 ---  236 3 ---  243 3 --- }
2536: 0025 { 237 3 ---  244 3 ---  238 3 ---  245 3 --- }
2537: 0025 { 239 3 ---  246 3 ---  22B 3 ---  247 3 --- }
2538: 0025 { 22B 3 ---  248 3 ---  29C 3 ---  2A9 3 --- }
2539: 0020 { 29D 3 ---  2AA 3 ---  29E 3 ---  2AB 3 --- }
253A: 0020 { 29F 3 ---  2AC 3 ---  2A0 3 ---  2AD 3 --- }
253B: 0020 { 2A1 3 ---  2AE 3 ---  2A2 3 ---  2AF 3 --- }
253C: 0020 { 2A3 3 ---  2B0 3 ---  2A4 3 ---  2B1 3 --- }
253D: 0025 { 2A5 3 ---  2B2 3 ---  2A6 3 ---  2B3 3 --- }
253E: 0025 { 2A7 3 ---  2B4 3 ---  2A8 3 ---  2B5 3 --- }
253F: 0025 { 0F8 3 xy-  0F8 3 ---  0F8 3 x--  0F8 3 --- }
2540: 0025 { 0F8 3 ---  0F8 3 x--  0F8 3 ---  0F8 3 x-- }
2541: 0025 { 249 3 ---  0F8 3 ---  24A 3 ---  0F8 3 --- }
2542: 0025 { 24B 3 ---  0F8 3 ---  24C 3 ---  0F8 3 x-- }
2543: 0025 { 24D 3 ---  0F8 3 ---  24E 3 ---  0F8 3 x-- }
2544: 0025 { 24F 3 ---  249 3 ---  250 3 ---  24A 3 --- }
2545: 0025 { 251 3 ---  24B 3 ---  252 3 ---  259 3 --- }
2546: 0025 { 253 3 ---  25A 3 ---  254 3 ---  25B 3 --- }
2547: 0025 { 255 3 ---  25C 3 ---  255 3 ---  25C 3 --- }
2548: 0025 { 255 3 ---  25C 3 ---  2B6 3 ---  2C3 3 --- }
2549: 0020 { 2B7 3 ---  2C4 3 ---  2B8 3 ---  2C5 3 --- }
254A: 0020 { 2B9 3 ---  2C6 3 ---  2BA 3 ---  2C7 3 --- }
254B: 0020 { 2BB 3 ---  2C8 3 ---  2BC 3 ---  2C9 3 --- }
254C: 0020 { 2BD 3 ---  2CA 3 ---  2BE 3 ---  2CB 3 --- }
254D: 0025 { 2BF 3 ---  2CC 3 ---  2C0 3 ---  2CD 3 --- }
254E: 0025 { 2C1 3 ---  2CE 3 ---  2C2 3 ---  2CF 3 --- }
254F: 0025 { 0F8 3 ---  0F8 3 xy-  0F8 3 ---  0F8 3 --- }
2550: 0025 { 0F8 3 -y-  0F8 3 ---  0F8 3 -y-  0F8 3 --- }
2551: 0025 { 0F8 3 ---  0F8 3 -y-  0F8 3 ---  0F8 3 -y- }
2552: 0025 { 0F8 3 ---  0F8 3 ---  0F8 3 ---  0F8 3 --- }
2553: 0025 { 0F8 3 xy-  0F8 3 ---  0F8 3 xy-  0F8 3 x-- }
2554: 0025 { 0F8 3 -y-  0F8 3 ---  0F8 3 ---  0F8 3 -y- }
2555: 0025 { 0F8 3 ---  0F8 3 -y-  0F8 3 ---  0F8 3 --- }
2556: 0025 { 25D 3 ---  0F8 3 ---  25E 3 ---  262 3 --- }
2557: 0025 { 25F 3 ---  263 3 ---  260 3 ---  0F8 3 --- }
2558: 0025 { 261 3 ---  0F8 3 ---  2D0 3 ---  0F8 3 -y- }
2559: 0105 { 2D1 3 ---  0F8 3 ---  2D1 3 ---  0F8 3 --- }
255A: 0105 { 2D1 3 ---  0F8 3 ---  2D1 3 ---  0F8 3 --- }
255B: 0105 { 2D2 3 ---  2DA 3 ---  2D3 3 ---  2DB 3 --- }
255C: 0105 { 2D4 3 ---  2DC 3 ---  2D5 3 ---  2DD 3 --- }
255D: 0025 { 2D6 3 ---  0F8 3 ---  2D7 3 ---  0F8 3 --- }
255E: 0025 { 2D8 3 ---  0F8 3 ---  0F8 3 ---  0F8 3 --- }
255F: 0025 { 0F8 3 xy-  0F8 3 x--  0F8 3 x--  0F8 3 -y- }
2560: 0130 { 117 2 ---  11E 2 ---  117 2 ---  11F 2 --- }
2561: 0130 { 182 2 ---  192 2 ---  183 2 ---  193 2 --- }
2562: 0105 { 12E 5 ---  13E 5 ---  12F 5 ---  13F 5 --- }
2563: 0130 { 2E4 1 ---  2F4 1 ---  2E5 1 ---  2F5 1 --- }
2564: 0025 { 0FB 4 --p  0FB 4 --p  0FB 4 --p  0FB 4 --p }
2565: 0130 { 0FB 4 --p  0FB 4 --p  0FB 4 --p  0FB 4 --p }
2566: 020C { 0FB 4 --p  0FB 4 --p  0FB 4 --p  0FB 4 --p }
2567: 020C { 0FB 4 --p  0FB 4 --p  0FB 4 --p  0FB 4 --p }
2568: 020C { 0FB 4 --p  0FB 4 --p  0FB 4 --p  0FB 4 --p }
2569: 0130 { 2DE 1 ---  0F8 1 ---  2DF 1 ---  0F8 1 --- }
256A: 0143 { 083 7 ---  083 7 ---  084 7 ---  084 7 --- }
256B: 0105 { 1F4 7 ---  1F6 7 ---  1F5 7 ---  1F7 7 --- }
256C: 0130 { 200 2 ---  21E 2 ---  200 2 ---  21F 2 --- }
256D: 0025 { 0F8 3 ---  0F8 3 ---  0F8 3 ---  201 3 --- }
256E: 0025 { 0F8 3 x--  201 3 x--  0F8 3 x--  0F8 3 x-- }
256F: 0130 { 21F 2 ---  21E 2 ---  21E 2 ---  21F 2 --- }
2570: 020C { 0FB 4 --p  0FB 4 --p  0FB 4 --p  0FB 4 --p }
2571: 0130 { 194 2 ---  192 2 ---  195 2 ---  193 2 --- }
2572: 0025 { 0F8 2 ---  250 2 ---  0F8 2 ---  251 2 --- }
2573: 0025 { 242 2 ---  252 2 ---  243 2 ---  253 2 --- }
2574: 0025 { 244 2 ---  254 2 ---  245 2 ---  255 2 --- }
2575: 0025 { 0F8 2 ---  240 2 ---  0F8 2 ---  241 2 --- }
2576: 0025 { 0F8 4 ---  0F8 4 ---  0F8 4 ---  0F8 4 --- }
2577: 0025 { 0F8 4 ---  0F8 4 ---  0F8 4 ---  0F8 4 --- }
2578: 0105 { 1FA 7 ---  1FD 7 ---  1FB 7 ---  1FE 7 --- }
2579: 0105 { 1FC 7 ---  1FF 7 ---  1FC 7 ---  1FF 7 --- }
257A: 0105 { 1FB 7 x--  1FE 7 x--  1FA 7 x--  1FD 7 x-- }
257B: 0025 { 1F8 7 ---  1F8 7 ---  1F9 7 ---  1F9 7 --- }
257C: 0025 { 0F8 3 ---  202 3 ---  201 3 ---  203 3 --- }
257D: 0025 { 202 3 ---  206 3 ---  203 3 ---  207 3 --- }
257E: 0025 { 204 3 ---  208 3 ---  205 3 ---  209 3 --- }
257F: 0025 { 201 3 x--  204 3 ---  0F8 3 ---  205 3 --- }
2580: 0025 { 0F8 2 ---  25E 2 ---  24F 2 ---  25F 2 --- }
2581: 0025 { 24E 2 ---  27D 2 ---  0F8 2 ---  0F8 2 --- }
2582: 0025 { 260 2 ---  270 2 ---  261 2 ---  271 2 --- }
2583: 0025 { 262 2 ---  272 2 ---  263 2 ---  273 2 --- }
2584: 0025 { 264 2 ---  274 2 ---  265 2 ---  275 2 --- }
2585: 0025 { 246 2 ---  256 2 ---  247 2 ---  257 2 --- }
2586: 0025 { 248 2 ---  258 2 ---  249 2 ---  259 2 --- }
2587: 0025 { 24A 2 ---  25A 2 ---  0F8 2 ---  0F8 2 --- }
2588: 0105 { 0F8 2 ---  0F8 2 ---  24B 7 ---  25B 7 --- }
2589: 0105 { 24C 7 ---  25C 7 ---  24D 7 ---  25D 7 --- }
258A: ~
258B: 0025 { 1F6 7 -y-  1F4 7 -y-  1F7 7 -y-  1F5 7 -y- }
258C: 0025 { 20D 3 ---  211 3 ---  20E 3 ---  207 3 --- }
258D: 0025 { 20F 3 ---  206 3 ---  20E 3 ---  207 3 --- }
258E: 0025 { 20A 3 ---  208 3 ---  20B 3 ---  209 3 --- }
258F: 0025 { 20A 3 ---  208 3 ---  20C 3 ---  210 3 --- }
2590: 0025 { 26E 2 ---  27E 2 ---  26F 2 ---  27F 2 --- }
2591: 0025 { 21A 2 ---  21B 2 ---  0F8 2 ---  0F8 2 --- }
2592: 0025 { 27B 2 ---  27B 2 ---  27C 2 ---  27C 2 --- }
2593: 0105 { 2E0 1 ---  2F0 1 ---  2E1 1 ---  2F1 1 --- }
2594: 0105 { 2E2 1 ---  2F2 1 ---  2E3 1 ---  2F3 1 --- }
2595: 0025 { 266 2 ---  276 2 ---  267 2 ---  277 2 --- }
2596: 0025 { 268 2 ---  278 2 ---  269 2 ---  279 2 --- }
2597: 0025 { 26A 2 ---  27A 2 ---  0F8 2 ---  0F8 2 --- }
2598: 0025 { 0F8 2 ---  0F8 2 ---  26B 7 ---  26B 7 --- }
2599: 0025 { 26C 7 ---  26C 7 ---  26D 7 ---  26D 7 --- }
259A: 0025 { 220 5 ---  230 5 ---  221 5 ---  231 5 --- }
259B: 0025 { 222 5 ---  232 5 ---  223 5 ---  233 5 --- }
259C: ~
259D: 0025 { 212 3 ---  214 3 ---  20E 3 ---  207 3 --- }
259E: 0025 { 20A 3 ---  208 3 ---  20B 3 ---  209 3 --- }
259F: 0025 { 20A 3 ---  208 3 ---  20C 3 ---  210 3 --- }
25A0: 0025 { 0F8 2 ---  0F8 2 ---  0F8 2 ---  0F8 2 --- }
25A1: 0025 { 0F8 2 ---  229 2 ---  0F8 2 ---  239 2 --- }
25A2: 0025 { 0F8 2 ---  0F8 2 ---  0F8 2 ---  0F8 2 --- }
25A3: 0105 { 2F0 1 -y-  2E0 1 -y-  2F1 1 -y-  2E1 1 -y- }
25A4: 0105 { 2F2 1 -y-  2E2 1 -y-  2F3 1 -y-  2E3 1 -y- }
25A5: 0130 { 0F8 4 ---  0F8 4 ---  0F8 4 ---  0F8 4 --- }
25A6: 0025 { 17B 2 ---  17B 2 ---  17C 2 ---  17C 2 --- }
25A7: 0133 { 000 2 ---  010 2 ---  001 2 ---  011 2 --- }
25A8: 0134 { 002 2 ---  012 2 ---  003 2 ---  013 2 --- }
25A9: ~
25AA: 0025 { 22A 5 ---  23A 5 ---  22B 5 ---  23B 5 --- }
25AB: 0025 { 22C 5 ---  23C 5 ---  22D 5 ---  23D 5 --- }
25AC: 0020 { 217 3 ---  217 3 ---  217 3 ---  217 3 --- }
25AD: 0025 { 20D 3 ---  211 3 ---  20E 3 ---  207 3 --- }
25AE: 0025 { 20A 3 ---  208 3 ---  20B 3 ---  209 3 --- }
25AF: 0025 { 20A 3 ---  208 3 ---  213 3 ---  215 3 --- }
25B0: 0025 { 224 2 ---  234 2 ---  225 2 ---  235 2 --- }
25B1: 0025 { 226 2 ---  236 2 ---  227 2 ---  237 2 --- }
25B2: 0025 { 228 2 ---  238 2 ---  0F8 2 ---  0F8 2 --- }
25B3: 0130 { 1A4 5 ---  1C4 5 ---  1A6 5 ---  1C6 5 --- }
25B4: 0025 { 21B 2 ---  25E 2 ---  24F 2 ---  25F 2 --- }
25B5: ~
25B6: ~
25B7: 0135 { 020 2 ---  020 2 ---  021 2 ---  021 2 --- }
25B8: 0136 { 022 2 ---  022 2 ---  023 2 ---  023 2 --- }
25B9: ~
25BA: 0025 { 0F8 2 ---  0F8 2 ---  21C 5 ---  21C 5 --- }
25BB: 0025 { 21D 5 ---  21D 5 ---  0F8 2 ---  0F8 2 --- }
25BC: 0020 { 216 3 ---  216 3 ---  217 3 ---  217 3 --- }
25BD: 0020 { 217 3 ---  219 3 ---  217 3 ---  217 3 --- }
25BE: 0020 { 217 3 ---  217 3 ---  217 3 ---  219 3 --- }
25BF: 0020 { 217 3 ---  217 3 ---  218 3 ---  218 3 --- }
25C0: 0025 { 180 3 ---  190 3 ---  181 3 ---  191 3 --- }
25C1: 0025 { 182 3 ---  192 3 ---  183 3 ---  193 3 --- }
25C2: 0025 { 184 3 ---  194 3 ---  185 3 ---  195 3 --- }
25C3: 0025 { 186 3 ---  196 3 ---  187 3 ---  197 3 --- }
25C4: 0025 { 188 3 ---  198 3 ---  189 3 ---  199 3 --- }
25C5: 0025 { 18A 3 ---  19A 3 ---  18B 3 ---  19B 3 --- }
25C6: 0025 { 18C 3 ---  19C 3 ---  18D 3 ---  19D 3 --- }
25C7: 0025 { 18E 3 ---  19E 3 ---  18F 3 ---  19F 3 --- }
25C8: 0025 { 1A0 3 ---  1B0 3 ---  1A1 3 ---  1B1 3 --- }
25C9: 0025 { 1A2 3 ---  1B2 3 ---  1A3 3 ---  1B3 3 --- }
25CA: 0025 { 1A4 3 ---  1B4 3 ---  1A5 3 ---  1B5 3 --- }
25CB: 0025 { 1A6 3 ---  1B6 3 ---  1A7 3 ---  1B7 3 --- }
25CC: 0025 { 1A8 3 ---  1B8 3 ---  1A9 3 ---  1B9 3 --- }
25CD: 0025 { 1AA 3 ---  1BA 3 ---  1AB 3 ---  1BB 3 --- }
25CE: 0025 { 1AC 3 ---  1BC 3 ---  1AD 3 ---  1BD 3 --- }
25CF: 0025 { 1AE 3 ---  1BE 3 ---  1AF 3 ---  1BF 3 --- }
25D0: 0025 { 1C0 3 ---  1D0 3 ---  1C1 3 ---  1D1 3 --- }
25D1: 0025 { 1C2 3 ---  1D2 3 ---  1C3 3 ---  1D3 3 --- }
25D2: 0025 { 1C4 3 ---  1D4 3 ---  1C5 3 ---  1D5 3 --- }
25D3: 0025 { 1C6 3 ---  1D6 3 ---  1C7 3 ---  1D7 3 --- }
25D4: 0025 { 1C8 3 ---  1D8 3 ---  1C9 3 ---  1D9 3 --- }
25D5: 0025 { 1CA 3 ---  1DA 3 ---  1CB 3 ---  1DB 3 --- }
25D6: 0025 { 1CC 3 ---  1DC 3 ---  1CD 3 ---  1DD 3 --- }
25D7: 0025 { 1CE 3 ---  1DE 3 ---  1CF 3 ---  1DF 3 --- }
25D8: 0025 { 1E0 3 ---  1F0 3 ---  1E1 3 ---  1F1 3 --- }
25D9: 0025 { 0F8 3 ---  1E4 3 ---  0F8 3 ---  0F8 3 --- }
25DA: 0025 { 1E2 3 ---  1F2 3 ---  1E3 3 ---  1F3 3 --- }
25DB: 0025 { 22E 6 ---  22F 6 ---  22F 6 ---  23F 6 --- }
25DC: 0025 { 266 3 ---  276 3 ---  267 3 ---  277 3 --- }
25DD: 0025 { 268 3 ---  278 3 ---  269 3 ---  279 3 --- }
25DE: ~
25DF: 0025 { 1EE 3 ---  1FE 3 ---  1EF 3 ---  1FF 3 --- }
25E0: 0025 { 180 7 ---  190 7 ---  181 7 ---  191 7 --- }
25E1: 0025 { 182 7 ---  192 7 ---  183 7 ---  193 7 --- }
25E2: 0025 { 184 7 ---  194 7 ---  185 7 ---  195 7 --- }
25E3: 0025 { 186 7 ---  196 7 ---  187 7 ---  197 7 --- }
25E4: 0025 { 188 7 ---  198 7 ---  189 7 ---  199 7 --- }
25E5: 0025 { 18A 7 ---  19A 7 ---  18B 7 ---  19B 7 --- }
25E6: 0025 { 18C 7 ---  19C 7 ---  18D 7 ---  19D 7 --- }
25E7: 0025 { 18E 7 ---  19E 7 ---  18F 7 ---  19F 7 --- }
25E8: 0025 { 1A0 7 ---  1B0 7 ---  1A1 7 ---  1B1 7 --- }
25E9: 0025 { 1A2 7 ---  1B2 7 ---  1A3 7 ---  1B3 7 --- }
25EA: 0025 { 1A4 7 ---  1B4 7 ---  1A5 7 ---  1B5 7 --- }
25EB: 0025 { 1A6 7 ---  1B6 7 ---  1A7 7 ---  1B7 7 --- }
25EC: 0025 { 1A8 7 ---  1B8 7 ---  1A9 7 ---  1B9 7 --- }
25ED: 0025 { 1AA 7 ---  1BA 7 ---  1AB 7 ---  1BB 7 --- }
25EE: 0025 { 1AC 7 ---  1BC 7 ---  1AD 7 ---  1BD 7 --- }
25EF: 0025 { 1AE 7 ---  1BE 7 ---  1AF 7 ---  1BF 7 --- }
25F0: 0025 { 1C0 7 ---  1D0 7 ---  1C1 7 ---  1D1 7 --- }
25F1: 0025 { 1C2 7 ---  1D2 7 ---  1C3 7 ---  1D3 7 --- }
25F2: 0025 { 1C4 7 ---  1D4 7 ---  1C5 7 ---  1D5 7 --- }
25F3: 0025 { 1C6 7 ---  1D6 7 ---  1C7 7 ---  1D7 7 --- }
25F4: 0025 { 1C8 7 ---  1D8 7 ---  1C9 7 ---  1D9 7 --- }
25F5: 0025 { 1CA 7 ---  1DA 7 ---  1CB 7 ---  1DB 7 --- }
25F6: 0025 { 1CC 7 ---  1DC 7 ---  1CD 7 ---  1DD 7 --- }
25F7: 0025 { 1CE 7 ---  1DE 7 ---  1CF 7 ---  1DF 7 --- }
25F8: 0025 { 1E0 7 ---  1F0 7 ---  1E1 7 ---  1F1 7 --- }
25F9: 0025 { 0F8 7 ---  1E4 7 ---  0F8 7 ---  0F8 7 --- }
25FA: 0025 { 1E2 7 ---  1F2 7 ---  1E3 7 ---  1F3 7 --- }
25FB: 0025 { 265 7 ---  275 7 ---  0F8 7 ---  0F8 7 --- }
25FC: 0025 { 266 7 ---  276 7 ---  267 7 ---  277 7 --- }
25FD: 0025 { 268 7 ---  278 7 ---  269 7 ---  279 7 --- }
25FE: 0025 { 1E6 7 ---  1F6 7 ---  1E7 7 ---  1F7 7 --- }
25FF: 0025 { 1E5 7 ---  1F5 7 ---  0F8 7 ---  0F8 7 --- }
