3200: ~
3201: ~
3202: ~
3203: 0025 { 0F8 1 --p  0F8 1 --p  0F8 1 --p  0F8 1 --p }
3204: 0025 { 0F8 1 --p  0F8 1 --p  0F8 1 --p  102 1 --p }
3205: 0025 { 0F8 1 --p  103 1 --p  0F8 1 --p  104 1 --p }
3206: 0025 { 0F8 1 --p  105 1 --p  0F8 1 --p  106 1 --p }
3207: 0025 { 0F8 1 --p  107 1 --p  0F8 1 --p  108 1 --p }
3208: 0025 { 0F8 1 --p  109 1 --p  0F8 1 --p  10A 1 --p }
3209: 0025 { 0F8 1 --p  10B 1 --p  0F8 1 --p  10C 1 --p }
320A: 0025 { 0F8 1 --p  10D 1 --p  0F8 1 --p  0F8 1 --p }
320B: 0025 { 0F8 1 --p  0F8 1 --p  0F8 1 --p  0F8 1 --p }
320C: 0025 { 0F8 1 --p  0F8 1 --p  0F8 1 --p  0F8 1 --p }
320D: ~
320E: ~
320F: ~
3210: ~
3211: ~
3212: ~
3213: 0025 { 0F8 1 --p  0F8 1 --p  110 1 --p  120 1 --p }
3214: 0025 { 111 1 --p  121 1 --p  112 1 --p  122 1 --p }
3215: 0025 { 113 1 --p  123 1 --p  114 1 --p  124 1 --p }
3216: 0025 { 115 1 --p  125 1 --p  116 1 --p  126 1 --p }
3217: 0025 { 117 1 --p  127 1 --p  118 1 --p  128 1 --p }
3218: 0025 { 119 1 --p  129 1 --p  11A 1 --p  12A 1 --p }
3219: 0025 { 11B 1 --p  1AD 1 --p  11C 1 --p  12C 1 --p }
321A: 0025 { 11D 1 --p  1AD 1 --p  11E 1 --p  1AD 1 --p }
321B: 0025 { 11F 1 --p  1AD 1 --p  154 1 --p  164 1 --p }
321C: 0025 { 0F8 1 --p  0F8 1 --p  0F8 1 --p  0F8 1 --p }
321D: ~
321E: ~
321F: ~
3220: ~
3221: ~
3222: ~
3223: 0025 { 0F8 1 --p  0F8 1 --p  130 1 --p  140 1 --p }
3224: 0025 { 131 1 --p  141 1 --p  132 1 --p  142 1 --p }
3225: 0025 { 133 1 --p  143 1 --p  134 1 --p  270 1 --p }
3226: 0025 { 135 1 --p  271 1 --p  136 1 --p  272 1 --p }
3227: 0025 { 137 1 --p  273 1 --p  138 1 --p  274 1 --p }
3228: 0025 { 139 1 --p  275 1 --p  13A 1 --p  14A 1 --p }
3229: 0025 { 13B 1 --p  14B 1 --p  13C 1 --p  14C 1 --p }
322A: 0025 { 13D 1 --p  14D 1 --p  13E 1 --p  14E 1 --p }
322B: 0025 { 13F 1 --p  14F 1 --p  174 1 --p  146 1 --p }
322C: 0025 { 0F8 1 --p  0F8 1 --p  0F8 1 --p  0F8 1 --p }
322D: ~
322E: ~
322F: ~
3230: ~
3231: ~
3232: ~
3233: 0025 { 0F8 1 --p  0F8 1 --p  150 1 --p  160 1 --p }
3234: 0025 { 151 1 --p  161 1 --p  152 1 --p  162 1 --p }
3235: 0025 { 153 1 --p  163 1 --p  276 1 --p  27A 1 --p }
3236: 0025 { 277 1 --p  27B 1 --p  000 1 --p  010 1 --p }
3237: 0025 { 001 1 --p  011 1 --p  278 1 --p  27C 1 --p }
3238: 0025 { 279 1 --p  27D 1 --p  15A 1 --p  16A 1 --p }
3239: 0025 { 1AD 1 --p  16B 1 --p  15C 1 --p  16C 1 --p }
323A: 0025 { 15D 1 --p  16D 1 --p  15E 1 --p  16E 1 --p }
323B: 0025 { 15F 1 --p  16F 1 --p  156 1 --p  166 1 --p }
323C: 0025 { 0F8 1 --p  0F8 1 --p  0F8 1 --p  0F8 1 --p }
323D: ~
323E: ~
323F: ~
3240: ~
3241: ~
3242: ~
3243: 0025 { 0F8 1 --p  0F8 1 --p  170 1 --p  180 1 --p }
3244: 0025 { 171 1 --p  181 1 --p  172 1 --p  182 1 --p }
3245: 0025 { 173 1 --p  183 1 --p  27E 1 --p  143 1 --p }
3246: 0025 { 27F 1 --p  259 1 --p  255 1 --p  25A 1 --p }
3247: 0025 { 256 1 --p  25B 1 --p  257 1 --p  25C 1 --p }
3248: 0025 { 258 1 --p  143 1 --p  17A 1 --p  18A 1 --p }
3249: 0025 { 17B 1 --p  18B 1 --p  17C 1 --p  18C 1 --p }
324A: 0025 { 17D 1 --p  18D 1 --p  17E 1 --p  18E 1 --p }
324B: 0025 { 17F 1 --p  18F 1 --p  176 1 --p  145 1 --p }
324C: 0025 { 0F8 1 --p  0F8 1 --p  0F8 1 --p  0F8 1 --p }
324D: ~
324E: ~
324F: ~
3250: ~
3251: ~
3252: ~
3253: 0025 { 0F8 1 --p  0F8 1 --p  190 1 --p  1A0 1 --p }
3254: 0025 { 191 1 --p  1A1 1 --p  192 1 --p  1A2 1 --p }
3255: 0025 { 193 1 --p  1A3 1 --p  194 1 --p  1A4 1 --p }
3256: 0025 { 195 1 --p  1A5 1 --p  196 1 --p  1A6 1 --p }
3257: 0025 { 197 1 --p  1A7 1 --p  198 1 --p  1A8 1 --p }
3258: 0025 { 199 1 --p  1A9 1 --p  19A 1 --p  1AA 1 --p }
3259: 0025 { 19B 1 --p  1AB 1 --p  19C 1 --p  1AC 1 --p }
325A: 0025 { 19D 1 --p  1AD 1 --p  19E 1 --p  1AE 1 --p }
325B: 0025 { 19F 1 --p  1AF 1 --p  155 1 --p  165 1 --p }
325C: 0025 { 0F8 1 --p  0F8 1 --p  0F8 1 --p  0F8 1 --p }
325D: ~
325E: ~
325F: ~
3260: ~
3261: ~
3262: ~
3263: 0025 { 0F8 1 --p  0F8 1 --p  1B0 1 --p  1C0 1 --p }
3264: 0025 { 1B1 1 --p  1C1 1 --p  1B2 1 --p  1C2 1 --p }
3265: 0025 { 1B3 1 --p  1C3 1 --p  1B4 1 --p  1C4 1 --p }
3266: 0025 { 1B5 1 --p  1C5 1 --p  1B6 1 --p  1C6 1 --p }
3267: 0025 { 1B7 1 --p  1C7 1 --p  1B8 1 --p  1C8 1 --p }
3268: 0025 { 1B9 1 --p  1C9 1 --p  1BA 1 --p  1CA 1 --p }
3269: 0025 { 1BB 1 --p  1CB 1 --p  1BC 1 --p  1CC 1 --p }
326A: 0025 { 1BD 1 --p  1CD 1 --p  1BE 1 --p  1CE 1 --p }
326B: 0025 { 1BF 1 --p  1CF 1 --p  175 1 --p  148 1 --p }
326C: 0025 { 0F8 1 --p  0F8 1 --p  0F8 1 --p  0F8 1 --p }
326D: ~
326E: ~
326F: ~
3270: ~
3271: ~
3272: ~
3273: 0025 { 0F8 1 --p  0F8 1 --p  1D0 1 --p  1E0 1 --p }
3274: 0025 { 1D1 1 --p  1E1 1 --p  1D2 1 --p  1E2 1 --p }
3275: 0025 { 1D3 1 --p  1E3 1 --p  1D4 1 --p  1E4 1 --p }
3276: 0025 { 1D5 1 --p  1E5 1 --p  1D6 1 --p  1E6 1 --p }
3277: 0025 { 1D7 1 --p  1E7 1 --p  1D8 1 --p  1E8 1 --p }
3278: 0025 { 1D9 1 --p  1E9 1 --p  1DA 1 --p  1EA 1 --p }
3279: 0025 { 1DB 1 --p  1EB 1 --p  1DC 1 --p  1EC 1 --p }
327A: 0025 { 1DD 1 --p  1ED 1 --p  1DE 1 --p  1EE 1 --p }
327B: 0025 { 1DF 1 --p  1EF 1 --p  158 1 --p  168 1 --p }
327C: 0025 { 0F8 1 --p  169 1 --p  0F8 1 --p  0F8 1 --p }
327D: ~
327E: ~
327F: ~
3280: ~
3281: ~
3282: ~
3283: 0025 { 0F8 1 --p  0F8 1 --p  1F0 1 --p  200 1 --p }
3284: 0025 { 1F1 1 --p  201 1 --p  1F2 1 --p  202 1 --p }
3285: 0025 { 1F3 1 --p  203 1 --p  1F4 1 --p  204 1 --p }
3286: 0025 { 1F5 1 --p  205 1 --p  1F6 1 --p  206 1 --p }
3287: 0025 { 1F7 1 --p  207 1 --p  1F8 1 --p  208 1 --p }
3288: 0025 { 1F9 1 --p  209 1 --p  1FA 1 --p  20A 1 --p }
3289: 0025 { 1FB 1 --p  20B 1 --p  1FC 1 --p  20C 1 --p }
328A: 0025 { 1FD 1 --p  20D 1 --p  1FE 1 --p  20E 1 --p }
328B: 0025 { 1FF 1 --p  20F 1 --p  178 1 --p  101 1 --p }
328C: 0025 { 179 1 --p  10E 1 --p  0F8 1 --p  0F8 1 --p }
328D: ~
328E: ~
328F: ~
3290: ~
3291: ~
3292: ~
3293: 0025 { 0F8 1 --p  0F8 1 --p  210 1 --p  220 1 --p }
3294: 0025 { 211 1 --p  221 1 --p  212 1 --p  222 1 --p }
3295: 0025 { 213 1 --p  223 1 --p  214 1 --p  224 1 --p }
3296: 0025 { 215 1 --p  225 1 --p  216 1 --p  226 1 --p }
3297: 0025 { 217 1 --p  227 1 --p  218 1 --p  228 1 --p }
3298: 0025 { 219 1 --p  229 1 --p  21A 1 --p  22A 1 --p }
3299: 0025 { 21B 1 --p  22B 1 --p  21C 1 --p  22C 1 --p }
329A: 0025 { 21D 1 --p  22D 1 --p  21E 1 --p  22E 1 --p }
329B: 0025 { 21F 1 --p  22F 1 --p  149 1 --p  12B 1 --p }
329C: 0025 { 0F8 1 --p  12D 1 --p  0F8 1 --p  0F8 1 --p }
329D: ~
329E: ~
329F: ~
32A0: ~
32A1: ~
32A2: ~
32A3: 0025 { 0F8 1 --p  0F8 1 --p  230 1 --p  240 1 --p }
32A4: 0025 { 231 1 --p  241 1 --p  232 1 --p  242 1 --p }
32A5: 0025 { 233 1 --p  243 1 --p  234 1 --p  244 1 --p }
32A6: 0025 { 235 1 --p  245 1 --p  236 1 --p  246 1 --p }
32A7: 0025 { 237 1 --p  247 1 --p  238 1 --p  248 1 --p }
32A8: 0025 { 239 1 --p  249 1 --p  23A 1 --p  24A 1 --p }
32A9: 0025 { 23B 1 --p  24B 1 --p  23C 1 --p  24C 1 --p }
32AA: 0025 { 23D 1 --p  24D 1 --p  23E 1 --p  24E 1 --p }
32AB: 0025 { 23F 1 --p  24F 1 --p  12A 1 --p  12F 1 --p }
32AC: 0025 { 12E 1 --p  15B 1 --p  0F8 1 --p  0F8 1 --p }
32AD: ~
32AE: ~
32AF: ~
32B0: ~
32B1: ~
32B2: ~
32B3: ~
32B4: ~
32B5: ~
32B6: ~
32B7: ~
32B8: ~
32B9: ~
32BA: ~
32BB: ~
32BC: ~
32BD: ~
32BE: ~
32BF: ~
32C0: ~
32C1: ~
32C2: ~
32C3: ~
32C4: ~
32C5: ~
32C6: ~
32C7: ~
32C8: ~
32C9: ~
32CA: ~
32CB: ~
32CC: ~
32CD: ~
32CE: ~
32CF: ~
32D0: ~
32D1: ~
32D2: ~
32D3: ~
32D4: ~
32D5: ~
32D6: ~
32D7: ~
32D8: ~
32D9: ~
32DA: ~
32DB: ~
32DC: ~
32DD: ~
32DE: ~
32DF: ~
32E0: ~
32E1: ~
32E2: ~
32E3: ~
32E4: ~
32E5: ~
32E6: ~
32E7: ~
32E8: ~
32E9: ~
32EA: ~
32EB: ~
32EC: ~
32ED: ~
32EE: ~
32EF: ~
32F0: ~
32F1: ~
32F2: ~
32F3: ~
32F4: ~
32F5: ~
32F6: ~
32F7: ~
32F8: ~
32F9: ~
32FA: ~
32FB: ~
32FC: ~
32FD: ~
32FE: ~
32FF: ~
