1800: 0100 { 182 3 ---  192 3 ---  183 3 ---  193 3 --- }
1801: 0101 { 181 3 ---  1D0 3 ---  183 3 ---  193 3 --- }
1802: 0102 { 18D 3 ---  1D0 3 ---  183 3 ---  193 3 --- }
1803: 0103 { 182 3 ---  192 3 ---  181 3 x--  1D0 3 x-- }
1804: 0104 { 182 3 ---  192 3 ---  18D 3 x--  1D0 3 x-- }
1805: 0105 { 00D 6 ---  0F8 2 ---  00D 6 ---  0F8 2 --- }
1806: 0106 { 02C 1 ---  03C 1 ---  02C 1 x--  03C 1 x-- }
1807: 0107 { 1D8 4 ---  1DA 4 ---  1D9 4 ---  1DB 4 --- }
1808: 0108 { 1D9 4 ---  1DA 4 ---  1D9 4 ---  1DB 4 --- }
1809: 0109 { 1D9 4 ---  1DA 4 ---  1D8 4 x--  1DB 4 --- }
180A: 010A { 1D9 4 ---  1E5 4 ---  1D9 4 x--  1E5 4 --- }
180B: 010B { 000 0 ---  000 0 ---  000 0 ---  000 0 --- }
180C: 010C { 000 0 ---  000 0 ---  000 0 ---  000 0 --- }
180D: 010D { 000 0 ---  000 0 ---  000 0 ---  000 0 --- }
180E: 010E { 000 0 ---  000 0 ---  000 0 ---  000 0 --- }
180F: 010F { 000 0 ---  000 0 ---  000 0 ---  000 0 --- }
1810: 0110 { 000 0 ---  000 0 ---  000 0 ---  000 0 --- }
1811: 0111 { 064 1 ---  066 1 ---  065 1 ---  067 1 --- }
1812: 0112 { 0DA 7 ---  0DC 7 ---  0DB 7 ---  0DD 7 --- }
1813: 0113 { 064 1 ---  066 1 ---  065 1 ---  067 1 --- }
1814: 0114 { 060 6 ---  062 6 ---  061 6 ---  063 6 --- }
1815: 0115 { 064 1 ---  066 1 ---  065 1 ---  067 1 --- }
1816: 0116 { 064 1 ---  066 1 ---  065 1 ---  067 1 --- }
1817: 0117 { 068 6 ---  06A 6 ---  069 6 ---  06B 6 --- }
1818: 0118 { 068 6 ---  06A 6 ---  069 6 ---  06B 6 --- }
1819: 0119 { 068 6 ---  06A 6 ---  069 6 ---  06B 6 --- }
181A: 011A { 068 6 ---  06A 6 ---  069 6 ---  06B 6 --- }
181B: 011B { 068 6 ---  06A 6 ---  069 6 ---  06B 6 --- }
181C: 011C { 068 6 ---  06A 6 ---  069 6 ---  06B 6 --- }
181D: 011D { 068 6 ---  06A 6 ---  069 6 ---  06B 6 --- }
181E: 011E { 068 6 ---  06A 6 ---  069 6 ---  06B 6 --- }
181F: 011F { 060 6 ---  062 6 ---  061 6 ---  063 6 --- }
1820: 0120 { 060 6 ---  062 6 ---  061 6 ---  063 6 --- }
1821: 0121 { 060 6 ---  062 6 ---  061 6 ---  063 6 --- }
1822: 0122 { 060 6 ---  062 6 ---  061 6 ---  063 6 --- }
1823: 0123 { 060 6 ---  062 6 ---  061 6 ---  063 6 --- }
1824: 0124 { 060 6 ---  062 6 ---  061 6 ---  063 6 --- }
1825: 0125 { 060 6 ---  062 6 ---  061 6 ---  063 6 --- }
1826: 0126 { 060 6 ---  062 6 ---  061 6 ---  063 6 --- }
1827: 0127 { 060 6 ---  062 6 ---  061 6 ---  063 6 --- }
1828: 0128 { 060 6 ---  062 6 ---  061 6 ---  063 6 --- }
1829: 0129 { 068 6 ---  06A 6 ---  069 6 ---  06B 6 --- }
182A: 012A { 068 6 ---  06A 6 ---  069 6 ---  06B 6 --- }
182B: 012B { 068 6 ---  06A 6 ---  069 6 ---  06B 6 --- }
182C: 012C { 08E 1 ---  09E 1 ---  08F 1 ---  09F 1 --- }
182D: 012D { 0BE 0 ---  0F6 0 ---  0D7 0 ---  0F7 0 --- }
182E: 012E { 068 7 ---  06A 7 ---  069 7 ---  06B 7 --- }
182F: 012F { 05C 6 ---  05E 6 ---  05D 6 ---  05F 6 --- }
1830: 0130 { 030 4 ---  032 4 ---  031 4 ---  033 4 --- }
1831: 0131 { 1D8 7 xy-  1C8 7 xy-  1D7 7 xy-  1C7 7 xy- }
1832: 0132 { 058 6 ---  05A 6 ---  059 6 ---  05B 6 --- }
1833: 0133 { 000 0 ---  010 0 ---  001 0 ---  011 0 --- }
1834: 0134 { 002 0 ---  012 0 ---  003 0 ---  013 0 --- }
1835: 0135 { 020 0 ---  020 0 ---  021 0 ---  021 0 --- }
1836: 0136 { 022 0 ---  022 0 ---  023 0 ---  023 0 --- }
1837: 0130 { 000 7 ---  010 7 ---  001 7 ---  011 7 --- }
1838: 0130 { 002 7 ---  012 7 ---  003 7 ---  013 7 --- }
1839: 0139 { 000 6 ---  010 6 ---  001 6 ---  011 6 --- }
183A: 013A { 002 6 ---  012 6 ---  003 6 ---  013 6 --- }
183B: 013B { 004 0 ---  014 0 ---  005 0 ---  015 0 --- }
183C: 013C { 024 0 ---  034 0 ---  025 0 ---  035 0 --- }
183D: 013D { 02E 0 ---  03E 0 ---  02E 0 ---  03E 0 --- }
183E: 013E { 02F 0 ---  03F 0 ---  02F 0 ---  03F 0 --- }
183F: 013F { 024 0 ---  034 0 ---  025 0 ---  035 0 --- }
1840: 0025 { 006 6 ---  016 6 ---  007 6 ---  017 6 --- }
1841: 0141 { 00A 1 ---  01A 1 ---  00A 1 x--  01A 1 x-- }
1842: 0142 { 02A 1 ---  03A 1 ---  02B 1 ---  03B 1 --- }
1843: 0143 { 083 1 ---  083 1 ---  084 1 ---  084 1 --- }
1844: 0144 { 01C 6 -y-  01C 6 ---  01C 6 xy-  01C 6 x-- }
1845: 0145 { 180 3 ---  190 3 ---  183 3 ---  193 3 --- }
1846: 0146 { 191 3 ---  190 3 ---  183 3 ---  193 3 --- }
1847: 0147 { 1D7 3 ---  190 3 ---  183 3 ---  193 3 --- }
1848: 0148 { 182 3 ---  192 3 ---  180 3 x--  190 3 x-- }
1849: 0149 { 182 3 ---  192 3 ---  191 3 x--  190 3 x-- }
184A: 014A { 182 3 ---  192 3 ---  1D7 3 x--  190 3 x-- }
184B: 014B { 184 3 ---  190 3 ---  195 3 ---  193 3 --- }
184C: 014C { 194 3 ---  192 3 ---  184 3 x--  190 3 x-- }
184D: 014D { 190 3 -y-  180 3 -y-  193 3 -y-  183 3 -y- }
184E: 014E { 192 3 -y-  182 3 -y-  193 3 -y-  183 3 -y- }
184F: 014F { 192 3 -y-  182 3 -y-  190 3 xy-  180 3 xy- }
1850: 0150 { 190 3 -y-  184 3 -y-  193 3 -y-  195 3 -y- }
1851: 0151 { 192 3 -y-  194 3 -y-  190 3 xy-  184 3 xy- }
1852: 0152 { 0F8 4 ---  0F8 4 ---  0F8 4 ---  0F8 4 --- }
1853: 0153 { 1F4 4 ---  1F6 4 ---  1F5 4 ---  1F7 4 --- }
1854: 0154 { 1F8 4 ---  1F8 4 ---  1F9 4 ---  1F9 4 --- }
1855: 0155 { 1F6 4 -y-  1F4 4 -y-  1F7 4 -y-  1F5 4 -y- }
1856: 0156 { 1FA 4 ---  1FD 4 ---  1FB 4 ---  1FE 4 --- }
1857: 0157 { 1FC 4 ---  1FF 4 ---  1FC 4 ---  1FF 4 --- }
1858: 0158 { 1FB 4 x--  1FE 4 x--  1FA 4 x--  1FD 4 x-- }
1859: 0159 { 04A 3 --p  0FB 3 --p  04B 3 --p  0FB 3 --p }
185A: 015A { 04A 3 --p  0FB 3 --p  048 3 --p  049 3 --p }
185B: 015B { 0FB 3 --p  0FB 3 --p  049 3 --p  049 3 --p }
185C: 015B { 1C7 2 --p  1DB 6 --p  1C8 2 --p  1DC 6 --p }
185D: 015D { 1C7 2 --p  1DC 6 --p  1C8 2 --p  1DC 6 --p }
185E: 015E { 1C7 2 --p  1DC 6 --p  1C8 2 --p  1DF 6 --p }
185F: 015F { 1DE 2 ---  1B0 2 ---  1C8 2 ---  1CA 2 --- }
1860: 0160 { 1C7 2 ---  1B0 2 ---  1C8 2 ---  1CA 2 --- }
1861: 0161 { 1C8 2 ---  1CA 2 ---  1C8 2 ---  1CA 2 --- }
1862: 0162 { 1F0 5 -yp  1F0 5 --p  1F1 5 -yp  1F1 5 --p }
1863: 0163 { 1F1 5 -yp  1F1 5 --p  1F1 5 -yp  1F1 5 --p }
1864: 0164 { 1F1 5 -yp  1F1 5 --p  1F2 5 -yp  1F2 5 --p }
1865: 0165 { 192 3 -y-  194 3 -y-  193 3 -y-  195 3 -y- }
1866: 0166 { 1E0 4 ---  1E3 4 ---  1E1 4 ---  1C3 4 --- }
1867: 0167 { 0FA 7 ---  1C4 4 ---  1E2 4 ---  0FA 7 --- }
1868: 0168 { 020 0 ---  020 0 ---  021 0 ---  021 0 --- }
1869: 0169 { 022 0 ---  022 0 ---  023 0 ---  023 0 --- }
186A: 016A { 026 0 ---  036 0 ---  026 0 x--  036 0 x-- }
186B: 016B { 026 6 ---  036 6 ---  026 6 x--  036 6 x-- }
186C: 016C { 026 7 ---  036 7 ---  026 7 x--  036 7 x-- }
186D: 016D { 027 7 ---  037 7 ---  027 7 x--  037 7 x-- }
186E: 016E { 0F8 3 ---  1B4 3 ---  0F8 3 ---  1B5 3 --- }
186F: 016F { 194 3 ---  1A9 3 ---  195 3 ---  1AA 3 --- }
1870: 0170 { 1C0 2 ---  1BE 2 ---  195 2 ---  1AA 2 --- }
1871: 0171 { 1C5 2 ---  1CC 2 ---  1C5 2 ---  1CD 2 --- }
1872: 0172 { 0FB 2 ---  1CC 2 ---  0FB 2 ---  1CD 2 --- }
1873: 0173 { 0F8 3 ---  1B6 3 ---  0F8 3 ---  1B7 3 --- }
1874: 0174 { 194 2 ---  1AB 2 ---  195 2 ---  1AC 2 --- }
1875: 0175 { 1C0 2 ---  1AF 2 ---  195 2 ---  1AC 2 --- }
1876: 0176 { 1C5 2 ---  1CE 2 ---  1C5 2 ---  1CF 2 --- }
1877: 0177 { 0FB 2 ---  1CE 2 ---  0FB 2 ---  1CF 2 --- }
1878: 0178 { 1B4 3 ---  1B8 3 ---  1B5 3 ---  1B9 3 --- }
1879: 0179 { 1ED 2 ---  1B8 2 ---  1EE 2 ---  1B9 2 --- }
187A: 017A { 1EF 2 ---  1B8 2 ---  1EE 2 ---  1B9 2 --- }
187B: 017B { 1C6 2 ---  1B8 2 ---  1C7 2 ---  1B9 2 --- }
187C: 017C { 1CC 2 ---  1B8 2 ---  1CD 2 ---  1B9 2 --- }
187D: 017D { 1A4 3 ---  1BA 3 ---  1A5 3 ---  193 3 --- }
187E: 017E { 1BB 3 ---  1BA 3 ---  1BC 3 ---  193 3 --- }
187F: 017F { 1BF 3 ---  1BA 3 ---  1BC 3 ---  193 3 --- }
1880: 0180 { 1C8 2 ---  1BA 2 ---  1A5 2 ---  193 2 --- }
1881: 0181 { 1CA 2 ---  1BA 2 ---  1A5 2 ---  193 2 --- }
1882: 0182 { 1A5 3 x--  192 3 ---  1A4 3 x--  1BA 3 x-- }
1883: 0183 { 1BC 3 x--  192 3 ---  1BB 3 x--  1BA 3 x-- }
1884: 0184 { 1BC 3 x--  193 3 x--  1BF 3 x--  1BA 3 x-- }
1885: 0185 { 1A5 2 x--  192 2 ---  1C8 2 x--  1BA 2 x-- }
1886: 0186 { 1A5 2 x--  192 2 ---  1CA 2 x--  1BA 2 x-- }
1887: 0187 { 1B5 3 x--  1B9 3 x--  1B4 3 x--  1B8 3 x-- }
1888: 0188 { 1EE 2 x--  1B9 2 x--  1ED 2 x--  1B8 2 x-- }
1889: 0189 { 1EE 2 x--  1B9 2 x--  1EF 2 x--  1B8 2 x-- }
188A: 018A { 1C7 2 x--  1B9 2 x--  1C6 2 x--  1B8 2 x-- }
188B: 018B { 1CD 2 x--  1B9 2 x--  1CC 2 x--  1B8 2 x-- }
188C: 018C { 0F8 3 ---  1B7 3 x--  0F8 3 ---  1B6 3 x-- }
188D: 018D { 194 2 ---  1AC 2 x--  195 2 ---  1AB 2 x-- }
188E: 018E { 194 2 ---  1AC 2 x--  1C0 2 x--  1AF 2 x-- }
188F: 018F { 1C5 2 ---  1CF 2 x--  1C5 2 ---  1CE 2 x-- }
1890: 0190 { 0FB 2 ---  1CF 2 x--  0FB 2 ---  1CE 2 x-- }
1891: 0191 { 0F8 3 ---  1B5 3 x--  0F8 3 ---  1B4 3 x-- }
1892: 0192 { 194 2 ---  1AA 2 x--  195 2 ---  1A9 2 x-- }
1893: 0193 { 194 2 ---  1AA 2 x--  1C0 2 x--  1BE 2 x-- }
1894: 0194 { 1C5 2 ---  1CD 2 x--  1C5 2 ---  1CC 2 x-- }
1895: 0195 { 0FB 2 ---  1CD 2 x--  0FB 2 ---  1CC 2 x-- }
1896: 0196 { 0F8 3 ---  19B 3 ---  0F8 3 ---  19C 3 --- }
1897: 0197 { 194 2 ---  1A0 2 ---  195 2 ---  1B1 2 --- }
1898: 0198 { 1C0 2 ---  18F 2 ---  195 2 ---  1B1 2 --- }
1899: 0199 { 1C5 2 ---  1D5 2 ---  1C5 2 ---  1D6 2 --- }
189A: 019A { 0FB 2 ---  1D5 2 ---  0FB 2 ---  1D6 2 --- }
189B: 019B { 19B 3 ---  19D 3 ---  18E 3 ---  19E 3 --- }
189C: 019C { 1EC 3 ---  19D 3 ---  1A1 3 ---  19E 3 --- }
189D: 019D { 1EB 3 ---  19D 3 ---  1A1 3 ---  19E 3 --- }
189E: 019E { 1CA 2 ---  19D 2 ---  1CB 2 ---  19E 2 --- }
189F: 019F { 1D5 2 ---  19D 2 ---  1D6 2 ---  19E 2 --- }
18A0: 01A0 { 18E 3 x--  19E 3 x--  19B 3 x--  19D 3 x-- }
18A1: 01A1 { 1A1 3 x--  19E 3 x--  1EC 3 x--  19D 3 x-- }
18A2: 01A2 { 1A1 3 x--  19E 3 x--  1EB 3 x--  19D 3 x-- }
18A3: 01A3 { 1CB 2 x--  19E 2 x--  1CA 2 x--  19D 2 x-- }
18A4: 01A4 { 1D6 2 x--  19E 2 x--  1D5 2 x--  19D 2 x-- }
18A5: 01A5 { 0F8 3 ---  19C 3 x--  0F8 3 ---  19B 3 x-- }
18A6: 01A6 { 194 3 ---  1B1 3 x--  195 3 ---  1A0 3 x-- }
18A7: 01A7 { 194 3 ---  1B1 3 x--  1C0 3 x--  18F 3 x-- }
18A8: 01A8 { 1C5 2 ---  1D6 2 x--  1C5 2 ---  1D5 2 x-- }
18A9: 01A9 { 0FB 2 ---  1D6 2 x--  0FB 2 ---  1D5 2 x-- }
18AA: 01AA { 0F8 3 ---  196 3 ---  187 3 ---  197 3 --- }
18AB: 01AB { 194 3 ---  188 3 ---  189 3 ---  197 3 --- }
18AC: 01AC { 1C0 3 ---  198 3 ---  189 3 ---  197 3 --- }
18AD: 01AD { 1C5 2 ---  1D8 2 ---  1C9 2 ---  197 2 --- }
18AE: 01AE { 0FB 2 ---  1D8 2 ---  1D8 2 ---  197 2 --- }
18AF: 01AF { 187 3 x--  197 3 x--  0F8 3 ---  196 3 x-- }
18B0: 01B0 { 189 2 x--  197 2 x--  195 2 ---  188 2 x-- }
18B1: 01B1 { 189 2 x--  197 2 x--  1C0 2 x--  198 2 x-- }
18B2: 01B2 { 1C9 2 x--  197 2 x--  1C5 2 ---  1D8 2 x-- }
18B3: 01B3 { 1D8 2 x--  197 2 x--  0FB 2 ---  1D8 2 x-- }
18B4: 01B4 { 0DE 7 ---  0EE 7 ---  0DF 7 ---  0EF 7 --- }
18B5: 01B5 { 0DF 7 x--  0EF 7 x--  0DE 7 x--  0EE 7 x-- }
18B6: 01B6 { 1C1 4 ---  1D1 4 ---  1C2 4 ---  1D2 4 --- }
18B7: 01B7 { 1C2 4 x--  1D2 4 x--  1C1 4 x--  1D1 4 x-- }
18B8: 01B8 { 1A4 2 ---  1BA 2 ---  1BD 2 ---  1D0 2 x-- }
18B9: 01B9 { 1BB 2 ---  1BA 2 ---  1AD 2 ---  1D0 2 x-- }
18BA: 01BA { 1BD 2 x--  1D0 2 ---  1A4 2 x--  1BA 2 x-- }
18BB: 01BB { 1AD 2 x--  1D0 2 ---  1BB 2 x--  1BA 2 x-- }
18BC: 01BC { 19B 2 ---  19D 2 ---  1A3 2 ---  1B2 2 --- }
18BD: 01BD { 1EC 2 ---  19D 2 ---  1A2 2 ---  1B2 2 --- }
18BE: 01BE { 1A3 2 x--  1B2 2 x--  19B 2 x--  19D 2 x-- }
18BF: 01BF { 1A2 2 x--  1B2 2 x--  1EC 2 x--  19D 2 x-- }
18C0: 01C0 { 0F8 3 ---  196 3 ---  18A 3 ---  19A 3 --- }
18C1: 01C1 { 194 2 ---  188 2 ---  199 2 ---  19A 2 --- }
18C2: 01C2 { 18A 2 x--  19A 2 x--  0F8 2 ---  196 2 x-- }
18C3: 01C3 { 199 2 x--  19A 2 x--  195 2 ---  188 2 x-- }
18C4: 01C4 { 196 3 -y-  0F8 3 ---  197 3 -y-  187 3 -y- }
18C5: 01C5 { 197 3 xy-  187 3 xy-  196 3 xy-  0F8 3 --- }
18C6: 01C6 { 19B 3 -y-  0F8 3 ---  19C 3 -y-  0F8 3 --- }
18C7: 01C7 { 19D 3 -y-  19B 3 -y-  19E 3 -y-  18E 3 -y- }
18C8: 01C8 { 19E 3 xy-  18E 3 xy-  19D 3 xy-  19B 3 xy- }
18C9: 01C9 { 19C 3 xy-  0F8 3 ---  19B 3 xy-  0F8 3 --- }
18CA: 01CA { 0F8 2 ---  0F8 2 ---  1C1 2 ---  1D1 2 --- }
18CB: 01CB { 1C1 2 ---  1D1 2 ---  1C2 2 ---  1D2 2 --- }
18CC: 01CC { 1C1 2 x--  1D1 2 x--  0F8 2 ---  0F8 2 --- }
18CD: 01CD { 1C2 2 x--  1D2 2 x--  1C1 2 x--  1D1 2 x-- }
18CE: 01CE { 0F8 7 ---  044 2 ---  044 2 ---  045 2 --- }
18CF: 01CF { 048 2 x--  049 2 x--  0F8 7 ---  048 2 x-- }
18D0: 01D0 { 044 2 x--  045 2 x--  0F8 7 ---  044 2 x-- }
18D1: 01D1 { 0F8 7 ---  048 2 ---  048 2 ---  049 2 --- }
18D2: 01D2 { 0F8 5 --p  04C 5 --p  0F8 5 --p  04D 5 --p }
18D3: 01D3 { 04C 5 --p  04E 5 --p  04D 5 --p  04F 5 --p }
18D4: 01D4 { 041 5 x-p  043 5 x-p  040 5 x-p  042 5 x-p }
18D5: 01D5 { 0F8 5 --p  041 5 x-p  0F8 5 --p  040 5 x-p }
18D6: 01D6 { 0F8 5 --p  044 5 --p  044 5 --p  045 5 --p }
18D7: 01D7 { 046 5 x-p  047 5 x-p  0F8 5 --p  046 5 x-p }
18D8: 01D8 { 1A6 3 ---  192 3 ---  1A7 3 ---  193 3 --- }
18D9: 01D9 { 1AE 3 ---  1D0 3 ---  1A7 3 ---  193 3 --- }
18DA: 01DA { 1A8 3 ---  192 3 ---  195 3 ---  193 3 --- }
18DB: 01DB { 194 3 ---  192 3 ---  1A8 3 x--  193 3 --- }
18DC: 01DC { 1A7 3 x--  192 3 ---  1A6 3 x--  193 3 --- }
18DD: 01DD { 1A7 3 x--  192 3 ---  1AE 3 x--  1D0 3 x-- }
18DE: 01DE { 18C 3 ---  192 3 ---  1B3 3 ---  193 3 --- }
18DF: 01DF { 19F 3 ---  1D0 3 ---  1B3 3 ---  193 3 --- }
18E0: 01E0 { 1B3 3 x--  192 3 ---  18C 3 x--  193 3 --- }
18E1: 01E1 { 1B3 3 x--  192 3 ---  19F 3 x--  1D0 3 x-- }
18E2: 01E2 { 186 3 ---  192 3 ---  195 3 ---  193 3 --- }
18E3: 01E3 { 18B 3 ---  1D0 3 ---  195 3 ---  193 3 --- }
18E4: 01E4 { 194 3 ---  192 3 ---  186 3 x--  193 3 --- }
18E5: 01E5 { 194 3 ---  192 3 ---  18B 3 x--  1D0 3 x-- }
18E6: 01E6 { 194 3 ---  192 3 ---  195 3 ---  193 3 --- }
18E7: 01E7 { 1C0 3 ---  1D0 3 ---  195 3 ---  193 3 --- }
18E8: 01E8 { 194 3 ---  192 3 ---  1C0 3 x--  1D0 3 x-- }
18E9: 01E9 { 186 3 ---  192 3 ---  1C0 3 x--  1D0 3 x-- }
18EA: 01EA { 1C0 3 ---  1D0 3 ---  186 3 x--  193 3 x-- }
18EB: 01EB { 182 3 ---  192 3 ---  183 3 ---  193 3 --- }
18EC: 01EC { 192 3 -y-  186 3 -y-  193 3 -y-  195 3 -y- }
18ED: 01ED { 192 3 -y-  194 3 -y-  193 3 -y-  186 3 xy- }
18EE: 01EE { 192 3 -y-  18C 3 -y-  193 3 -y-  1B3 3 -y- }
18EF: 01EF { 192 3 -y-  1B3 3 xy-  193 3 -y-  18C 3 xy- }
18F0: 0044 { 192 3 -y-  194 3 -y-  193 3 -y-  195 3 -y- }
18F1: 01F1 { 1C2 2 ---  1D2 2 ---  195 2 ---  193 2 --- }
18F2: 01F2 { 194 2 ---  192 2 ---  1C2 2 x--  1D2 2 x-- }
18F3: 01F3 { 045 2 ---  047 2 ---  047 2 ---  192 2 --- }
18F4: 01F4 { 04B 2 x--  192 2 x--  049 2 x--  04B 2 x-- }
18F5: 01F5 { 047 2 x--  192 2 x--  045 2 x--  047 2 x-- }
18F6: 01F6 { 049 2 ---  04B 2 ---  04B 2 ---  192 2 --- }
18F7: 01F7 { 1C2 2 ---  0F8 2 ---  193 2 ---  1D1 2 xy- }
18F8: 01F8 { 1F3 2 ---  193 2 ---  193 2 ---  1B0 2 xy- }
18F9: 01F9 { 194 2 ---  1D1 2 -y-  1C2 2 x--  0F8 2 --- }
18FA: 01FA { 194 2 ---  1B0 2 -y-  1F3 2 x--  193 2 --- }
18FB: 01FB { 04E 5 --p  0FB 5 --p  04F 5 --p  0FB 5 --p }
18FC: 01FC { 043 5 x-p  0FB 5 --p  042 5 x-p  0FB 5 --p }
18FD: 01FD { 045 5 --p  0FB 5 --p  0FB 5 --p  0FB 5 --p }
18FE: 01FE { 0FB 5 --p  0FB 5 --p  047 5 x-p  0FB 5 --p }
18FF: 01FF { 0FB 5 --p  0FB 5 --p  0FB 5 --p  0FB 5 --p }
