1000: 010C { 04E 7 ---  0F8 7 ---  04E 7 ---  0F8 7 --- }
1001: 010D { 04E 7 x--  0F8 7 ---  04E 7 x--  0F8 7 --- }
1002: 0100 { 182 7 ---  192 7 ---  183 7 ---  193 7 --- }
1003: 0101 { 181 7 ---  1D0 7 ---  183 7 ---  193 7 --- }
1004: 0102 { 18D 7 ---  1D0 7 ---  183 7 ---  193 7 --- }
1005: 0103 { 182 7 ---  192 7 ---  181 7 x--  1D0 7 x-- }
1006: 0104 { 182 7 ---  192 7 ---  18D 7 x--  1D0 7 x-- }
1007: 012F { 05F 6 xy-  05D 6 xy-  05E 6 xy-  05C 6 xy- }
1008: 011A { 060 6 ---  062 6 ---  061 6 ---  063 6 --- }
1009: 015A { 048 7 x-p  049 7 x-p  04A 7 x-p  0FB 7 x-p }
100A: 0159 { 04A 7 --p  0FB 7 --p  04B 7 --p  0FB 7 --p }
100B: 015A { 04A 7 --p  0FB 7 --p  048 7 --p  049 7 --p }
100C: 01D6 { 0F8 7 --p  044 7 --p  044 7 --p  045 7 --p }
100D: 01D7 { 046 7 x-p  047 7 x-p  0F8 7 --p  046 7 x-p }
100E: 0130 { 190 2 -y-  191 2 -y-  193 2 -y-  183 2 -y- }
100F: 0180 { 1CE 2 ---  1BA 2 ---  1CF 2 ---  193 2 --- }
1010: 013B { 004 2 ---  014 2 ---  005 2 ---  015 2 --- }
1011: 013D { 02E 2 ---  03E 2 ---  02E 2 ---  03E 2 --- }
1012: 013B { 005 2 x--  015 2 x--  004 2 x--  014 2 x-- }
1013: 0139 { 000 2 ---  010 2 ---  001 2 ---  011 2 --- }
1014: 013A { 002 2 ---  012 2 ---  003 2 ---  013 2 --- }
1015: 01D2 { 0F8 7 --p  04C 7 --p  0F8 7 --p  04D 7 --p }
1016: 01D3 { 04C 7 --p  04E 7 --p  04D 7 --p  04F 7 --p }
1017: 01D4 { 041 7 x-p  043 7 x-p  040 7 x-p  042 7 x-p }
1018: 01D5 { 0F8 7 --p  041 7 x-p  0F8 7 --p  040 7 x-p }
1019: 015B { 049 7 x-p  049 7 x-p  0FB 7 x-p  0FB 7 x-p }
101A: 01FF { 0FB 7 --p  0FB 7 --p  0FB 7 --p  0FB 7 --p }
101B: 015B { 0FB 7 --p  0FB 7 --p  049 7 --p  049 7 --p }
101C: 01FD { 045 7 --p  0FB 7 --p  0FB 7 --p  0FB 7 --p }
101D: 01FE { 0FB 7 --p  0FB 7 --p  047 7 x-p  0FB 7 --p }
101E: 015A { 0DE 6 ---  0EE 6 ---  0DF 6 ---  0EF 6 --- }
101F: 0186 { 1CF 2 x--  193 2 x--  1CE 2 x--  1BA 2 x-- }
1020: 013F { 024 2 ---  034 2 ---  025 2 ---  035 2 --- }
1021: 013E { 02F 2 ---  03F 2 ---  02F 2 ---  03F 2 --- }
1022: 013C { 025 2 x--  035 2 x--  024 2 x--  034 2 x-- }
1023: 0135 { 020 2 ---  020 2 ---  021 2 ---  021 2 --- }
1024: 0136 { 022 2 ---  022 2 ---  023 2 ---  023 2 --- }
1025: 01FB { 04E 7 --p  0FB 7 --p  04F 7 --p  0FB 7 --p }
1026: 0004 { 200 7 --p  0FB 7 --p  201 7 --p  0FB 7 --p }
1027: 0005 { 0FB 7 --p  0FB 7 --p  0FB 7 --p  0FB 7 --p }
1028: 01FC { 043 7 x-p  0FB 7 --p  042 7 x-p  0FB 7 --p }
1029: 015A { 049 7 xyp  048 7 xyp  0FB 7 xyp  04A 7 xyp }
102A: 0159 { 0FB 7 -yp  04A 7 -yp  0FB 7 -yp  04B 7 -yp }
102B: 015A { 0FB 7 -yp  04A 7 -yp  049 7 -yp  048 7 -yp }
102C: 0130 { 08E 2 ---  09E 2 ---  08F 2 ---  09F 2 --- }
102D: 0130 { 08F 2 x--  09F 2 x--  08E 2 x--  09E 2 x-- }
102E: 0026 { 0F8 2 ---  00C 2 ---  0F8 2 ---  00C 2 x-- }
102F: 0000 { 070 2 ---  072 2 ---  071 2 ---  073 2 --- }
1030: 0156 { 1FA 2 ---  1FD 2 ---  1FB 2 ---  1FE 2 --- }
1031: 0157 { 1FC 2 ---  1FF 2 ---  1FC 2 ---  1FF 2 --- }
1032: 0158 { 1FB 2 x--  1FE 2 x--  1FA 2 x--  1FD 2 x-- }
1033: 0137 { 010 2 -y-  000 2 -y-  011 2 -y-  001 2 -y- }
1034: 0138 { 012 2 -y-  002 2 -y-  013 2 -y-  003 2 -y- }
1035: 0025 { 0B0 2 ---  0C0 2 ---  0B1 2 ---  0C1 2 --- }
1036: 0025 { 0B1 2 ---  0C1 2 ---  0B1 2 ---  0C1 2 --- }
1037: 0025 { 0B1 2 x--  0C1 2 x--  0B0 2 x--  0C0 2 x-- }
1038: 01AA { 0F8 2 ---  0C2 2 ---  0C2 2 ---  0C3 2 --- }
1039: 01E2 { 0B2 2 ---  0C1 2 ---  0B1 2 ---  0C1 2 --- }
103A: 01E4 { 0B1 2 x--  0C1 2 x--  0B2 2 x--  0C1 2 x-- }
103B: 01AF { 0C2 2 x--  0C3 2 x--  0F8 2 x--  0C2 2 x-- }
103C: 0130 { 09E 2 -y-  08E 2 -y-  09F 2 -y-  08F 2 -y- }
103D: 0130 { 09F 2 xy-  08F 2 xy-  09E 2 xy-  08E 2 xy- }
103E: 0144 { 01C 2 -y-  01C 2 ---  01C 2 xy-  01C 2 x-- }
103F: 0002 { 0FD 2 ---  0FD 2 ---  0FD 2 ---  0FD 2 --- }
1040: 0130 { 1B0 7 ---  1A0 7 ---  181 7 ---  191 7 --- }
1041: 0100 { 180 7 ---  191 7 ---  181 7 ---  191 7 --- }
1042: 0130 { 180 7 ---  191 7 ---  1B1 7 ---  192 7 --- }
1043: 0100 { 1D0 7 ---  1E0 7 ---  1D3 7 ---  1E3 7 --- }
1044: 0100 { 1D2 7 ---  1E2 7 ---  1D1 7 ---  1E1 7 --- }
1045: 0100 { 1D2 7 ---  1E2 7 ---  1D3 7 ---  1E3 7 --- }
1046: 0130 { 183 7 ---  193 7 ---  184 7 ---  194 7 --- }
1047: 0130 { 184 7 ---  194 7 ---  184 7 ---  194 7 --- }
1048: 0130 { 184 7 ---  194 7 ---  185 7 ---  195 7 --- }
1049: 0130 { 183 7 ---  193 7 ---  185 7 ---  195 7 --- }
104A: 01AA { 0F8 7 ---  18A 7 ---  18A 7 ---  19A 7 --- }
104B: 01AF { 18B 7 ---  19B 7 ---  0F8 7 ---  18B 7 --- }
104C: 0196 { 0F8 7 ---  18C 7 ---  0F8 7 ---  18D 7 --- }
104D: 019B { 18C 7 ---  19C 7 ---  18D 7 ---  19D 7 --- }
104E: 01A0 { 18E 7 ---  19E 7 ---  18F 7 ---  19F 7 --- }
104F: 01A5 { 0F8 7 ---  18E 7 ---  0F8 7 ---  18F 7 --- }
1050: 0130 { 190 7 ---  1A0 7 ---  191 7 ---  191 7 --- }
1051: 003F { 191 7 ---  191 7 ---  191 7 ---  191 7 --- }
1052: 0130 { 191 7 ---  191 7 ---  182 7 ---  192 7 --- }
1053: 0025 { 1E0 7 ---  1E0 7 ---  1E3 7 ---  1E3 7 --- }
1054: 0025 { 1E2 7 ---  1E2 7 ---  1E1 7 ---  1E1 7 --- }
1055: 0025 { 1E2 7 ---  1E2 7 ---  1E3 7 ---  1E3 7 --- }
1056: 0130 { 193 7 ---  193 7 ---  194 7 ---  194 7 --- }
1057: 0130 { 194 7 ---  194 7 ---  194 7 ---  194 7 --- }
1058: 0130 { 194 7 ---  194 7 ---  195 7 ---  195 7 --- }
1059: 0130 { 193 7 ---  193 7 ---  195 7 ---  195 7 --- }
105A: 01F0 { 19A 7 ---  191 7 ---  191 7 ---  191 7 --- }
105B: 01F0 { 191 7 ---  191 7 ---  19B 7 ---  191 7 --- }
105C: 01F0 { 19C 7 ---  191 7 ---  19D 7 ---  191 7 --- }
105D: 01F0 { 191 7 ---  191 7 ---  191 7 ---  191 7 --- }
105E: 01F0 { 191 7 ---  191 7 ---  191 7 ---  191 7 --- }
105F: 01F0 { 19E 7 ---  191 7 ---  19F 7 ---  191 7 --- }
1060: 0130 { 190 7 ---  1C0 7 ---  191 7 ---  1A2 7 --- }
1061: 0130 { 191 7 ---  1A1 7 ---  191 7 ---  1A2 7 --- }
1062: 0130 { 191 7 ---  1A1 7 ---  182 7 ---  1C1 7 --- }
1063: 0025 { 1E0 7 ---  1F0 7 ---  1E3 7 ---  1F3 7 --- }
1064: 0025 { 1E2 7 ---  1F2 7 ---  1E1 7 ---  1F1 7 --- }
1065: 0025 { 1E2 7 ---  1F2 7 ---  1E3 7 ---  1F3 7 --- }
1066: 0130 { 193 7 ---  1A3 7 ---  194 7 ---  1A4 7 --- }
1067: 0130 { 194 7 ---  1A4 7 ---  194 7 ---  1A4 7 --- }
1068: 0130 { 194 7 ---  1A4 7 ---  195 7 ---  1A5 7 --- }
1069: 0130 { 193 7 ---  1A3 7 ---  195 7 ---  1A5 7 --- }
106A: 01AA { 191 7 ---  1AA 7 ---  1AA 7 ---  19A 7 --- }
106B: 01AF { 1AB 7 ---  19B 7 ---  191 7 ---  1AB 7 --- }
106C: 0196 { 191 7 ---  1AC 7 ---  191 7 ---  1AD 7 --- }
106D: 019B { 1AC 7 ---  19C 7 ---  1AD 7 ---  19D 7 --- }
106E: 01A0 { 1AE 7 ---  19E 7 ---  1AF 7 ---  19F 7 --- }
106F: 01A5 { 191 7 ---  1AE 7 ---  191 7 ---  1AF 7 --- }
1070: 01F0 { 1B2 7 ---  191 7 ---  191 7 ---  191 7 --- }
1071: 01F0 { 191 7 ---  191 7 ---  1B3 7 ---  191 7 --- }
1072: 0130 { 186 7 ---  196 7 ---  187 7 ---  197 7 --- }
1073: 0130 { 1E8 7 ---  193 7 ---  184 7 ---  194 7 --- }
1074: 0130 { 184 7 ---  194 7 ---  1E9 7 ---  195 7 --- }
1075: 0130 { 1E8 7 ---  193 7 ---  1E9 7 ---  195 7 --- }
1076: 0130 { 183 7 ---  1A3 7 ---  184 7 ---  1A4 7 --- }
1077: 0130 { 184 7 ---  1A4 7 ---  184 7 ---  1A4 7 --- }
1078: 0130 { 184 7 ---  1A4 7 ---  185 7 ---  1A5 7 --- }
1079: 0130 { 183 7 ---  1A3 7 ---  185 7 ---  1A5 7 --- }
107A: 0106 { 1C4 7 ---  188 7 ---  1C5 7 ---  189 7 --- }
107B: 0106 { 1D4 7 ---  198 7 ---  1D5 7 ---  199 7 --- }
107C: 0100 { 1D0 7 ---  1E0 7 ---  1D1 7 ---  1E1 7 --- }
107D: 0025 { 1A8 7 ---  1E0 7 ---  1A9 7 ---  1E1 7 --- }
107E: 0025 { 1E5 7 x--  1F5 7 x--  1E4 7 x--  1F4 7 x-- }
107F: 0025 { 1E4 7 ---  1F4 7 ---  1E5 7 ---  1F5 7 --- }
1080: 01F0 { 191 7 ---  1C2 7 ---  191 7 ---  191 7 --- }
1081: 01F0 { 191 7 ---  191 7 ---  191 7 ---  1C3 7 --- }
1082: 0100 { 1BA 7 ---  1CA 7 ---  1BB 7 ---  1CB 7 --- }
1083: 0130 { 193 7 ---  1F8 7 ---  194 7 ---  1A4 7 --- }
1084: 0130 { 194 7 ---  1A4 7 ---  195 7 ---  1F9 7 --- }
1085: 0130 { 193 7 ---  1F8 7 ---  195 7 ---  1F9 7 --- }
1086: 0130 { 1C8 7 ---  1A0 7 ---  181 7 ---  191 7 --- }
1087: 0130 { 180 7 ---  191 7 ---  1C9 7 ---  192 7 --- }
1088: 0025 { 1C6 7 ---  1D6 7 ---  1C7 7 ---  1D7 7 --- }
1089: 0025 { 1C7 7 x--  1D7 7 x--  1C6 7 x--  1D6 7 x-- }
108A: 0025 { 188 7 ---  188 7 ---  189 7 ---  189 7 --- }
108B: 0025 { 198 7 ---  198 7 ---  199 7 ---  199 7 --- }
108C: 0025 { 1E0 7 ---  1E0 7 ---  1E1 7 ---  1E1 7 --- }
108D: 0106 { 1B8 7 ---  1D0 7 ---  1B9 7 ---  1D1 7 --- }
108E: 0106 { 1B8 7 ---  0F8 7 ---  1B9 7 ---  0F8 7 --- }
108F: 0006 { 1EA 7 ---  1EA 7 ---  1EB 7 ---  1EB 7 --- }
1090: 0100 { 1BE 7 ---  191 7 ---  1BF 7 ---  191 7 --- }
1091: 0006 { 1CA 7 ---  1DA 7 ---  1CB 7 ---  1DB 7 --- }
1092: 0006 { 1CA 7 ---  1CA 7 ---  1CB 7 ---  1CB 7 --- }
1093: 0130 { 1E8 7 ---  1F8 7 ---  184 7 ---  1A4 7 --- }
1094: 0130 { 184 7 ---  1A4 7 ---  1E9 7 ---  1F9 7 --- }
1095: 0130 { 1E8 7 ---  1F8 7 ---  1E9 7 ---  1F9 7 --- }
1096: 0130 { 190 7 ---  1D8 7 ---  191 7 ---  1A2 7 --- }
1097: 0130 { 191 7 ---  1A1 7 ---  182 7 ---  1D9 7 --- }
1098: 0025 { 1E6 7 ---  1F6 7 ---  1E7 7 ---  1F7 7 --- }
1099: 0025 { 1E7 7 x--  1F7 7 x--  1E6 7 x--  1F6 7 x-- }
109A: 0025 { 188 7 ---  1A6 7 ---  189 7 ---  1A7 7 --- }
109B: 0025 { 198 7 ---  1B6 7 ---  199 7 ---  1B7 7 --- }
109C: 0025 { 1E0 7 ---  1F0 7 ---  1E1 7 ---  1F1 7 --- }
109D: 0106 { 1D0 7 ---  1F0 7 ---  1D1 7 ---  1F1 7 --- }
109E: 0025 { 1BC 7 ---  1CC 7 ---  1BC 7 x--  1CC 7 x-- }
109F: 0006 { 1EA 7 ---  1FA 7 ---  1EB 7 ---  1FB 7 --- }
10A0: 0130 { 180 7 ---  190 7 ---  182 7 ---  192 7 --- }
10A1: 0100 { 181 7 ---  191 7 ---  182 7 ---  192 7 --- }
10A2: 0130 { 181 7 x--  191 7 x--  180 7 x--  190 7 x-- }
10A3: 0196 { 0F8 7 ---  187 7 x--  0F8 7 ---  186 7 x-- }
10A4: 019B { 187 7 x--  197 7 x--  186 7 x--  196 7 x-- }
10A5: 01A0 { 186 7 ---  196 7 ---  187 7 ---  197 7 --- }
10A6: 01A5 { 0F8 7 x--  186 7 ---  0F8 7 x--  187 7 --- }
10A7: 01AA { 189 7 x--  199 7 x--  188 7 x--  198 7 x-- }
10A8: 01AF { 188 7 ---  198 7 ---  189 7 ---  199 7 --- }
10A9: 0196 { 195 7 x--  1AB 7 x--  194 7 x--  1AA 7 x-- }
10AA: 019B { 1AB 7 x--  197 7 x--  1AA 7 x--  196 7 x-- }
10AB: 01A0 { 1AA 7 ---  196 7 ---  1AB 7 ---  197 7 --- }
10AC: 01A5 { 194 7 ---  1AA 7 ---  195 7 ---  1AB 7 --- }
10AD: 01AA { 18D 7 x--  19D 7 x--  18C 7 x--  19C 7 x-- }
10AE: 01AF { 18C 7 ---  19C 7 ---  18D 7 ---  19D 7 --- }
10AF: 012F { 1B2 7 -y-  1A2 7 -y-  1B3 7 -y-  1A3 7 -y- }
10B0: 0130 { 190 7 -y-  190 7 ---  185 7 ---  195 7 --- }
10B1: 0130 { 184 7 ---  194 7 ---  185 7 ---  195 7 --- }
10B2: 0130 { 184 7 ---  194 7 ---  190 7 xy-  190 7 x-- }
10B3: 01DE { 197 7 x--  184 7 ---  196 7 x--  195 7 --- }
10B4: 0044 { 184 7 ---  194 7 ---  185 7 ---  195 7 --- }
10B5: 0044 { 184 7 ---  194 7 ---  185 7 ---  195 7 --- }
10B6: 01E0 { 196 7 ---  185 7 x--  197 7 ---  184 7 x-- }
10B7: 01E2 { 1A9 7 x--  194 7 ---  1A8 7 x--  195 7 --- }
10B8: 01E4 { 1A8 7 ---  194 7 ---  1A9 7 ---  195 7 --- }
10B9: 01DE { 197 7 x--  184 7 ---  196 7 x--  195 7 --- }
10BA: 0044 { 184 7 ---  194 7 ---  185 7 ---  195 7 --- }
10BB: 0044 { 184 7 ---  194 7 ---  185 7 ---  195 7 --- }
10BC: 01E0 { 196 7 ---  185 7 x--  197 7 ---  184 7 x-- }
10BD: 01E2 { 1A9 7 x--  194 7 ---  1A8 7 x--  195 7 --- }
10BE: 01E4 { 1A8 7 ---  194 7 ---  1A9 7 ---  195 7 --- }
10BF: 012F { 1A2 7 ---  1B2 7 ---  1A3 7 ---  1B3 7 --- }
10C0: 0130 { 190 7 -y-  180 7 -y-  191 7 -y-  181 7 -y- }
10C1: 0130 { 192 7 xy-  182 7 xy-  191 7 xy-  181 7 xy- }
10C2: 0130 { 192 7 xy-  182 7 xy-  190 7 xy-  180 7 xy- }
10C3: 0100 { 18A 7 ---  19A 7 ---  181 7 ---  191 7 --- }
10C4: 0100 { 182 7 x--  192 7 x--  181 7 x--  191 7 x-- }
10C5: 0100 { 182 7 ---  192 7 ---  18B 7 ---  19B 7 --- }
10C6: 01ED { 195 7 xy-  185 7 xy-  194 7 xy-  1A4 7 -y- }
10C7: 01EC { 195 7 xy-  1A4 7 xy-  194 7 xy-  184 7 xy- }
10C8: 01EC { 184 7 ---  1A9 7 xy-  185 7 ---  195 7 --- }
10C9: 01ED { 184 7 ---  194 7 ---  185 7 ---  1A9 7 -y- }
10CA: 01EE { 184 7 ---  197 7 xy-  185 7 ---  196 7 xy- }
10CB: 0130 { 184 7 ---  194 7 ---  185 7 ---  195 7 --- }
10CC: 0044 { 184 7 ---  194 7 ---  185 7 ---  195 7 --- }
10CD: 01EF { 184 7 ---  196 7 -y-  185 7 ---  197 7 -y- }
10CE: 0020 { 0D3 2 x--  0E3 2 x--  0D2 2 x--  0E2 2 x-- }
10CF: 0020 { 0D2 2 ---  0E2 2 ---  0D3 2 ---  0E3 2 --- }
10D0: 0025 { 0D3 2 x--  0E3 2 x--  0D2 2 x--  0E2 2 x-- }
10D1: 0025 { 0D2 2 ---  0E2 2 ---  0D3 2 ---  0E3 2 --- }
10D2: 01AF { 0B2 2 x--  0C3 2 x--  0E9 2 x--  0B2 2 x-- }
10D3: 0044 { 1A0 7 ---  1B0 7 ---  185 7 ---  195 7 --- }
10D4: 0044 { 184 7 ---  194 7 ---  185 7 ---  195 7 --- }
10D5: 0044 { 184 7 ---  194 7 ---  1A1 7 ---  1B1 7 --- }
10D6: 01E4 { 184 7 ---  194 7 ---  1A4 7 ---  195 7 --- }
10D7: 01E2 { 1A4 7 x--  194 7 ---  185 7 ---  195 7 --- }
10D8: 01C4 { 199 7 xy-  189 7 xy-  198 7 xy-  188 7 xy- }
10D9: 01C5 { 198 7 -y-  188 7 -y-  199 7 -y-  189 7 -y- }
10DA: 01C6 { 187 7 xy-  0F8 7 -y-  186 7 xy-  0F8 7 -y- }
10DB: 01C7 { 197 7 xy-  187 7 xy-  196 7 xy-  186 7 xy- }
10DC: 01C8 { 196 7 -y-  186 7 -y-  197 7 -y-  187 7 -y- }
10DD: 01C9 { 186 7 -y-  0F8 7 xy-  187 7 -y-  0F8 7 xy- }
10DE: 0020 { 0F3 2 x--  0F3 2 xy-  0F2 2 x--  0F2 2 xy- }
10DF: 0020 { 0F2 2 ---  0F2 2 -y-  0F3 2 ---  0F3 2 -y- }
10E0: 0025 { 0F3 2 x--  0F3 2 xy-  0F2 2 x--  0F2 2 xy- }
10E1: 0025 { 0F2 2 ---  0F2 2 -y-  0F3 2 ---  0F3 2 -y- }
10E2: 0025 { 0E8 2 ---  0E9 2 ---  0E9 2 ---  0E8 2 --- }
10E3: 0044 { 1A0 7 ---  1AC 7 ---  185 7 ---  1AD 7 --- }
10E4: 0044 { 184 7 ---  1AD 7 ---  185 7 ---  1AD 7 --- }
10E5: 0044 { 184 7 ---  1AD 7 ---  1A1 7 ---  1AE 7 --- }
10E6: 00B3 { 0E7 2 ---  0E7 2 ---  0FF 2 ---  0FF 2 --- }
10E7: 0105 { 00D 2 ---  0F8 2 ---  00D 2 ---  0F8 2 --- }
10E8: 01EB { 1CC 2 ---  1DC 2 ---  1CA 2 x--  1E0 2 x-- }
10E9: 01EB { 1FB 2 x--  1FE 2 x--  1FA 2 x--  1FD 2 x-- }
10EA: 0025 { 0B1 2 ---  0C1 2 ---  0A6 2 ---  0B6 2 --- }
10EB: 0025 { 0A7 2 x--  0B7 2 x--  0A6 2 x--  0B6 2 x-- }
10EC: 0025 { 0A6 2 ---  0B6 2 ---  0A7 2 ---  0B7 2 --- }
10ED: 0025 { 0A6 2 x--  0B6 2 x--  0B1 2 x--  0C1 2 x-- }
10EE: 0020 { 0E3 2 xy-  0D3 2 xy-  0E2 2 xy-  0D2 2 xy- }
10EF: 0020 { 0E2 2 -y-  0D2 2 -y-  0E3 2 -y-  0D3 2 -y- }
10F0: 0025 { 0E3 2 xy-  0D3 2 xy-  0E2 2 xy-  0D2 2 xy- }
10F1: 0025 { 0E2 2 -y-  0D2 2 -y-  0E3 2 -y-  0D3 2 -y- }
10F2: 0105 { 0E8 2 ---  0E9 2 ---  0E9 2 ---  0E8 2 --- }
10F3: 0144 { 1A2 0 ---  1B2 0 ---  1A3 0 ---  1B3 0 --- }
10F4: 0204 { 1A0 2 ---  1B0 2 ---  1A1 2 ---  1B1 2 --- }
10F5: 0033 { 075 1 --p  075 1 --p  0F8 1 ---  0F8 1 --- }
10F6: 0030 { 0F8 0 ---  0F8 0 ---  075 0 ---  075 0 --- }
10F7: 0035 { 0F8 0 ---  0F8 0 ---  076 0 ---  075 0 --- }
10F8: ~
10F9: ~
10FA: 0025 { 0B1 2 ---  0C1 2 ---  0B6 2 ---  0C6 2 --- }
10FB: 0025 { 0B7 2 x--  0C7 2 x--  0B6 2 x--  0C6 2 x-- }
10FC: 0025 { 0B6 2 ---  0C6 2 ---  0B7 2 ---  0C7 2 --- }
10FD: 0025 { 0B6 2 x--  0C6 2 x--  0B1 2 x--  0C1 2 x-- }
10FE: 01B4 { 0DE 2 ---  0EE 2 ---  0DF 2 ---  0EF 2 --- }
10FF: 0130 { 030 2 ---  032 2 ---  031 2 ---  033 2 --- }
