3200: 0025 { 0F8 0 ---  200 7 ---  0F8 0 ---  201 7 --- }
3201: 0025 { 0F8 0 ---  202 7 ---  0F8 0 ---  203 7 --- }
3202: 0049 { 126 6 ---  136 6 ---  127 6 ---  137 6 --- }
3203: 0025 { 0F8 1 --p  0F8 1 --p  0F8 1 --p  0F8 1 --p }
3204: 0025 { 0F8 1 --p  0F8 1 --p  0F8 1 --p  102 1 --p }
3205: 0025 { 0F8 1 --p  103 1 --p  0F8 1 --p  104 1 --p }
3206: 0025 { 0F8 1 --p  105 1 --p  0F8 1 --p  106 1 --p }
3207: 0025 { 0F8 1 --p  107 1 --p  0F8 1 --p  108 1 --p }
3208: 0025 { 0F8 1 --p  109 1 --p  0F8 1 --p  10A 1 --p }
3209: 0025 { 0F8 1 --p  10B 1 --p  0F8 1 --p  10C 1 --p }
320A: 0025 { 0F8 1 --p  10D 1 --p  0F8 1 --p  0F8 1 --p }
320B: 0025 { 0F8 1 --p  0F8 1 --p  0F8 1 --p  0F8 1 --p }
320C: 0025 { 0F8 1 --p  0F8 1 --p  0F8 1 --p  0F8 1 --p }
320D: 0130 { 224 0 ---  234 0 ---  225 0 ---  235 0 --- }
320E: 0130 { 226 0 ---  236 0 ---  227 0 ---  237 0 --- }
320F: ~
3210: 0025 { 204 7 ---  208 7 ---  205 7 ---  209 7 --- }
3211: 0025 { 206 7 ---  20A 7 ---  207 7 ---  20B 7 --- }
3212: 0049 { 128 6 ---  138 6 ---  129 6 ---  139 6 --- }
3213: 0025 { 0F8 1 --p  0F8 1 --p  110 1 --p  120 1 --p }
3214: 0025 { 111 1 --p  121 1 --p  112 1 --p  122 1 --p }
3215: 0025 { 113 1 --p  123 1 --p  114 1 --p  124 1 --p }
3216: 0025 { 115 1 --p  125 1 --p  116 1 --p  126 1 --p }
3217: 0025 { 117 1 --p  127 1 --p  118 1 --p  128 1 --p }
3218: 0025 { 119 1 --p  129 1 --p  11A 1 --p  12A 1 --p }
3219: 0025 { 11B 1 --p  1AD 1 --p  11C 1 --p  12C 1 --p }
321A: 0025 { 11D 1 --p  1AD 1 --p  11E 1 --p  1AD 1 --p }
321B: 0025 { 11F 1 --p  1AD 1 --p  154 1 --p  164 1 --p }
321C: 0025 { 0F8 1 --p  0F8 1 --p  0F8 1 --p  0F8 1 --p }
321D: 0130 { 226 0 ---  236 0 ---  227 0 ---  237 0 --- }
321E: 0130 { 224 0 ---  234 0 ---  225 0 ---  235 0 --- }
321F: ~
3220: 0025 { 20C 7 ---  210 7 ---  20D 7 ---  211 7 --- }
3221: 0025 { 20E 7 ---  212 7 ---  20F 7 ---  213 7 --- }
3222: 0100 { 12A 6 ---  13A 6 ---  12B 6 ---  13B 6 --- }
3223: 0025 { 0F8 1 --p  0F8 1 --p  130 1 --p  140 1 --p }
3224: 0025 { 131 1 --p  141 1 --p  132 1 --p  142 1 --p }
3225: 0025 { 133 1 --p  143 1 --p  134 1 --p  270 1 --p }
3226: 0025 { 135 1 --p  271 1 --p  136 1 --p  272 1 --p }
3227: 0025 { 137 1 --p  273 1 --p  138 1 --p  274 1 --p }
3228: 0025 { 139 1 --p  275 1 --p  13A 1 --p  14A 1 --p }
3229: 0025 { 13B 1 --p  14B 1 --p  13C 1 --p  14C 1 --p }
322A: 0025 { 13D 1 --p  14D 1 --p  13E 1 --p  14E 1 --p }
322B: 0025 { 13F 1 --p  14F 1 --p  174 1 --p  146 1 --p }
322C: 0025 { 0F8 1 --p  0F8 1 --p  0F8 1 --p  0F8 1 --p }
322D: ~
322E: ~
322F: ~
3230: 0025 { 214 7 ---  218 7 ---  215 7 ---  219 7 --- }
3231: 0025 { 216 7 ---  21A 7 ---  217 7 ---  21B 7 --- }
3232: 0100 { 148 4 ---  158 4 ---  149 4 ---  159 4 --- }
3233: 0025 { 0F8 1 --p  0F8 1 --p  150 1 --p  160 1 --p }
3234: 0025 { 151 1 --p  161 1 --p  152 1 --p  162 1 --p }
3235: 0025 { 153 1 --p  163 1 --p  276 1 --p  27A 1 --p }
3236: 0025 { 277 1 --p  27B 1 --p  000 1 --p  010 1 --p }
3237: 0025 { 001 1 --p  011 1 --p  278 1 --p  27C 1 --p }
3238: 0025 { 279 1 --p  27D 1 --p  15A 1 --p  16A 1 --p }
3239: 0025 { 1AD 1 --p  16B 1 --p  15C 1 --p  16C 1 --p }
323A: 0025 { 15D 1 --p  16D 1 --p  15E 1 --p  16E 1 --p }
323B: 0025 { 15F 1 --p  16F 1 --p  156 1 --p  166 1 --p }
323C: 0025 { 0F8 1 --p  0F8 1 --p  0F8 1 --p  0F8 1 --p }
323D: ~
323E: ~
323F: ~
3240: 0130 { 220 7 ---  230 7 ---  221 7 ---  231 7 --- }
3241: 0130 { 222 7 ---  232 7 ---  2BE 3 ---  2C2 3 --- }
3242: 0100 { 14A 4 ---  15A 4 ---  14B 4 ---  15B 4 --- }
3243: 0025 { 0F8 1 --p  0F8 1 --p  170 1 --p  180 1 --p }
3244: 0025 { 171 1 --p  181 1 --p  172 1 --p  182 1 --p }
3245: 0025 { 173 1 --p  183 1 --p  27E 1 --p  143 1 --p }
3246: 0025 { 27F 1 --p  259 1 --p  255 1 --p  25A 1 --p }
3247: 0025 { 256 1 --p  25B 1 --p  257 1 --p  25C 1 --p }
3248: 0025 { 258 1 --p  143 1 --p  17A 1 --p  18A 1 --p }
3249: 0025 { 17B 1 --p  18B 1 --p  17C 1 --p  18C 1 --p }
324A: 0025 { 17D 1 --p  18D 1 --p  17E 1 --p  18E 1 --p }
324B: 0025 { 17F 1 --p  18F 1 --p  176 1 --p  145 1 --p }
324C: 0025 { 0F8 1 --p  0F8 1 --p  0F8 1 --p  0F8 1 --p }
324D: ~
324E: ~
324F: ~
3250: 0130 { 240 7 ---  250 7 ---  241 7 ---  251 7 --- }
3251: 0130 { 242 7 ---  252 7 ---  2C6 3 ---  2CB 3 --- }
3252: 0100 { 14C 4 ---  15C 4 ---  14D 4 ---  15D 4 --- }
3253: 0025 { 0F8 1 --p  0F8 1 --p  190 1 --p  1A0 1 --p }
3254: 0025 { 191 1 --p  1A1 1 --p  192 1 --p  1A2 1 --p }
3255: 0025 { 193 1 --p  1A3 1 --p  194 1 --p  1A4 1 --p }
3256: 0025 { 195 1 --p  1A5 1 --p  196 1 --p  1A6 1 --p }
3257: 0025 { 197 1 --p  1A7 1 --p  198 1 --p  1A8 1 --p }
3258: 0025 { 199 1 --p  1A9 1 --p  19A 1 --p  1AA 1 --p }
3259: 0025 { 19B 1 --p  1AB 1 --p  19C 1 --p  1AC 1 --p }
325A: 0025 { 19D 1 --p  1AD 1 --p  19E 1 --p  1AE 1 --p }
325B: 0025 { 19F 1 --p  1AF 1 --p  155 1 --p  165 1 --p }
325C: 0025 { 0F8 1 --p  0F8 1 --p  0F8 1 --p  0F8 1 --p }
325D: ~
325E: ~
325F: ~
3260: 0025 { 0F8 5 ---  280 5 ---  0F8 5 ---  281 5 --- }
3261: 0025 { 0F8 5 ---  282 5 ---  0F8 5 ---  283 5 --- }
3262: 0130 { 230 7 ---  240 7 ---  231 7 ---  241 7 --- }
3263: 0025 { 0F8 1 --p  0F8 1 --p  1B0 1 --p  1C0 1 --p }
3264: 0025 { 1B1 1 --p  1C1 1 --p  1B2 1 --p  1C2 1 --p }
3265: 0025 { 1B3 1 --p  1C3 1 --p  1B4 1 --p  1C4 1 --p }
3266: 0025 { 1B5 1 --p  1C5 1 --p  1B6 1 --p  1C6 1 --p }
3267: 0025 { 1B7 1 --p  1C7 1 --p  1B8 1 --p  1C8 1 --p }
3268: 0025 { 1B9 1 --p  1C9 1 --p  1BA 1 --p  1CA 1 --p }
3269: 0025 { 1BB 1 --p  1CB 1 --p  1BC 1 --p  1CC 1 --p }
326A: 0025 { 1BD 1 --p  1CD 1 --p  1BE 1 --p  1CE 1 --p }
326B: 0025 { 1BF 1 --p  1CF 1 --p  175 1 --p  148 1 --p }
326C: 0025 { 0F8 1 --p  0F8 1 --p  0F8 1 --p  0F8 1 --p }
326D: ~
326E: ~
326F: ~
3270: 0025 { 284 5 ---  288 5 ---  285 5 ---  289 5 --- }
3271: 0025 { 286 5 ---  28A 5 ---  287 5 ---  28B 5 --- }
3272: ~
3273: 0025 { 0F8 1 --p  0F8 1 --p  1D0 1 --p  1E0 1 --p }
3274: 0025 { 1D1 1 --p  1E1 1 --p  1D2 1 --p  1E2 1 --p }
3275: 0025 { 1D3 1 --p  1E3 1 --p  1D4 1 --p  1E4 1 --p }
3276: 0025 { 1D5 1 --p  1E5 1 --p  1D6 1 --p  1E6 1 --p }
3277: 0025 { 1D7 1 --p  1E7 1 --p  1D8 1 --p  1E8 1 --p }
3278: 0025 { 1D9 1 --p  1E9 1 --p  1DA 1 --p  1EA 1 --p }
3279: 0025 { 1DB 1 --p  1EB 1 --p  1DC 1 --p  1EC 1 --p }
327A: 0025 { 1DD 1 --p  1ED 1 --p  1DE 1 --p  1EE 1 --p }
327B: 0025 { 1DF 1 --p  1EF 1 --p  158 1 --p  168 1 --p }
327C: 0025 { 0F8 1 --p  169 1 --p  0F8 1 --p  0F8 1 --p }
327D: ~
327E: ~
327F: ~
3280: 0025 { 28C 5 ---  290 5 ---  28D 5 ---  291 5 --- }
3281: 0025 { 28E 5 ---  292 5 ---  28F 5 ---  293 5 --- }
3282: ~
3283: 0025 { 0F8 1 --p  0F8 1 --p  1F0 1 --p  200 1 --p }
3284: 0025 { 1F1 1 --p  201 1 --p  1F2 1 --p  202 1 --p }
3285: 0025 { 1F3 1 --p  203 1 --p  1F4 1 --p  204 1 --p }
3286: 0025 { 1F5 1 --p  205 1 --p  1F6 1 --p  206 1 --p }
3287: 0025 { 1F7 1 --p  207 1 --p  1F8 1 --p  208 1 --p }
3288: 0025 { 1F9 1 --p  209 1 --p  1FA 1 --p  20A 1 --p }
3289: 0025 { 1FB 1 --p  20B 1 --p  1FC 1 --p  20C 1 --p }
328A: 0025 { 1FD 1 --p  20D 1 --p  1FE 1 --p  20E 1 --p }
328B: 0025 { 1FF 1 --p  20F 1 --p  178 1 --p  101 1 --p }
328C: 0025 { 179 1 --p  10E 1 --p  0F8 1 --p  0F8 1 --p }
328D: ~
328E: ~
328F: ~
3290: 0025 { 294 5 ---  298 5 ---  295 5 ---  299 5 --- }
3291: 0025 { 296 5 ---  29A 5 ---  297 5 ---  29B 5 --- }
3292: ~
3293: 0025 { 0F8 1 --p  0F8 1 --p  210 1 --p  220 1 --p }
3294: 0025 { 211 1 --p  221 1 --p  212 1 --p  222 1 --p }
3295: 0025 { 213 1 --p  223 1 --p  214 1 --p  224 1 --p }
3296: 0025 { 215 1 --p  225 1 --p  216 1 --p  226 1 --p }
3297: 0025 { 217 1 --p  227 1 --p  218 1 --p  228 1 --p }
3298: 0025 { 219 1 --p  229 1 --p  21A 1 --p  22A 1 --p }
3299: 0025 { 21B 1 --p  22B 1 --p  21C 1 --p  22C 1 --p }
329A: 0025 { 21D 1 --p  22D 1 --p  21E 1 --p  22E 1 --p }
329B: 0025 { 21F 1 --p  22F 1 --p  149 1 --p  12B 1 --p }
329C: 0025 { 0F8 1 --p  12D 1 --p  0F8 1 --p  0F8 1 --p }
329D: ~
329E: ~
329F: ~
32A0: 0025 { 27B 3 x--  04E 6 x--  27C 3 ---  04F 6 --- }
32A1: 0025 { 27C 3 ---  04F 6 ---  27C 3 ---  04F 6 x-- }
32A2: 0025 { 27C 3 ---  04F 6 x--  27B 3 ---  04E 6 x-- }
32A3: 0025 { 0F8 1 --p  0F8 1 --p  230 1 --p  240 1 --p }
32A4: 0025 { 231 1 --p  241 1 --p  232 1 --p  242 1 --p }
32A5: 0025 { 233 1 --p  243 1 --p  234 1 --p  244 1 --p }
32A6: 0025 { 235 1 --p  245 1 --p  236 1 --p  246 1 --p }
32A7: 0025 { 237 1 --p  247 1 --p  238 1 --p  248 1 --p }
32A8: 0025 { 239 1 --p  249 1 --p  23A 1 --p  24A 1 --p }
32A9: 0025 { 23B 1 --p  24B 1 --p  23C 1 --p  24C 1 --p }
32AA: 0025 { 23D 1 --p  24D 1 --p  23E 1 --p  24E 1 --p }
32AB: 0025 { 23F 1 --p  24F 1 --p  12A 1 --p  12F 1 --p }
32AC: 0025 { 12E 1 --p  15B 1 --p  0F8 1 --p  0F8 1 --p }
32AD: ~
32AE: ~
32AF: ~
32B0: 0025 { 27B 3 ---  27B 3 ---  27C 3 ---  27C 3 --- }
32B1: 0025 { 27C 3 ---  27C 3 ---  27C 3 ---  27C 3 --- }
32B2: 0025 { 294 3 ---  29E 3 ---  295 3 ---  29F 3 --- }
32B3: 0025 { 296 3 ---  2A0 3 ---  297 3 ---  2A1 3 --- }
32B4: 0025 { 298 3 ---  2A2 3 ---  299 3 ---  2A3 3 --- }
32B5: 0025 { 29A 3 ---  29A 3 ---  29B 3 ---  2A4 3 --- }
32B6: 0025 { 29B 3 x--  2A4 3 x--  29A 3 x--  29A 3 x-- }
32B7: 0025 { 299 3 x--  2A3 3 x--  298 3 x--  2A2 3 x-- }
32B8: 0025 { 101 4 ---  111 4 ---  102 4 ---  112 4 --- }
32B9: 0025 { 103 4 ---  113 4 ---  104 4 ---  114 4 --- }
32BA: 0025 { 105 4 ---  115 4 ---  106 4 ---  116 4 --- }
32BB: 0025 { 101 4 ---  101 4 ---  107 4 ---  117 4 --- }
32BC: 0025 { 10A 4 ---  11A 4 ---  10B 4 ---  11B 4 --- }
32BD: ~
32BE: ~
32BF: ~
32C0: 0025 { 27D 3 ---  280 3 ---  27E 3 ---  280 3 --- }
32C1: 0025 { 27F 3 ---  281 3 ---  27D 3 ---  280 3 --- }
32C2: 0025 { 29E 3 ---  29E 3 ---  2A5 3 ---  2AC 3 --- }
32C3: 0025 { 2A6 3 ---  2AD 3 ---  2A7 3 ---  2AE 3 --- }
32C4: 0025 { 2A8 3 ---  2A2 3 ---  2A9 3 ---  2A3 3 --- }
32C5: 0025 { 2AA 3 ---  29A 3 ---  2AB 3 ---  2A4 3 --- }
32C6: 0025 { 2AB 3 x--  2A4 3 x--  2AA 3 x--  29A 3 x-- }
32C7: 0025 { 2A9 3 x--  2A3 3 x--  2A8 3 x--  2A2 3 x-- }
32C8: 0025 { 10C 5 ---  11C 5 ---  10D 5 ---  11D 5 --- }
32C9: 0025 { 10E 5 ---  11E 5 ---  10F 5 ---  11F 5 --- }
32CA: 0025 { 12C 5 ---  13C 5 ---  12D 5 ---  13D 5 --- }
32CB: 0025 { 12E 5 ---  13E 5 ---  12F 5 ---  13F 5 --- }
32CC: 0025 { 108 5 ---  118 5 ---  109 5 ---  119 5 --- }
32CD: ~
32CE: ~
32CF: ~
32D0: 0025 { 2BD 3 --p  2C1 3 --p  2BE 3 --p  2C2 3 --p }
32D1: 0025 { 2BF 3 --p  2C3 3 --p  2C0 3 --p  2C4 3 --p }
32D2: 0025 { 2AF 3 ---  2B7 3 ---  2B0 3 ---  2B8 3 --- }
32D3: 0025 { 2B1 3 ---  2B9 3 ---  2B2 3 ---  2B7 3 --- }
32D4: 0025 { 2B3 3 ---  2BA 3 ---  2B4 3 ---  2BB 3 --- }
32D5: 0025 { 2B5 3 ---  2BC 3 ---  2B6 3 ---  2BA 3 x-- }
32D6: 0025 { 2B6 3 x--  2BA 3 ---  2B5 3 x--  2BC 3 x-- }
32D7: 0025 { 2B4 3 x--  2BB 3 x--  2B3 3 x--  2BA 3 x-- }
32D8: 0025 { 168 4 ---  178 4 ---  169 4 ---  179 4 --- }
32D9: 0025 { 16A 4 ---  17A 4 ---  16B 4 ---  17B 4 --- }
32DA: 0025 { 16C 4 ---  17B 4 ---  16D 4 ---  17D 4 --- }
32DB: 0025 { 146 6 ---  156 6 ---  146 6 x--  156 6 x-- }
32DC: 62F0 { 160 5 ---  170 5 ---  161 5 ---  171 5 --- }
32DD: ~
32DE: ~
32DF: ~
32E0: 0025 { 2C5 3 --p  2CA 3 --p  2C6 3 --p  2CB 3 --p }
32E1: 0025 { 2C7 3 --p  2CC 3 --p  2C8 3 --p  2CD 3 --p }
32E2: 0025 { 2BD 3 ---  2C1 3 ---  2BE 3 ---  2C2 3 --- }
32E3: 0025 { 2BF 3 ---  2C3 3 ---  2C0 3 ---  2C4 3 --- }
32E4: 0025 { 282 3 ---  283 3 ---  282 3 ---  284 3 --- }
32E5: 0025 { 282 3 ---  285 3 ---  282 3 ---  286 3 --- }
32E6: 0025 { 282 3 ---  283 3 ---  282 3 ---  284 3 --- }
32E7: 0025 { 282 3 ---  285 3 ---  282 3 ---  286 3 --- }
32E8: 0025 { 282 3 ---  283 3 ---  282 3 ---  284 3 --- }
32E9: 0025 { 282 3 ---  285 3 ---  282 3 ---  286 3 --- }
32EA: 0025 { 282 3 ---  283 3 ---  282 3 ---  284 3 --- }
32EB: 0025 { 282 3 ---  285 3 ---  282 3 ---  286 3 --- }
32EC: 0025 { 282 3 ---  283 3 ---  282 3 ---  284 3 --- }
32ED: 0025 { 282 3 ---  283 3 ---  282 3 ---  284 3 --- }
32EE: ~
32EF: ~
32F0: 0025 { 29C 3 ---  29C 3 ---  29D 3 ---  29D 3 --- }
32F1: 0205 { 08C 6 ---  09C 6 ---  08D 6 ---  09D 6 --- }
32F2: 0025 { 2C5 3 ---  2CA 3 ---  2C6 3 ---  2CB 3 --- }
32F3: 0025 { 2C7 3 ---  2CC 3 ---  2C8 3 ---  2CD 3 --- }
32F4: 0025 { 287 3 ---  28B 3 ---  288 3 ---  28C 3 --- }
32F5: 0025 { 289 3 ---  28D 3 ---  28A 3 ---  28D 3 --- }
32F6: 0025 { 287 3 ---  28D 3 ---  288 3 ---  28D 3 --- }
32F7: 0025 { 289 3 ---  28E 3 ---  28A 3 ---  28F 3 --- }
32F8: 0025 { 287 3 ---  290 3 ---  288 3 ---  291 3 --- }
32F9: 0025 { 289 3 ---  28B 3 ---  28A 3 ---  28C 3 --- }
32FA: 0025 { 287 3 ---  28D 3 ---  288 3 ---  28D 3 --- }
32FB: 0025 { 289 3 ---  28D 3 ---  28A 3 ---  28D 3 --- }
32FC: 0025 { 287 3 ---  28E 3 ---  288 3 ---  28F 3 --- }
32FD: 0025 { 287 3 ---  290 3 ---  288 3 ---  291 3 --- }
32FE: ~
32FF: ~
