0600: 0130 { 18B 2 x--  1AB 2 x--  180 2 x--  18A 2 x-- }
0601: 0130 { 180 2 ---  190 2 ---  181 2 ---  191 2 --- }
0602: 0130 { 180 2 ---  18A 2 ---  18B 2 ---  1AB 2 --- }
0603: 0106 { 183 2 ---  193 2 ---  181 2 ---  191 2 --- }
0604: 0106 { 180 2 ---  190 2 ---  181 2 ---  191 2 --- }
0605: 0106 { 180 2 ---  190 2 ---  182 2 ---  192 2 --- }
0606: 01AA { 0F8 2 x--  195 2 x--  184 2 x--  194 2 x-- }
0607: 01AF { 184 2 ---  194 2 ---  0F8 2 x--  195 2 --- }
0608: 0196 { 0F8 2 ---  189 2 x--  0F8 2 ---  188 2 x-- }
0609: 019B { 187 2 x--  197 2 x--  186 2 x--  196 2 x-- }
060A: 01A0 { 186 2 ---  196 2 ---  187 2 ---  197 2 --- }
060B: 01A5 { 0F8 2 x--  188 2 ---  0F8 2 x--  189 2 --- }
060C: 004A { 1E0 2 --p  1F0 2 --p  1E1 2 --p  1F1 2 --p }
060D: 004A { 1E1 2 x-p  1F1 2 x-p  1E0 2 x-p  1F0 2 x-p }
060E: 0139 { 000 5 --p  010 5 --p  001 5 --p  011 5 --p }
060F: 013A { 002 5 --p  012 5 --p  003 5 --p  013 5 --p }
0610: 0130 { 19B 2 x--  1AB 2 x--  19A 2 x--  1AA 2 x-- }
0611: 0130 { 1A0 2 ---  1B0 2 ---  1A1 2 ---  1B1 2 --- }
0612: 0130 { 19A 2 ---  1AA 2 ---  19B 2 ---  1AB 2 --- }
0613: 0025 { 1A3 2 ---  1B3 2 ---  1A1 2 ---  1B1 2 --- }
0614: 0025 { 1A0 2 ---  1B0 2 ---  1A1 2 ---  1B1 2 --- }
0615: 0025 { 1A0 2 ---  1B0 2 ---  1A2 2 ---  1B2 2 --- }
0616: 01E2 { 1A5 2 x--  185 2 x--  1A4 2 x--  1B1 2 --- }
0617: 01E4 { 1A4 2 ---  1B0 2 ---  1A5 2 ---  185 2 --- }
0618: 01DE { 199 2 x--  1A9 2 x--  198 2 x--  1A8 2 x-- }
0619: 0130 { 1A7 2 x--  1B1 2 x--  1A6 2 x--  1B0 2 x-- }
061A: 0130 { 1A6 2 ---  1B0 2 ---  1A7 2 ---  1B1 2 --- }
061B: 01E0 { 198 2 ---  1A8 2 ---  199 2 ---  1A9 2 --- }
061C: 004A { 1E2 2 --p  1F2 2 --p  1E3 2 --p  1F3 2 --p }
061D: 004A { 1E3 2 x-p  1F3 2 x-p  1E2 2 x-p  1F2 2 x-p }
061E: 0135 { 020 5 --p  020 5 --p  021 5 --p  021 5 --p }
061F: 0136 { 022 5 --p  022 5 --p  023 5 --p  023 5 --p }
0620: 0130 { 1AB 2 xy-  18B 2 xy-  18A 2 xy-  180 2 xy- }
0621: 0130 { 190 2 -y-  180 2 -y-  191 2 -y-  181 2 -y- }
0622: 0130 { 18A 2 -y-  180 2 -y-  1AB 2 -y-  18B 2 -y- }
0623: 0106 { 193 2 -y-  183 2 -y-  191 2 -y-  181 2 -y- }
0624: 0106 { 190 2 -y-  180 2 -y-  191 2 -y-  181 2 -y- }
0625: 0106 { 190 2 -y-  180 2 -y-  192 2 -y-  182 2 -y- }
0626: 0106 { 1CC 2 ---  19E 2 -y-  1CD 2 ---  19F 2 -y- }
0627: 0106 { 1CE 2 ---  19E 2 -y-  1CF 2 ---  19F 2 -y- }
0628: 0106 { 18C 2 ---  19E 2 -y-  18D 2 ---  19F 2 -y- }
0629: 0106 { 18E 2 ---  19E 2 -y-  18F 2 ---  19F 2 -y- }
062A: 004A { 1D4 2 ---  1E4 2 ---  1D5 2 ---  1E5 2 --- }
062B: 004A { 1D6 2 ---  1E6 2 ---  1D7 2 ---  1E7 2 --- }
062C: 0130 { 0F8 2 x-p  0F8 2 x-p  1B4 2 --p  1B4 2 --p }
062D: 0130 { 1B5 2 --p  1B5 2 --p  1B6 2 --p  1B6 2 --p }
062E: 0130 { 1B7 2 --p  1B7 2 --p  1B8 2 --p  1B8 2 --p }
062F: 0130 { 1B9 2 --p  1B9 2 --p  0F8 2 x-p  0F8 2 x-p }
0630: 0025 { 0F8 2 x--  0F8 2 x--  1B4 2 ---  1B4 2 --- }
0631: 0025 { 1B5 2 ---  1B5 2 ---  1B6 2 ---  1B6 2 --- }
0632: 0025 { 1B7 2 ---  1B7 2 ---  1B8 2 ---  1B8 2 --- }
0633: 0025 { 1B9 2 ---  1B9 2 ---  0F8 2 x--  0F8 2 x-- }
0634: 0106 { 1BA 2 ---  1B9 2 ---  1BB 2 ---  0F8 2 x-- }
0635: 0106 { 1BC 2 ---  0F8 2 x--  1BD 2 ---  0F8 2 x-- }
0636: 0106 { 1BE 2 ---  0F8 2 x--  1BF 2 ---  0F8 2 x-- }
0637: 0106 { 1CB 2 ---  1B9 2 ---  1BD 2 ---  0F8 2 x-- }
0638: 0106 { 1CA 2 ---  1B9 2 ---  1BF 2 ---  0F8 2 x-- }
0639: 0025 { 19C 2 ---  1AC 2 ---  19D 2 ---  1AD 2 --- }
063A: 0025 { 19C 2 ---  1AC 2 ---  0F8 2 x--  0F8 2 x-- }
063B: 0006 { 19E 2 ---  19E 2 -y-  19F 2 ---  19F 2 -y- }
063C: 0025 { 0F8 2 x-p  0F8 2 x-p  1B4 2 --p  1B4 2 --p }
063D: 0025 { 1B5 2 --p  1B5 2 --p  1B6 2 --p  1B6 2 --p }
063E: 0025 { 1B7 2 --p  1B7 2 --p  1B8 2 --p  1B8 2 --p }
063F: 0025 { 1B9 2 --p  1B9 2 --p  0F8 2 x-p  0F8 2 x-p }
0640: 0025 { 0F8 2 x--  0F8 2 x--  1B4 2 ---  1C4 2 --- }
0641: 0025 { 1B5 2 ---  1C5 2 ---  1B6 2 ---  1C6 2 --- }
0642: 0025 { 1B7 2 ---  1C7 2 ---  1B8 2 ---  1C8 2 --- }
0643: 0025 { 1B9 2 ---  1C9 2 ---  0F8 2 x--  0F8 2 x-- }
0644: 0106 { 1BF 2 x--  0F8 2 x--  1BE 2 x--  0F8 2 x-- }
0645: 0106 { 1BD 2 x--  0F8 2 x--  1BC 2 x--  0F8 2 x-- }
0646: 0106 { 1BB 2 x--  0F8 2 x--  1BA 2 x--  1B4 2 --- }
0647: 0106 { 1BD 2 x--  0F8 2 x--  1CB 2 x--  1B4 2 --- }
0648: 0106 { 1BF 2 x--  0F8 2 x--  1CA 2 x--  1B4 2 --- }
0649: 0025 { 0F8 2 x-p  0F8 2 x-p  19C 2 --p  1AC 2 --p }
064A: 0025 { 19D 2 --p  1AD 2 --p  19C 2 --p  1AC 2 --p }
064B: 0006 { 19E 2 ---  1AE 2 ---  19F 2 ---  1AF 2 --- }
064C: 0025 { 0F8 2 x-p  0F8 2 x-p  1B4 2 --p  1C4 2 --p }
064D: 0025 { 1B5 2 --p  1C5 2 --p  1B6 2 --p  1C6 2 --p }
064E: 0025 { 1B7 2 --p  1C7 2 --p  1B8 2 --p  1C8 2 --p }
064F: 0025 { 1B9 2 --p  1C9 2 --p  0F8 2 x-p  0F8 2 x-p }
0650: ~
0651: 0106 { 1BF 2 x-p  0F8 2 x-p  1BE 2 x-p  0F8 2 x-p }
0652: 0106 { 1BD 2 x-p  0F8 2 x-p  1BC 2 x-p  0F8 2 x-p }
0653: 0106 { 1BB 2 x-p  0F8 2 x-p  1BA 2 x-p  1B4 2 --p }
0654: 0205 { 0F8 2 x--  0D7 7 ---  087 7 ---  0D0 7 --- }
0655: 0205 { 082 7 ---  092 7 ---  082 7 ---  093 7 --- }
0656: 0205 { 087 7 x--  0D0 7 x--  0F8 2 x--  0D7 7 x-- }
0657: 0025 { 0F8 2 x--  0C5 7 ---  0F8 2 x--  0C5 7 x-- }
0658: 0025 { 0AC 6 ---  0BC 6 ---  0AD 6 ---  0BD 6 --- }
0659: 0125 { 1D8 6 ---  1E8 6 ---  1D9 6 ---  1E9 6 --- }
065A: 0130 { 185 2 xy-  1A5 2 xy-  1B1 2 -y-  1A4 2 xy- }
065B: 0130 { 1B0 2 -y-  1A4 2 -y-  185 2 -y-  1A5 2 -y- }
065C: 0130 { 180 2 --p  190 2 --p  181 2 --p  191 2 --p }
065D: 01AA { 195 2 xy-  0F8 2 xy-  194 2 xy-  184 2 xy- }
065E: 01AF { 194 2 -y-  184 2 -y-  195 2 -y-  0F8 2 xy- }
065F: 0106 { 1CA 2 --p  1B9 2 --p  1BF 2 --p  0F8 2 x-p }
0660: ~
0661: ~
0662: ~
0663: ~
0664: 0205 { 0D7 7 ---  0F8 2 x--  0D0 7 -y-  087 7 -y- }
0665: 0205 { 092 7 -y-  082 7 -y-  093 7 -y-  082 7 -y- }
0666: 0205 { 0D0 7 xy-  087 7 xy-  0D7 7 x--  0F8 2 x-- }
0667: 0025 { 0C5 7 -y-  0F8 2 x--  0C5 7 xy-  0F8 2 x-- }
0668: ~
0669: ~
066A: ~
066B: ~
066C: ~
066D: ~
066E: ~
066F: ~
0670: ~
0671: ~
0672: ~
0673: ~
0674: ~
0675: ~
0676: 01BA { 004 4 ---  004 4 ---  004 4 ---  004 4 --- }
0677: ~
0678: ~
0679: ~
067A: ~
067B: ~
067C: ~
067D: ~
067E: ~
067F: ~
0680: ~
0681: ~
0682: ~
0683: ~
0684: ~
0685: ~
0686: ~
0687: 0025 { 004 4 ---  004 4 ---  004 4 ---  004 4 --- }
0688: ~
0689: ~
068A: ~
068B: ~
068C: ~
068D: ~
068E: ~
068F: ~
0690: ~
0691: ~
0692: ~
0693: ~
0694: ~
0695: ~
0696: 0205 { 004 4 ---  004 4 ---  004 4 ---  004 4 --- }
0697: 0205 { 004 4 ---  004 4 ---  004 4 ---  004 4 --- }
0698: 0205 { 004 4 ---  004 4 ---  004 4 ---  004 4 --- }
0699: ~
069A: ~
069B: ~
069C: ~
069D: ~
069E: ~
069F: ~
06A0: ~
06A1: ~
06A2: ~
06A3: ~
06A4: ~
06A5: ~
06A6: ~
06A7: ~
06A8: ~
06A9: ~
06AA: ~
06AB: ~
06AC: ~
06AD: ~
06AE: ~
06AF: ~
06B0: ~
06B1: ~
06B2: ~
06B3: ~
06B4: ~
06B5: ~
06B6: ~
06B7: ~
06B8: ~
06B9: ~
06BA: ~
06BB: ~
06BC: ~
06BD: ~
06BE: ~
06BF: ~
06C0: ~
06C1: ~
06C2: ~
06C3: ~
06C4: ~
06C5: ~
06C6: ~
06C7: ~
06C8: ~
06C9: ~
06CA: ~
06CB: ~
06CC: ~
06CD: ~
06CE: ~
06CF: ~
06D0: ~
06D1: ~
06D2: ~
06D3: ~
06D4: ~
06D5: ~
06D6: ~
06D7: ~
06D8: ~
06D9: ~
06DA: ~
06DB: ~
06DC: ~
06DD: ~
06DE: ~
06DF: ~
06E0: ~
06E1: ~
06E2: ~
06E3: ~
06E4: ~
06E5: ~
06E6: ~
06E7: ~
06E8: ~
06E9: ~
06EA: ~
06EB: ~
06EC: ~
06ED: ~
06EE: ~
06EF: ~
06F0: ~
06F1: ~
06F2: ~
06F3: ~
06F4: ~
06F5: ~
06F6: ~
06F7: ~
06F8: ~
06F9: ~
06FA: ~
06FB: ~
06FC: ~
06FD: ~
06FE: ~
06FF: ~
