1F00: 0130 { 180 2 ---  187 2 ---  180 2 ---  187 2 --- }
1F01: 0130 { 180 2 ---  187 2 ---  181 2 ---  188 2 --- }
1F02: 0130 { 182 2 ---  189 2 ---  183 2 ---  18A 2 --- }
1F03: 0130 { 184 2 ---  18B 2 ---  181 2 ---  188 2 --- }
1F04: 0130 { 182 2 ---  189 2 ---  185 2 ---  18C 2 --- }
1F05: 0130 { 186 2 x--  18D 2 x--  182 2 x--  189 2 x-- }
1F06: 0130 { 18E 2 ---  194 2 ---  18E 2 ---  194 2 --- }
1F07: 0130 { 193 2 x--  199 2 x--  190 2 x--  196 2 x-- }
1F08: 0130 { 190 2 ---  196 2 ---  191 2 ---  197 2 --- }
1F09: 0130 { 192 2 ---  198 2 ---  18F 2 ---  195 2 --- }
1F0A: 0130 { 190 2 ---  196 2 ---  193 2 ---  199 2 --- }
1F0B: 0039 { 0A0 3 ---  0A2 3 ---  0A1 3 ---  0A3 3 --- }
1F0C: 003A { 0A2 3 ---  0A2 3 ---  0A3 3 ---  0A3 3 --- }
1F0D: 003C { 0A0 3 --p  0A2 3 --p  0A1 3 --p  0A3 3 --p }
1F0E: 003D { 0A2 3 --p  0A2 3 --p  0A3 3 --p  0A3 3 --p }
1F0F: 003D { 08B 3 xy-  08B 3 x--  08B 3 xy-  08B 3 x-- }
1F10: 0025 { 283 4 ---  23F 2 x--  2A4 4 ---  23E 2 x-- }
1F11: 0025 { 2AC 4 ---  23D 2 x--  2AE 4 ---  23C 2 x-- }
1F12: 0025 { 2BE 4 ---  0F8 2 x--  0F8 2 x--  0F8 2 x-- }
1F13: 0130 { 04A 3 --p  0FB 3 --p  04B 3 --p  0FB 3 --p }
1F14: 0130 { 0F8 4 ---  0F8 4 ---  0F8 4 ---  0F8 4 --- }
1F15: 0025 { 0F9 1 --p  0F9 1 --p  0F9 1 --p  0F9 1 --p }
1F16: 0130 { 0F9 1 --p  0F9 1 --p  0F9 1 --p  0F9 1 --p }
1F17: 020C { 0F9 7 --p  0F9 7 --p  0F9 7 --p  0F9 7 --p }
1F18: 0025 { 0F8 4 ---  0F8 4 ---  0F8 4 ---  0F8 4 --- }
1F19: 0ED0 { 0F8 5 ---  0F8 5 ---  0F8 5 ---  0F8 5 --- }
1F1A: 0ED1 { 0F8 5 ---  0F8 5 ---  0F8 5 x--  0F8 5 x-- }
1F1B: 0025 { 0F8 4 ---  0F8 4 ---  0F8 4 ---  0F8 4 --- }
1F1C: 1F1B { 0F8 4 ---  0F8 4 ---  0F8 4 ---  0F8 4 --- }
1F1D: 1F1B { 0F8 4 ---  0F8 4 ---  0F8 4 ---  0F8 4 --- }
1F1E: 1F1B { 0F8 4 ---  0F8 4 ---  0F8 4 ---  0F8 4 --- }
1F1F: 1F1B { 0F8 4 ---  0F8 4 ---  0F8 4 ---  0F8 4 --- }
1F20: 0025 { 24F 2 x--  25F 2 x--  24E 2 x--  25E 2 x-- }
1F21: 0025 { 24D 2 x--  25D 2 x--  24C 2 x--  25C 2 x-- }
1F22: 0025 { 0F8 4 ---  285 4 ---  293 4 ---  2AE 4 --- }
1F23: 0025 { 2A7 4 ---  2B1 4 ---  2A0 4 ---  0F8 4 --- }
1F24: 0025 { 2AD 4 ---  28F 4 ---  2AA 4 ---  2AB 4 --- }
1F25: 0025 { 2B2 4 ---  2A0 4 ---  0F8 4 ---  2B8 4 --- }
1F26: ~
1F27: ~
1F28: ~
1F29: ~
1F2A: ~
1F2B: ~
1F2C: ~
1F2D: ~
1F2E: ~
1F2F: ~
1F30: 0025 { 26F 2 x--  27F 2 x--  26E 2 x--  27E 2 x-- }
1F31: 0025 { 26D 2 x--  27D 2 x--  26C 2 x--  27C 2 x-- }
1F32: 0025 { 0F8 4 ---  293 4 ---  287 4 ---  2A7 4 --- }
1F33: 0025 { 2A4 4 ---  2A4 4 ---  2B8 4 ---  2B1 4 --- }
1F34: 0025 { 0F8 4 ---  2A4 4 ---  0F8 4 ---  0F8 4 --- }
1F35: 0025 { 08E 4 ---  09E 4 ---  08F 4 ---  09F 4 --- }
1F36: 0025 { 0BE 5 ---  0F6 5 ---  0D7 5 ---  0F7 5 --- }
1F37: ~
1F38: ~
1F39: 0130 { 0F8 4 ---  0F8 4 ---  0F8 4 ---  0F8 4 --- }
1F3A: ~
1F3B: ~
1F3C: ~
1F3D: ~
1F3E: ~
1F3F: ~
1F40: 0025 { 004 4 ---  004 4 ---  004 4 ---  004 4 --- }
1F41: 0025 { 004 4 ---  004 4 ---  004 4 ---  004 4 --- }
1F42: 0025 { 004 4 ---  004 4 ---  004 4 ---  004 4 --- }
1F43: ~
1F44: ~
1F45: ~
1F46: ~
1F47: ~
1F48: ~
1F49: ~
1F4A: ~
1F4B: ~
1F4C: ~
1F4D: ~
1F4E: ~
1F4F: ~
1F50: 0130 { 182 2 ---  182 2 -y-  183 2 ---  183 2 -y- }
1F51: ~
1F52: 0130 { 180 2 ---  180 2 -y-  183 2 ---  182 2 xy- }
1F53: 0130 { 182 2 ---  183 2 xy-  180 2 x--  180 2 xy- }
1F54: ~
1F55: ~
1F56: ~
1F57: ~
1F58: ~
1F59: ~
1F5A: ~
1F5B: ~
1F5C: ~
1F5D: ~
1F5E: ~
1F5F: ~
1F60: 0025 { 100 2 ---  110 2 ---  0F8 2 ---  0F8 2 --- }
1F61: 0025 { 101 2 ---  111 2 ---  0F8 2 ---  0F8 2 --- }
1F62: 0025 { 102 2 ---  112 2 ---  0F8 2 ---  0F8 2 --- }
1F63: 0025 { 103 2 ---  111 2 ---  0F8 2 ---  0F8 2 --- }
1F64: 0025 { 104 2 ---  114 2 ---  0F8 2 ---  0F8 2 --- }
1F65: 0025 { 104 2 ---  115 2 ---  0F8 2 ---  0F8 2 --- }
1F66: 0025 { 106 2 ---  116 2 ---  0F8 2 ---  0F8 2 --- }
1F67: 0025 { 107 2 ---  117 2 ---  0F8 2 ---  0F8 2 --- }
1F68: 0025 { 108 2 ---  118 2 ---  0F8 2 ---  0F8 2 --- }
1F69: 0025 { 109 2 ---  116 2 ---  0F8 2 ---  0F8 2 --- }
1F6A: 0025 { 10A 2 ---  11A 2 ---  0F8 2 ---  0F8 2 --- }
1F6B: 0025 { 10B 2 ---  11B 2 ---  0F8 2 ---  0F8 2 --- }
1F6C: 0025 { 10C 2 ---  11C 2 ---  0F8 2 ---  0F8 2 --- }
1F6D: 0025 { 10D 2 ---  11D 2 ---  0F8 2 ---  0F8 2 --- }
1F6E: 0025 { 10E 2 ---  116 2 ---  0F8 2 ---  0F8 2 --- }
1F6F: 0025 { 10F 2 ---  115 2 ---  0F8 2 ---  0F8 2 --- }
1F70: 0025 { 10E 2 ---  130 2 ---  0F8 2 ---  0F8 2 --- }
1F71: 0025 { 121 2 ---  131 2 ---  0F8 2 ---  0F8 2 --- }
1F72: 0025 { 122 2 ---  132 2 ---  0F8 2 ---  0F8 2 --- }
1F73: 0025 { 108 2 ---  133 2 ---  0F8 2 ---  0F8 2 --- }
1F74: 0025 { 124 2 ---  134 2 ---  0F8 2 ---  0F8 2 --- }
1F75: 0025 { 125 2 ---  135 2 ---  0F8 2 ---  0F8 2 --- }
1F76: 0025 { 126 2 ---  136 2 ---  0F8 2 ---  0F8 2 --- }
1F77: 0025 { 127 2 ---  137 2 ---  0F8 2 ---  0F8 2 --- }
1F78: 0025 { 128 2 ---  133 2 ---  0F8 2 ---  0F8 2 --- }
1F79: 0025 { 129 2 ---  139 2 ---  0F8 2 ---  0F8 2 --- }
1F7A: 0025 { 12A 2 ---  13A 2 ---  0F8 2 ---  0F8 2 --- }
1F7B: 0025 { 12C 2 ---  0F8 2 ---  0F8 2 ---  0F8 2 --- }
1F7C: 0025 { 0F8 2 ---  113 2 ---  0F8 2 ---  0F8 2 --- }
1F7D: 0025 { 0F8 2 ---  105 2 ---  0F8 2 ---  0F8 2 --- }
1F7E: 0025 { 105 2 ---  0F8 2 ---  0F8 2 ---  0F8 2 --- }
1F7F: 0025 { 11E 2 ---  113 2 ---  0F8 2 ---  0F8 2 --- }
1F80: 0025 { 0F8 2 ---  0F8 2 ---  100 2 ---  110 2 --- }
1F81: 0025 { 0F8 2 ---  0F8 2 ---  101 2 ---  111 2 --- }
1F82: 0025 { 0F8 2 ---  0F8 2 ---  102 2 ---  112 2 --- }
1F83: 0025 { 0F8 2 ---  0F8 2 ---  103 2 ---  111 2 --- }
1F84: 0025 { 0F8 2 ---  0F8 2 ---  104 2 ---  114 2 --- }
1F85: 0025 { 0F8 2 ---  0F8 2 ---  104 2 ---  115 2 --- }
1F86: 0025 { 0F8 2 ---  0F8 2 ---  106 2 ---  116 2 --- }
1F87: 0025 { 0F8 2 ---  0F8 2 ---  107 2 ---  117 2 --- }
1F88: 0025 { 0F8 2 ---  0F8 2 ---  108 2 ---  118 2 --- }
1F89: 0025 { 0F8 2 ---  0F8 2 ---  109 2 ---  116 2 --- }
1F8A: 0025 { 0F8 2 ---  0F8 2 ---  10A 2 ---  11A 2 --- }
1F8B: 0025 { 0F8 2 ---  0F8 2 ---  10B 2 ---  11B 2 --- }
1F8C: 0025 { 0F8 2 ---  0F8 2 ---  10C 2 ---  11C 2 --- }
1F8D: 0025 { 0F8 2 ---  0F8 2 ---  10D 2 ---  11D 2 --- }
1F8E: 0025 { 0F8 2 ---  0F8 2 ---  10E 2 ---  116 2 --- }
1F8F: 0025 { 0F8 2 ---  0F8 2 ---  10F 2 ---  115 2 --- }
1F90: 0025 { 0F8 2 ---  0F8 2 ---  10E 2 ---  130 2 --- }
1F91: 0025 { 0F8 2 ---  0F8 2 ---  121 2 ---  131 2 --- }
1F92: 0025 { 0F8 2 ---  0F8 2 ---  122 2 ---  132 2 --- }
1F93: 0025 { 0F8 2 ---  0F8 2 ---  108 2 ---  133 2 --- }
1F94: 0025 { 0F8 2 ---  0F8 2 ---  124 2 ---  134 2 --- }
1F95: 0025 { 0F8 2 ---  0F8 2 ---  125 2 ---  135 2 --- }
1F96: 0025 { 0F8 2 ---  0F8 2 ---  126 2 ---  136 2 --- }
1F97: 0025 { 0F8 2 ---  0F8 2 ---  127 2 ---  137 2 --- }
1F98: 0025 { 0F8 2 ---  0F8 2 ---  128 2 ---  133 2 --- }
1F99: 0025 { 0F8 2 ---  0F8 2 ---  129 2 ---  139 2 --- }
1F9A: 0025 { 0F8 2 ---  0F8 2 ---  12A 2 ---  13A 2 --- }
1F9B: 0025 { 0F8 2 ---  0F8 2 ---  12C 2 ---  0F8 2 --- }
1F9C: 0025 { 0F8 2 ---  0F8 2 ---  0F8 2 ---  113 2 --- }
1F9D: 0025 { 0F8 2 ---  0F8 2 ---  0F8 2 ---  105 2 --- }
1F9E: 0025 { 0F8 2 ---  0F8 2 ---  105 2 ---  0F8 2 --- }
1F9F: 0025 { 0F8 2 ---  0F8 2 ---  11E 2 ---  113 2 --- }
1FA0: 0025 { 140 2 ---  150 2 ---  0F8 2 ---  0F8 2 --- }
1FA1: 0025 { 141 2 ---  111 2 ---  0F8 2 ---  0F8 2 --- }
1FA2: 0025 { 112 2 -y-  112 2 ---  0F8 2 ---  0F8 2 --- }
1FA3: 0025 { 158 2 ---  151 2 x--  0F8 2 ---  0F8 2 --- }
1FA4: 0025 { 142 2 ---  152 2 ---  0F8 2 ---  0F8 2 --- }
1FA5: 0025 { 143 2 ---  153 2 ---  0F8 2 ---  0F8 2 --- }
1FA6: 0025 { 151 2 xy-  154 2 ---  0F8 2 ---  0F8 2 --- }
1FA7: 0025 { 141 2 ---  117 2 ---  0F8 2 ---  0F8 2 --- }
1FA8: 0025 { 144 2 ---  133 2 ---  0F8 2 ---  0F8 2 --- }
1FA9: 0025 { 145 2 ---  155 2 ---  0F8 2 ---  0F8 2 --- }
1FAA: 0025 { 146 2 ---  156 2 ---  0F8 2 ---  0F8 2 --- }
1FAB: 0025 { 123 2 ---  133 2 ---  0F8 2 ---  0F8 2 --- }
1FAC: 0025 { 147 2 ---  11C 2 ---  0F8 2 ---  0F8 2 --- }
1FAD: 0025 { 148 2 ---  117 2 ---  0F8 2 ---  0F8 2 --- }
1FAE: 0025 { 116 2 -y-  116 2 ---  0F8 2 ---  0F8 2 --- }
1FAF: 0025 { 111 2 -y-  141 2 -y-  0F8 2 ---  0F8 2 --- }
1FB0: 0025 { 151 2 xy-  158 2 -y-  0F8 2 ---  0F8 2 --- }
1FB1: 0025 { 149 2 ---  115 2 ---  0F8 2 ---  0F8 2 --- }
1FB2: 0025 { 14A 2 ---  15A 2 ---  0F8 2 ---  0F8 2 --- }
1FB3: 0025 { 14B 2 ---  133 2 ---  0F8 2 ---  0F8 2 --- }
1FB4: 0025 { 117 2 -y-  140 2 -y-  0F8 2 ---  0F8 2 --- }
1FB5: 0025 { 14C 2 ---  135 2 ---  0F8 2 ---  0F8 2 --- }
1FB6: 0025 { 11C 2 -y-  147 2 -y-  0F8 2 ---  0F8 2 --- }
1FB7: 0025 { 14E 2 ---  15E 2 ---  0F8 2 ---  0F8 2 --- }
1FB8: 0025 { 117 2 -y-  154 2 ---  0F8 2 ---  0F8 2 --- }
1FB9: 0025 { 14F 2 ---  15F 2 ---  0F8 2 ---  0F8 2 --- }
1FBA: 0025 { 0F8 2 ---  0F8 2 ---  0F8 2 ---  0F8 2 --- }
1FBB: 0025 { 0F8 2 ---  0F8 2 ---  0F8 2 ---  0F8 2 --- }
1FBC: 0025 { 0F8 2 ---  0F8 2 ---  0F8 2 ---  0F8 2 --- }
1FBD: 0025 { 113 2 -y-  105 2 ---  0F8 2 ---  0F8 2 --- }
1FBE: 0025 { 113 2 -y-  113 2 ---  0F8 2 ---  0F8 2 --- }
1FBF: 0025 { 119 2 ---  113 2 ---  0F8 2 ---  0F8 2 --- }
1FC0: 0025 { 0F8 2 ---  0F8 2 ---  140 2 ---  150 2 --- }
1FC1: 0025 { 0F8 2 ---  0F8 2 ---  141 2 ---  111 2 --- }
1FC2: 0025 { 0F8 2 ---  0F8 2 ---  112 2 -y-  112 2 --- }
1FC3: 0025 { 0F8 2 -y-  0F8 2 -y-  158 2 ---  151 2 x-- }
1FC4: 0025 { 0F8 2 ---  0F8 2 ---  142 2 ---  152 2 --- }
1FC5: 0025 { 0F8 2 ---  0F8 2 ---  143 2 ---  153 2 --- }
1FC6: 0025 { 0F8 2 ---  0F8 2 ---  151 2 xy-  154 2 --- }
1FC7: 0025 { 0F8 2 ---  0F8 2 ---  141 2 ---  117 2 --- }
1FC8: 0025 { 0F8 2 ---  0F8 2 ---  144 2 ---  133 2 --- }
1FC9: 0025 { 0F8 2 ---  0F8 2 ---  145 2 ---  155 2 --- }
1FCA: 0025 { 0F8 2 ---  0F8 2 ---  146 2 ---  156 2 --- }
1FCB: 0025 { 0F8 2 ---  0F8 2 ---  123 2 ---  133 2 --- }
1FCC: 0025 { 0F8 2 ---  0F8 2 ---  147 2 ---  11C 2 --- }
1FCD: 0025 { 0F8 2 ---  0F8 2 ---  148 2 ---  117 2 --- }
1FCE: 0025 { 0F8 2 ---  0F8 2 ---  116 2 -y-  116 2 --- }
1FCF: 0025 { 0F8 2 ---  0F8 2 ---  111 2 -y-  141 2 -y- }
1FD0: 0025 { 0F8 2 ---  0F8 2 ---  151 2 xy-  158 2 -y- }
1FD1: 0025 { 0F8 2 ---  0F8 2 ---  149 2 ---  115 2 --- }
1FD2: 0025 { 0F8 2 ---  0F8 2 ---  14A 2 ---  15A 2 --- }
1FD3: 0025 { 0F8 2 ---  0F8 2 ---  14B 2 ---  133 2 --- }
1FD4: 0025 { 0F8 2 ---  0F8 2 ---  117 2 -y-  140 2 -y- }
1FD5: 0025 { 0F8 2 ---  0F8 2 ---  14C 2 ---  135 2 --- }
1FD6: 0025 { 0F8 2 ---  0F8 2 ---  11C 2 -y-  147 2 -y- }
1FD7: 0025 { 0F8 2 ---  0F8 2 ---  14E 2 ---  15E 2 --- }
1FD8: 0025 { 0F8 2 ---  0F8 2 ---  117 2 -y-  154 2 --- }
1FD9: 0025 { 0F8 2 ---  0F8 2 ---  14F 2 ---  15F 2 --- }
1FDA: 0025 { 0F8 2 ---  0F8 2 ---  0F8 2 ---  0F8 2 --- }
1FDB: 0025 { 0F8 2 ---  0DA 2 ---  0F8 2 ---  0DB 2 --- }
1FDC: 0025 { 0F8 2 ---  0DC 2 ---  0F8 2 ---  0DD 2 --- }
1FDD: 0025 { 0F8 2 ---  0F8 2 ---  113 2 -y-  105 2 --- }
1FDE: 0025 { 0F8 2 ---  0F8 2 ---  113 2 -y-  113 2 --- }
1FDF: 0025 { 0F8 2 ---  0F8 2 ---  119 2 ---  113 2 --- }
1FE0: 0025 { 160 2 ---  133 2 ---  0F8 2 ---  0F8 2 --- }
1FE1: 0025 { 161 2 ---  171 2 ---  0F8 2 ---  0F8 2 --- }
1FE2: 0025 { 162 2 ---  172 2 ---  0F8 2 ---  0F8 2 --- }
1FE3: 0025 { 163 2 ---  173 2 ---  0F8 2 ---  0F8 2 --- }
1FE4: 0025 { 164 2 ---  174 2 ---  0F8 2 ---  0F8 2 --- }
1FE5: 0025 { 165 2 ---  116 2 ---  0F8 2 ---  0F8 2 --- }
1FE6: 0025 { 166 2 ---  133 2 ---  0F8 2 ---  0F8 2 --- }
1FE7: 0025 { 167 2 ---  116 2 ---  0F8 2 ---  0F8 2 --- }
1FE8: 0025 { 168 2 ---  173 2 ---  0F8 2 ---  0F8 2 --- }
1FE9: 0025 { 169 2 ---  116 2 ---  0F8 2 ---  0F8 2 --- }
1FEA: 0025 { 004 4 ---  004 4 ---  004 4 ---  004 4 --- }
1FEB: 0025 { 085 2 ---  095 2 ---  086 2 ---  096 2 --- }
1FEC: 0025 { 085 2 ---  095 2 ---  086 2 ---  096 2 --- }
1FED: 0130 { 0A0 4 ---  0A2 4 ---  0A1 4 ---  0A3 4 --- }
1FEE: 0025 { 093 5 -y-  01E 7 -y-  0D5 7 -y-  01F 7 -y- }
1FEF: 0025 { 0F8 7 -y-  09C 7 -y-  094 5 -y-  0F8 7 -y- }
1FF0: 0025 { 0F8 2 ---  0F8 2 ---  160 2 ---  133 2 --- }
1FF1: 0025 { 0F8 2 ---  0F8 2 ---  161 2 ---  171 2 --- }
1FF2: 0025 { 0F8 2 ---  0F8 2 ---  162 2 ---  172 2 --- }
1FF3: 0025 { 0F8 2 ---  0F8 2 ---  163 2 ---  173 2 --- }
1FF4: 0025 { 0F8 2 ---  0F8 2 ---  164 2 ---  174 2 --- }
1FF5: 0025 { 0F8 2 ---  0F8 2 ---  165 2 ---  116 2 --- }
1FF6: 0025 { 0F8 2 ---  0F8 2 ---  166 2 ---  133 2 --- }
1FF7: 0025 { 0F8 2 ---  0F8 2 ---  167 2 ---  116 2 --- }
1FF8: 0025 { 0F8 2 ---  0F8 2 ---  168 2 ---  173 2 --- }
1FF9: 0025 { 0F8 2 ---  0F8 2 ---  169 2 ---  116 2 --- }
1FFA: 0025 { 004 4 ---  004 4 ---  004 4 ---  004 4 --- }
1FFB: 0025 { 095 2 ---  095 2 ---  096 2 ---  096 2 --- }
1FFC: 0025 { 095 2 ---  095 2 ---  096 2 ---  096 2 --- }
1FFD: 0130 { 0A2 4 ---  0A2 4 ---  0A3 4 ---  0A3 4 --- }
1FFE: 0025 { 00E 7 -y-  0F8 7 -y-  00F 7 -y-  0F8 7 -y- }
1FFF: 0025 { 08C 7 -y-  0F8 7 -y-  0F8 7 -y-  0F8 7 -y- }
