7800: 0130 { 100 1 ---  10B 1 ---  101 1 ---  10C 1 --- }
7801: 0130 { 101 1 ---  10D 1 ---  101 1 ---  10E 2 --- }
7802: 0130 { 102 1 ---  10F 2 ---  103 1 ---  110 2 --- }
7803: 0130 { 104 1 ---  111 0 ---  101 1 ---  112 0 --- }
7804: 0130 { 101 1 ---  113 0 ---  101 1 ---  114 0 --- }
7805: 0130 { 105 1 ---  115 0 ---  106 1 ---  116 1 --- }
7806: 0130 { 101 1 ---  117 1 ---  101 1 ---  118 1 --- }
7807: 0130 { 101 1 ---  119 0 ---  101 1 ---  11A 0 --- }
7808: 0130 { 101 1 ---  11A 0 ---  105 1 ---  11B 0 --- }
7809: 0130 { 106 1 ---  116 1 ---  101 1 ---  11C 0 --- }
780A: 0130 { 101 1 ---  11D 0 ---  101 1 ---  11E 1 --- }
780B: 0130 { 101 1 ---  11F 2 ---  107 1 ---  120 2 --- }
780C: 0130 { 108 1 ---  121 1 ---  101 1 ---  122 1 --- }
780D: 0130 { 101 1 ---  123 1 ---  101 1 ---  124 1 --- }
780E: 0130 { 109 1 ---  125 1 ---  10A 1 ---  126 1 --- }
780F: 0130 { 28F 4 ---  28F 7 xyp  28F 7 xyp  28F 4 --- }
7810: 0130 { 127 1 ---  143 0 ---  128 1 ---  144 0 --- }
7811: 0130 { 129 1 ---  145 0 ---  12A 2 ---  146 0 --- }
7812: 0130 { 12B 2 ---  147 1 ---  12C 1 ---  148 1 --- }
7813: 0130 { 12D 3 ---  149 2 ---  12E 3 ---  14A 2 --- }
7814: 0130 { 12F 0 ---  14B 2 ---  130 3 ---  14C 3 --- }
7815: 0130 { 131 3 ---  14D 3 ---  132 1 ---  14E 1 --- }
7816: 0130 { 133 1 ---  14F 1 ---  134 1 ---  150 1 --- }
7817: 0130 { 135 3 ---  151 3 ---  136 3 ---  152 0 --- }
7818: 0130 { 136 3 ---  152 0 ---  137 3 ---  153 3 --- }
7819: 0130 { 132 1 ---  14E 1 ---  138 3 ---  154 3 --- }
781A: 0130 { 139 3 ---  155 3 ---  13A 1 ---  156 1 --- }
781B: 0130 { 13B 3 ---  157 2 ---  13C 3 ---  158 3 --- }
781C: 0130 { 13D 1 ---  159 1 ---  13E 1 ---  15A 1 --- }
781D: 0130 { 13F 1 ---  15B 1 ---  140 1 ---  15C 1 --- }
781E: 0130 { 141 1 ---  15D 1 ---  142 1 ---  15E 1 --- }
781F: 020C { 0F8 0 ---  0F8 0 ---  0F8 0 ---  0F8 0 --- }
7820: 0130 { 15F 1 ---  17B 1 ---  160 1 ---  17C 1 --- }
7821: 0130 { 161 3 ---  17D 3 ---  162 3 ---  17E 3 --- }
7822: 0130 { 163 3 ---  17F 3 ---  164 2 ---  180 2 --- }
7823: 0130 { 165 2 ---  181 2 ---  166 2 ---  182 2 --- }
7824: 0130 { 167 2 ---  183 2 ---  168 1 ---  184 1 --- }
7825: 0130 { 169 1 ---  185 1 ---  16A 1 ---  186 1 --- }
7826: 0130 { 16B 1 ---  187 1 ---  16C 1 ---  188 1 --- }
7827: 0130 { 16D 3 ---  189 2 ---  16E 3 ---  18A 3 --- }
7828: 0130 { 16E 3 ---  18A 3 ---  16F 3 ---  18B 2 --- }
7829: 0130 { 16A 1 ---  186 1 ---  170 3 ---  18C 1 --- }
782A: 0130 { 171 3 ---  18D 1 ---  172 1 ---  18E 1 --- }
782B: 0130 { 173 2 ---  18F 2 ---  174 3 ---  190 2 --- }
782C: 0130 { 175 1 ---  191 1 ---  176 1 ---  192 1 --- }
782D: 0130 { 177 1 ---  193 1 ---  178 1 ---  194 1 --- }
782E: 0130 { 179 1 ---  195 1 ---  17A 1 ---  196 1 --- }
782F: 0130 { 004 4 ---  3FF 7 xyp  3FF 7 xyp  004 4 --- }
7830: 0130 { 100 1 ---  117 0 ---  101 1 ---  118 1 --- }
7831: 0130 { 102 0 ---  119 0 ---  103 0 ---  11A 0 --- }
7832: 0130 { 104 3 ---  11B 0 ---  105 2 ---  11C 3 --- }
7833: 0130 { 106 0 ---  11D 2 ---  107 0 ---  11E 0 --- }
7834: 0130 { 108 1 ---  11F 1 ---  109 2 ---  120 0 --- }
7835: 0130 { 10A 2 ---  121 2 ---  10A 2 ---  121 2 --- }
7836: 0130 { 10A 2 ---  121 2 ---  10B 2 ---  122 2 --- }
7837: 0130 { 10C 1 ---  123 1 ---  10D 1 ---  124 1 --- }
7838: 0130 { 10E 1 ---  125 1 ---  10F 1 ---  126 1 --- }
7839: 0130 { 110 2 ---  127 2 ---  111 2 ---  128 2 --- }
783A: 0130 { 112 2 ---  129 2 ---  113 0 ---  12A 0 --- }
783B: 0130 { 114 0 ---  12B 0 ---  115 0 ---  12C 0 --- }
783C: 0130 { 004 4 ---  3FF 7 xyp  3FF 7 xyp  004 4 --- }
783D: 0130 { 004 4 ---  3FF 7 xyp  3FF 7 xyp  004 4 --- }
783E: 0130 { 004 4 ---  3FF 7 xyp  3FF 7 xyp  004 4 --- }
783F: 0130 { 004 4 ---  3FF 7 xyp  3FF 7 xyp  004 4 --- }
7840: 0130 { 12E 1 ---  145 2 ---  12F 1 ---  146 2 --- }
7841: 0130 { 130 1 ---  147 2 ---  131 1 ---  148 2 --- }
7842: 0130 { 132 1 ---  149 2 ---  133 1 ---  14A 2 --- }
7843: 0130 { 134 1 ---  14B 2 ---  135 1 ---  14C 2 --- }
7844: 0130 { 136 1 ---  14D 2 ---  137 1 ---  14E 2 --- }
7845: 0130 { 135 1 ---  14C 2 ---  139 1 ---  152 2 --- }
7846: 0130 { 132 1 ---  149 2 ---  133 1 ---  14A 2 --- }
7847: 0130 { 13A 1 ---  151 2 ---  13B 1 ---  149 2 --- }
7848: 0130 { 13C 1 ---  152 2 ---  13D 1 ---  153 2 --- }
7849: 0130 { 13E 1 ---  154 2 ---  13F 1 ---  14E 2 --- }
784A: 0130 { 140 1 ---  151 2 ---  141 1 ---  155 2 --- }
784B: 0130 { 142 1 ---  14A 2 ---  143 1 ---  156 2 --- }
784C: 0130 { 004 4 ---  3FF 7 xyp  3FF 7 xyp  004 4 --- }
784D: 0130 { 004 4 ---  3FF 7 xyp  3FF 7 xyp  004 4 --- }
784E: 0130 { 004 4 ---  3FF 7 xyp  3FF 7 xyp  004 4 --- }
784F: 0130 { 004 4 ---  3FF 7 xyp  3FF 7 xyp  004 4 --- }
7850: 0130 { 100 1 ---  114 1 ---  101 1 ---  115 2 --- }
7851: 0130 { 102 1 ---  116 0 ---  103 1 ---  117 0 --- }
7852: 0130 { 104 1 ---  118 0 ---  105 1 ---  119 0 --- }
7853: 0130 { 106 1 ---  11A 0 ---  107 1 ---  11B 2 --- }
7854: 0130 { 102 1 ---  11C 1 ---  102 1 ---  11C 1 --- }
7855: 0130 { 108 1 ---  11D 1 ---  109 1 ---  11E 1 --- }
7856: 0130 { 10A 1 ---  11F 1 ---  10B 1 ---  120 2 --- }
7857: 0130 { 10C 1 ---  121 2 ---  102 1 ---  122 0 --- }
7858: 0130 { 10D 1 ---  123 0 ---  10E 1 ---  124 1 --- }
7859: 0130 { 10F 1 ---  125 1 ---  110 1 ---  126 1 --- }
785A: 0130 { 111 1 ---  127 2 ---  102 1 ---  128 1 --- }
785B: 0130 { 112 1 ---  129 1 ---  113 1 ---  12A 1 --- }
785C: 0130 { 004 4 ---  3FF 7 xyp  3FF 7 xyp  004 4 --- }
785D: 0130 { 004 4 ---  3FF 7 xyp  3FF 7 xyp  004 4 --- }
785E: 0130 { 004 4 ---  3FF 7 xyp  3FF 7 xyp  004 4 --- }
785F: 0130 { 004 4 ---  3FF 7 xyp  3FF 7 xyp  004 4 --- }
7860: 0130 { 12B 1 ---  142 3 ---  12C 1 ---  143 1 --- }
7861: 0130 { 12D 0 ---  144 0 ---  12E 0 ---  145 0 --- }
7862: 0130 { 12F 0 ---  146 0 ---  130 0 ---  147 0 --- }
7863: 0130 { 131 0 ---  148 0 ---  132 0 ---  149 0 --- }
7864: 0130 { 133 0 ---  14A 0 ---  133 0 ---  14A 0 --- }
7865: 0130 { 134 0 ---  14B 1 ---  135 2 ---  14C 2 --- }
7866: 0130 { 136 0 ---  14D 0 ---  137 2 ---  14E 2 --- }
7867: 0130 { 138 1 ---  14F 1 ---  139 0 ---  150 3 --- }
7868: 0130 { 13A 1 ---  151 1 ---  13B 1 ---  152 3 --- }
7869: 0130 { 13C 1 ---  153 1 ---  13D 1 ---  154 1 --- }
786A: 0130 { 13E 1 ---  155 1 ---  13F 1 ---  156 3 --- }
786B: 0130 { 140 1 ---  157 1 ---  141 1 ---  158 2 --- }
786C: 0130 { 004 4 ---  3FF 7 xyp  3FF 7 xyp  004 4 --- }
786D: 0130 { 004 4 ---  3FF 7 xyp  3FF 7 xyp  004 4 --- }
786E: 0130 { 004 4 ---  3FF 7 xyp  3FF 7 xyp  004 4 --- }
786F: 0130 { 004 4 ---  3FF 7 xyp  3FF 7 xyp  004 4 --- }
7870: 0130 { 159 1 ---  170 1 ---  15A 1 ---  171 2 --- }
7871: 0130 { 15B 0 ---  170 1 ---  15C 0 ---  170 1 --- }
7872: 0130 { 15D 0 ---  172 1 ---  15E 0 ---  170 1 --- }
7873: 0130 { 15F 0 ---  170 1 ---  160 0 ---  173 2 --- }
7874: 0130 { 161 1 ---  170 1 ---  161 1 ---  170 1 --- }
7875: 0130 { 162 1 ---  170 1 ---  163 2 ---  174 1 --- }
7876: 0130 { 164 1 ---  170 1 ---  165 2 ---  170 1 --- }
7877: 0130 { 166 1 ---  175 2 ---  167 1 ---  170 1 --- }
7878: 0130 { 168 1 ---  170 1 ---  169 3 ---  176 1 --- }
7879: 0130 { 16A 1 ---  170 1 ---  16B 1 ---  177 2 --- }
787A: 0130 { 16C 1 ---  178 1 ---  16D 1 ---  170 1 --- }
787B: 0130 { 16E 1 ---  179 1 ---  16F 2 ---  17A 1 --- }
787C: 0130 { 004 4 ---  3FF 7 xyp  3FF 7 xyp  004 4 --- }
787D: 0130 { 004 4 ---  3FF 7 xyp  3FF 7 xyp  004 4 --- }
787E: 0130 { 004 4 ---  3FF 7 xyp  3FF 7 xyp  004 4 --- }
787F: 0130 { 004 4 ---  3FF 7 xyp  3FF 7 xyp  004 4 --- }
7880: 0130 { 100 2 ---  116 0 ---  101 2 ---  117 2 --- }
7881: 0130 { 102 2 ---  118 1 ---  103 2 ---  119 2 --- }
7882: 0130 { 103 2 ---  11A 2 ---  104 2 ---  11B 0 --- }
7883: 0130 { 103 2 ---  11C 1 ---  105 2 ---  11D 0 --- }
7884: 0130 { 106 2 ---  11E 2 ---  107 2 ---  11F 2 --- }
7885: 0130 { 108 2 ---  120 2 ---  109 2 ---  121 0 --- }
7886: 0130 { 10A 2 ---  122 2 ---  10B 2 ---  123 2 --- }
7887: 0130 { 10C 2 ---  124 2 ---  10D 2 ---  125 2 --- }
7888: 0130 { 10E 2 ---  126 2 ---  10F 2 ---  127 2 --- }
7889: 0130 { 110 2 ---  128 2 ---  111 2 ---  129 2 --- }
788A: 0130 { 112 2 ---  12A 2 ---  113 2 ---  12B 0 --- }
788B: 0130 { 113 2 ---  12B 0 ---  109 2 ---  121 0 --- }
788C: 0130 { 004 4 ---  3FF 7 xyp  3FF 7 xyp  004 4 --- }
788D: 0130 { 004 4 ---  3FF 7 xyp  3FF 7 xyp  004 4 --- }
788E: 0130 { 004 4 ---  3FF 7 xyp  3FF 7 xyp  004 4 --- }
788F: 0130 { 004 4 ---  3FF 7 xyp  3FF 7 xyp  004 4 --- }
7890: 0130 { 12D 3 ---  144 0 ---  12E 3 ---  145 0 --- }
7891: 0130 { 12F 1 ---  146 1 ---  130 3 ---  147 1 --- }
7892: 0130 { 131 3 ---  148 1 ---  132 1 ---  149 1 --- }
7893: 0130 { 133 1 ---  14A 1 ---  134 1 ---  14B 1 --- }
7894: 0130 { 135 3 ---  14C 3 ---  136 3 ---  14D 3 --- }
7895: 0130 { 137 3 ---  14E 0 ---  138 3 ---  14F 3 --- }
7896: 0130 { 139 3 ---  150 0 ---  13A 3 ---  151 3 --- }
7897: 0130 { 13B 3 ---  152 0 ---  13C 2 ---  153 0 --- }
7898: 0130 { 13D 3 ---  154 3 ---  13E 3 ---  155 0 --- }
7899: 0130 { 13F 3 ---  156 0 ---  140 3 ---  157 3 --- }
789A: 0130 { 141 2 ---  158 0 ---  142 2 ---  159 0 --- }
789B: 0130 { 143 3 ---  15A 0 ---  12D 3 ---  144 0 --- }
789C: 0130 { 004 4 ---  3FF 7 xyp  3FF 7 xyp  004 4 --- }
789D: 0130 { 004 4 ---  3FF 7 xyp  3FF 7 xyp  004 4 --- }
789E: 0130 { 004 4 ---  3FF 7 xyp  3FF 7 xyp  004 4 --- }
789F: 0130 { 004 4 ---  3FF 7 xyp  3FF 7 xyp  004 4 --- }
78A0: 0130 { 15B 0 ---  172 1 ---  15C 0 ---  173 1 --- }
78A1: 0130 { 15D 1 ---  174 1 ---  15E 1 ---  175 1 --- }
78A2: 0130 { 15F 1 ---  176 1 ---  160 1 ---  177 1 --- }
78A3: 0130 { 161 1 ---  178 1 ---  162 0 ---  179 1 --- }
78A4: 0130 { 163 2 ---  17A 1 ---  164 3 ---  17B 1 --- }
78A5: 0130 { 165 3 ---  17C 1 ---  166 3 ---  17D 1 --- }
78A6: 0130 { 167 3 ---  17E 1 ---  168 3 ---  17F 1 --- }
78A7: 0130 { 169 3 ---  197 1 ---  16A 3 ---  17B 1 x-- }
78A8: 0130 { 16B 3 ---  198 1 ---  16C 3 ---  199 1 --- }
78A9: 0130 { 16D 3 ---  19A 1 ---  16E 3 ---  19B 1 --- }
78AA: 0130 { 16F 3 ---  19C 1 ---  170 3 ---  17B 1 x-- }
78AB: 0130 { 171 0 ---  19D 1 ---  15B 0 ---  172 1 --- }
78AC: 0130 { 004 4 ---  3FF 7 xyp  3FF 7 xyp  004 4 --- }
78AD: 0130 { 004 4 ---  3FF 7 xyp  3FF 7 xyp  004 4 --- }
78AE: 0130 { 004 4 ---  3FF 7 xyp  3FF 7 xyp  004 4 --- }
78AF: 0130 { 004 4 ---  3FF 7 xyp  3FF 7 xyp  004 4 --- }
78B0: 0130 { 100 1 ---  111 2 ---  101 1 ---  112 2 --- }
78B1: 0130 { 102 1 ---  113 0 ---  103 1 ---  114 2 --- }
78B2: 0130 { 104 1 ---  115 2 ---  105 1 ---  116 2 --- }
78B3: 0130 { 106 1 ---  117 2 ---  107 1 ---  118 1 --- }
78B4: 0130 { 108 1 ---  119 1 ---  109 1 ---  11A 0 --- }
78B5: 0130 { 108 1 ---  11B 2 ---  10A 1 ---  11C 2 --- }
78B6: 0130 { 10B 1 ---  11D 2 ---  10C 1 ---  11E 2 --- }
78B7: 0130 { 10D 1 ---  11F 2 ---  10E 1 ---  120 2 --- }
78B8: 0130 { 10F 1 ---  121 2 ---  110 1 ---  122 2 --- }
78B9: 0130 { 004 4 ---  3FF 7 xyp  3FF 7 xyp  004 4 --- }
78BA: 0130 { 004 4 ---  3FF 7 xyp  3FF 7 xyp  004 4 --- }
78BB: 0130 { 004 4 ---  3FF 7 xyp  3FF 7 xyp  004 4 --- }
78BC: 0130 { 004 4 ---  3FF 7 xyp  3FF 7 xyp  004 4 --- }
78BD: 0130 { 004 4 ---  3FF 7 xyp  3FF 7 xyp  004 4 --- }
78BE: 0130 { 004 4 ---  3FF 7 xyp  3FF 7 xyp  004 4 --- }
78BF: 0130 { 004 4 ---  3FF 7 xyp  3FF 7 xyp  004 4 --- }
78C0: 0130 { 123 0 ---  135 1 ---  124 2 ---  136 0 --- }
78C1: 0130 { 125 3 ---  137 3 ---  126 0 ---  138 3 --- }
78C2: 0130 { 127 0 ---  139 2 ---  128 2 ---  13A 2 --- }
78C3: 0130 { 129 2 ---  13B 2 ---  12A 1 ---  13C 1 --- }
78C4: 0130 { 12B 2 ---  13D 0 ---  12C 2 ---  13E 0 --- }
78C5: 0130 { 12D 0 ---  13F 2 ---  12E 0 ---  140 2 --- }
78C6: 0130 { 12F 0 ---  141 0 ---  130 2 ---  142 2 --- }
78C7: 0130 { 131 2 ---  143 2 ---  132 0 ---  144 0 --- }
78C8: 0130 { 133 1 ---  145 1 ---  134 0 ---  146 0 --- }
78C9: 0130 { 004 4 ---  3FF 7 xyp  3FF 7 xyp  004 4 --- }
78CA: 0130 { 004 4 ---  3FF 7 xyp  3FF 7 xyp  004 4 --- }
78CB: 0130 { 004 4 ---  3FF 7 xyp  3FF 7 xyp  004 4 --- }
78CC: 0130 { 004 4 ---  3FF 7 xyp  3FF 7 xyp  004 4 --- }
78CD: 0130 { 004 4 ---  3FF 7 xyp  3FF 7 xyp  004 4 --- }
78CE: 0130 { 004 4 ---  3FF 7 xyp  3FF 7 xyp  004 4 --- }
78CF: 0130 { 004 4 ---  3FF 7 xyp  3FF 7 xyp  004 4 --- }
78D0: 0130 { 147 2 ---  159 2 ---  148 2 ---  15A 2 --- }
78D1: 0130 { 149 2 ---  15B 2 ---  14A 2 ---  15C 2 --- }
78D2: 0130 { 14B 2 ---  15D 2 ---  14C 2 ---  15E 2 --- }
78D3: 0130 { 14D 0 ---  15F 2 ---  14E 1 ---  160 2 --- }
78D4: 0130 { 14F 2 ---  161 0 ---  150 0 ---  162 0 --- }
78D5: 0130 { 151 0 ---  163 0 ---  152 0 ---  164 0 --- }
78D6: 0130 { 153 0 ---  165 2 ---  154 2 ---  166 2 --- }
78D7: 0130 { 155 2 ---  167 2 ---  156 2 ---  15C 2 x-- }
78D8: 0130 { 157 2 ---  168 2 ---  158 2 ---  15E 2 x-- }
78D9: 0130 { 004 4 ---  3FF 7 xyp  3FF 7 xyp  004 4 --- }
78DA: 0130 { 004 4 ---  3FF 7 xyp  3FF 7 xyp  004 4 --- }
78DB: 0130 { 004 4 ---  3FF 7 xyp  3FF 7 xyp  004 4 --- }
78DC: 0130 { 004 4 ---  3FF 7 xyp  3FF 7 xyp  004 4 --- }
78DD: 0130 { 004 4 ---  3FF 7 xyp  3FF 7 xyp  004 4 --- }
78DE: 0130 { 004 4 ---  3FF 7 xyp  3FF 7 xyp  004 4 --- }
78DF: 0130 { 004 4 ---  3FF 7 xyp  3FF 7 xyp  004 4 --- }
78E0: 0130 { 100 1 ---  11B 2 ---  101 1 ---  11C 2 --- }
78E1: 0130 { 102 1 ---  11D 1 ---  103 1 ---  11E 1 --- }
78E2: 0130 { 104 1 ---  11F 1 ---  105 1 ---  120 1 --- }
78E3: 0130 { 106 1 ---  121 2 ---  107 1 ---  122 1 --- }
78E4: 0130 { 108 1 ---  123 1 ---  109 1 ---  124 1 --- }
78E5: 0130 { 10A 1 ---  125 1 ---  10B 1 ---  126 1 --- }
78E6: 0130 { 10C 1 ---  127 1 ---  10D 1 ---  128 1 --- }
78E7: 0130 { 10E 1 ---  129 0 ---  10F 1 ---  12A 1 --- }
78E8: 0130 { 110 1 ---  12B 2 ---  111 1 ---  12C 1 --- }
78E9: 0130 { 112 1 ---  12D 1 ---  113 1 ---  12E 0 --- }
78EA: 0130 { 113 1 ---  12F 3 ---  114 3 ---  130 1 --- }
78EB: 0130 { 115 3 ---  131 1 ---  116 3 ---  132 3 --- }
78EC: 0130 { 117 1 ---  133 1 ---  118 2 ---  134 2 --- }
78ED: 0130 { 119 2 ---  135 2 ---  11A 2 ---  136 2 --- }
78EE: 0130 { 004 4 ---  3FF 7 xyp  3FF 7 xyp  004 4 --- }
78EF: 0130 { 004 4 ---  3FF 7 xyp  3FF 7 xyp  004 4 --- }
78F0: 0130 { 137 1 ---  153 1 ---  138 1 ---  154 3 --- }
78F1: 0130 { 139 1 ---  155 3 ---  13A 1 ---  156 2 --- }
78F2: 0130 { 13B 1 ---  157 2 ---  13C 1 ---  158 2 --- }
78F3: 0130 { 13D 1 ---  159 3 ---  13E 1 ---  15A 3 --- }
78F4: 0130 { 13F 1 ---  15B 0 ---  140 1 ---  15C 0 --- }
78F5: 0130 { 141 1 ---  15B 0 ---  142 1 ---  15D 0 --- }
78F6: 0130 { 143 1 ---  15E 0 ---  144 1 ---  15F 0 --- }
78F7: 0130 { 145 1 ---  160 0 ---  146 1 ---  161 0 --- }
78F8: 0130 { 147 1 ---  162 0 ---  148 1 ---  163 0 --- }
78F9: 0130 { 149 1 ---  164 3 ---  14A 0 ---  165 0 --- }
78FA: 0130 { 14B 3 ---  166 0 ---  14C 1 ---  167 3 --- }
78FB: 0130 { 14D 3 ---  168 3 ---  14E 3 ---  169 3 --- }
78FC: 0130 { 14F 1 ---  16A 0 ---  150 1 ---  16B 1 --- }
78FD: 0130 { 151 1 ---  16C 1 ---  152 1 ---  16D 1 --- }
78FE: 0130 { 004 4 ---  3FF 7 xyp  3FF 7 xyp  004 4 --- }
78FF: 0130 { 004 4 ---  3FF 7 xyp  3FF 7 xyp  004 4 --- }
