6400: 0025 { 0F8 5 x--  0F8 5 x--  0F8 5 x--  2BB 5 x-- }
6401: 0025 { 0F8 5 x--  2BA 5 x--  0F8 5 x--  289 5 x-- }
6402: 0025 { 0F8 5 x--  288 5 x--  0F8 5 x--  287 5 x-- }
6403: 0025 { 0F8 5 x--  0F8 5 x--  0F8 5 x--  0F8 5 x-- }
6404: 0025 { 240 4 ---  250 4 ---  241 4 ---  251 4 --- }
6405: 0025 { 242 4 ---  252 4 ---  0F8 5 x--  0F8 5 x-- }
6406: 0025 { 275 6 ---  277 6 ---  276 6 ---  278 6 --- }
6407: 0025 { 0F8 5 x--  0F8 5 x--  27B 4 x--  214 4 x-- }
6408: 0025 { 200 4 ---  210 4 ---  201 4 ---  211 4 --- }
6409: 0025 { 202 4 ---  212 4 ---  203 4 ---  213 4 --- }
640A: 0025 { 204 4 ---  0F8 5 x--  205 4 ---  215 4 --- }
640B: 0025 { 206 4 ---  216 4 ---  207 4 ---  217 4 --- }
640C: 0025 { 208 4 ---  218 4 ---  209 4 ---  219 4 --- }
640D: 0025 { 20A 4 ---  21A 4 ---  20B 4 ---  21B 4 --- }
640E: 0025 { 27B 4 ---  214 4 ---  0F8 5 x--  0F8 5 x-- }
640F: 0130 { 28E 5 ---  29E 5 ---  28F 5 ---  29F 5 --- }
6410: 0025 { 0F8 5 x--  0F8 5 x--  2CB 5 x--  2DB 5 x-- }
6411: 0025 { 2CA 5 x--  2DA 5 x--  299 5 x--  2BD 5 x-- }
6412: 0025 { 298 5 x--  2BC 5 x--  297 5 x--  29D 5 x-- }
6413: 0025 { 296 5 x--  29C 5 x--  0F8 5 x--  0F8 5 x-- }
6414: 0025 { 260 4 ---  270 4 ---  261 4 ---  271 4 --- }
6415: 0025 { 262 4 ---  272 4 ---  0F8 5 x--  0F8 5 x-- }
6416: 0025 { 279 6 ---  0F8 6 x--  27A 6 ---  0F8 6 x-- }
6417: 0025 { 0F8 5 x--  0F8 5 x--  225 4 x--  0F8 5 x-- }
6418: 0025 { 220 4 ---  230 4 ---  221 4 ---  231 4 --- }
6419: 0025 { 222 4 ---  232 4 ---  223 4 ---  233 4 --- }
641A: 0025 { 224 4 ---  234 4 ---  0F8 5 x--  235 4 --- }
641B: 0025 { 226 4 ---  236 4 ---  227 4 ---  237 4 --- }
641C: 0025 { 228 4 ---  238 4 ---  229 4 ---  239 4 --- }
641D: 0025 { 22A 4 ---  23A 4 ---  22B 4 ---  23B 4 --- }
641E: 0025 { 225 4 ---  0F8 5 x--  0F8 5 x--  0F8 5 x-- }
641F: 0130 { 2AE 5 ---  2BE 5 ---  2AF 5 ---  2BF 5 --- }
6420: 0025 { 0F8 5 x--  0F8 5 x--  2DD 5 x--  2E7 5 x-- }
6421: 0025 { 2DC 5 x--  2E6 5 x--  2CD 5 x--  2D8 5 x-- }
6422: 0025 { 2CC 5 x--  2C8 5 x--  2AD 5 x--  2F3 5 x-- }
6423: 0025 { 2AC 5 x--  286 5 x--  0F8 5 x--  0F8 5 x-- }
6424: 0025 { 0F8 5 x--  0F8 5 x--  242 4 x--  252 4 x-- }
6425: 0025 { 241 4 x--  251 4 x--  240 4 x--  250 4 x-- }
6426: 0130 { 273 3 ---  257 3 ---  274 3 ---  266 3 --- }
6427: 0025 { 0F8 5 x--  0F8 5 x--  0F8 5 x--  0F8 5 x-- }
6428: 0025 { 0F8 5 x--  0F8 5 x--  263 4 ---  0F8 5 x-- }
6429: 0025 { 264 4 ---  0F8 5 x--  243 4 ---  253 4 --- }
642A: 0025 { 244 4 ---  254 4 ---  245 4 ---  255 4 --- }
642B: 0025 { 246 4 ---  256 4 ---  247 4 ---  254 4 x-- }
642C: 0025 { 267 4 ---  253 4 x--  264 4 x--  0F8 5 x-- }
642D: 0025 { 263 4 x--  0F8 5 x--  0F8 5 x--  0F8 5 x-- }
642E: 0025 { 0F8 5 x--  0F8 5 x--  0F8 5 x--  0F8 5 x-- }
642F: 0130 { 2CE 5 ---  2DE 5 ---  2CF 5 ---  2DF 5 --- }
6430: 0025 { 0F8 5 x--  0F8 5 x--  20C 4 ---  21C 4 --- }
6431: 0025 { 20D 4 ---  21D 4 ---  20E 4 ---  21E 4 --- }
6432: 0025 { 20F 4 ---  21F 4 ---  0F8 5 x--  0F8 5 x-- }
6433: 0025 { 0F8 5 x--  0F8 5 x--  0F8 5 x--  0F8 5 x-- }
6434: 0025 { 0F8 5 x--  0F8 5 x--  262 4 x--  272 4 x-- }
6435: 0025 { 261 4 x--  271 4 x--  260 4 x--  270 4 x-- }
6436: 0025 { 0F8 5 x--  0F8 5 x--  25E 5 ---  26E 5 --- }
6437: 0025 { 25F 5 ---  26F 5 ---  0F8 5 x--  0F8 5 x-- }
6438: 0025 { 28B 5 x--  29B 5 x--  28A 5 x--  29A 5 x-- }
6439: 0025 { 28C 5 x--  0F8 5 x--  0F8 5 x--  0F8 5 x-- }
643A: 0025 { 0F8 5 xy-  2AB 5 xy-  0F8 5 xy-  2AA 5 xy- }
643B: 0106 { 252 7 --p  262 7 --p  252 7 x-p  262 7 x-p }
643C: 0130 { 2EA 5 ---  2FA 5 ---  2EF 5 ---  2FF 5 --- }
643D: 0130 { 2EA 5 ---  2FA 5 ---  2EB 5 ---  2FB 5 --- }
643E: 0130 { 2EC 5 ---  2FC 5 ---  2ED 5 ---  2FD 5 --- }
643F: 0130 { 2EE 5 ---  2FE 5 ---  2EF 5 ---  2FF 5 --- }
6440: 0025 { 0F8 5 x--  0F8 5 x--  22C 4 ---  23C 4 --- }
6441: 0025 { 22D 4 ---  23D 4 ---  22E 4 ---  23E 4 --- }
6442: 0025 { 22F 4 ---  23F 4 ---  0F8 5 x--  0F8 5 x-- }
6443: 0106 { 250 7 --p  260 7 --p  251 7 --p  261 7 --p }
6444: 0106 { 252 7 --p  262 7 --p  252 7 x-p  262 7 x-p }
6445: 0106 { 251 7 x-p  261 7 x-p  250 7 x-p  260 7 x-p }
6446: 0025 { 0F8 5 x--  0F8 5 x--  27E 5 ---  0F8 5 --- }
6447: 0025 { 27F 5 ---  0F8 5 ---  0F8 5 x--  0F8 5 x-- }
6448: 0025 { 2AB 5 x--  0F8 5 x--  2AA 5 x--  0F8 5 x-- }
6449: 0025 { 20B 7 --p  21B 7 --p  20C 7 --p  21C 7 --p }
644A: 0025 { 29B 5 xy-  28B 5 xy-  29A 5 xy-  28A 5 xy- }
644B: 0025 { 0F8 5 xy-  28C 5 xy-  0F8 5 xy-  0F8 5 xy- }
644C: 006E { 0F8 5 x--  0F8 5 x--  0F8 5 x--  0F8 5 x-- }
644D: 0025 { 0A0 4 --p  0B0 4 --p  0A1 4 --p  0B1 4 --p }
644E: 0025 { 0A1 4 x-p  0B1 4 x-p  0A0 4 x-p  0B0 4 x-p }
644F: 0025 { 0F8 5 x--  0F8 5 x--  0F8 5 x--  0F8 5 x-- }
6450: 0025 { 0F8 5 x--  0F8 5 x--  24C 5 ---  25C 5 --- }
6451: 0025 { 24D 4 ---  25D 4 ---  24E 4 ---  25E 4 --- }
6452: 0025 { 24F 4 ---  25F 4 ---  0F8 5 x--  0F8 5 x-- }
6453: 0025 { 0F8 5 x-p  0F8 5 x-p  255 7 x-p  265 7 x-p }
6454: 0025 { 253 7 --p  263 7 --p  082 3 --p  092 3 --p }
6455: 0025 { 255 7 --p  265 7 --p  0F8 5 x-p  0F8 5 x-p }
6456: 0025 { 0F8 5 x--  0F8 5 x--  0F8 5 x--  0F8 5 x-- }
6457: 0025 { 0F8 5 x--  0B0 5 ---  0F8 5 x--  0B1 5 --- }
6458: 0025 { 0F8 5 x--  0C0 5 ---  0F8 5 x--  0C1 5 --- }
6459: 0035 { 0F8 5 x--  0F8 5 x--  180 5 ---  190 5 --- }
645A: 0035 { 181 5 ---  191 5 ---  0F8 5 x--  0F8 5 x-- }
645B: 0025 { 0F8 5 x--  1AC 5 ---  0F8 5 x--  1AD 5 --- }
645C: 0025 { 0F8 5 -y-  2AA 5 -y-  0F8 5 -y-  2AB 5 -y- }
645D: 0025 { 0F8 5 x--  0F8 5 x--  0F8 5 x--  0F8 5 x-- }
645E: ~
645F: ~
6460: 0025 { 0F8 5 x--  0F8 5 x--  26C 4 ---  26C 4 --- }
6461: 0025 { 0F8 5 x--  26D 4 ---  0F8 5 x--  26E 4 --- }
6462: 0025 { 26C 4 x--  26F 4 ---  0F8 5 x--  0F8 5 x-- }
6463: 0025 { 0F8 5 x-p  0F8 5 x-p  0F8 5 x-p  256 7 --p }
6464: 0025 { 248 7 --p  258 7 --p  249 7 --p  259 7 --p }
6465: 0025 { 0F8 5 x-p  256 7 x-p  0F8 5 x-p  0F8 5 x-p }
6466: 0025 { 25E 5 ---  26E 5 ---  25F 5 ---  26F 5 --- }
6467: 006F { 2F1 5 ---  2F1 5 ---  2F1 5 ---  2F1 5 --- }
6468: 0025 { 0F8 5 ---  221 5 x--  0F8 5 ---  220 5 x-- }
6469: 0025 { 0F8 5 ---  0F8 5 ---  28C 5 ---  0F8 5 --- }
646A: 0025 { 28A 5 ---  29A 5 ---  28B 5 ---  29B 5 --- }
646B: 0025 { 0F8 5 -y-  0F8 5 -y-  0F8 5 -y-  28C 5 -y- }
646C: 0025 { 29A 5 -y-  28A 5 -y-  29B 5 -y-  28B 5 -y- }
646D: 0025 { 0F8 3 ---  0F8 3 ---  1E9 3 ---  1F9 3 --- }
646E: 0025 { 1EA 3 ---  1FA 3 ---  1EB 3 ---  1FB 3 --- }
646F: ~
6470: 0025 { 0F8 5 x--  0F8 5 x--  27C 4 ---  248 4 --- }
6471: 0025 { 27D 4 ---  249 4 ---  27E 4 ---  24A 4 --- }
6472: 0025 { 27F 4 ---  24B 4 ---  0F8 5 x--  0F8 5 x-- }
6473: 0025 { 236 5 ---  246 5 ---  237 5 ---  247 5 --- }
6474: 0130 { 268 7 --p  278 7 --p  269 7 --p  279 7 --p }
6475: ~
6476: 0025 { 27E 5 ---  0F8 5 ---  27F 5 ---  0F8 5 --- }
6477: 006F { 2F1 5 ---  2F6 5 ---  2F1 5 ---  2F7 5 --- }
6478: 0025 { 231 5 x--  241 5 x--  230 5 x--  240 5 x-- }
6479: 0025 { 0F7 1 ---  0CD 1 ---  0CC 1 ---  0CE 1 --- }
647A: 0025 { 2AA 5 ---  0F8 5 ---  2AB 5 ---  0F8 5 --- }
647B: 0025 { 188 3 ---  198 3 ---  189 3 ---  199 3 --- }
647C: 0025 { 18A 3 ---  19A 3 ---  0F8 3 ---  19B 3 --- }
647D: 0025 { 0F8 3 ---  0F8 3 ---  1D8 3 ---  1E8 3 --- }
647E: 0025 { 18C 3 ---  19C 3 ---  18D 3 ---  19D 3 --- }
647F: ~
6480: 0025 { 0F8 5 x--  0F8 5 x--  258 4 ---  268 4 --- }
6481: 0025 { 259 4 ---  269 4 ---  25A 4 ---  26A 4 --- }
6482: 0025 { 25B 4 ---  26B 4 ---  0F8 5 x--  0F8 5 x-- }
6483: 0163 { 020 4 -y-  020 4 -y-  021 4 -y-  021 4 -y- }
6484: 0164 { 022 4 -y-  022 4 -y-  023 4 -y-  023 4 -y- }
6485: 0133 { 000 4 ---  010 4 ---  001 4 ---  011 4 --- }
6486: 0134 { 002 4 ---  012 4 ---  003 4 ---  013 4 --- }
6487: 0025 { 0F8 1 x--  0F0 2 ---  0F8 1 x--  0F1 2 --- }
6488: 0130 { 00E 2 ---  01E 2 ---  00F 2 ---  01F 2 --- }
6489: 0025 { 082 1 ---  085 1 ---  084 1 ---  085 1 x-- }
648A: ~
648B: 0025 { 1A8 3 ---  1B8 3 ---  1A9 3 ---  1B9 3 --- }
648C: 0025 { 1AA 3 ---  1BA 3 ---  1AB 3 ---  1BB 3 --- }
648D: 0025 { 0F8 3 ---  0F8 3 ---  1F8 3 ---  18B 3 --- }
648E: 0025 { 1AC 3 ---  1BC 3 ---  1AD 3 ---  1BD 3 --- }
648F: ~
6490: 0025 { 0F8 5 x--  0F8 5 x--  21F 4 xy-  20F 4 xy- }
6491: 0025 { 21E 4 xy-  20E 4 xy-  21D 4 xy-  20D 4 xy- }
6492: 0025 { 21C 4 xy-  20C 4 xy-  0F8 5 x--  0F8 5 x-- }
6493: 0130 { 010 4 -y-  000 4 -y-  011 4 -y-  001 4 -y- }
6494: 0130 { 012 4 -y-  002 4 -y-  013 4 -y-  003 4 -y- }
6495: 0135 { 020 4 ---  020 4 ---  021 4 ---  021 4 --- }
6496: 0136 { 022 4 ---  022 4 ---  023 4 ---  023 4 --- }
6497: 0025 { 0F2 2 ---  0F4 2 ---  0F3 2 ---  0F5 2 --- }
6498: 0025 { 0F8 1 x--  0F6 2 ---  0F8 1 x--  0F8 1 x-- }
6499: 0025 { 0E4 1 ---  0E2 1 ---  0E4 1 x--  0E2 1 x-- }
649A: ~
649B: 0025 { 1C8 3 ---  0F8 3 ---  1C9 3 ---  1D9 3 --- }
649C: 0025 { 1CA 3 ---  1DA 3 ---  1CB 3 ---  1DB 3 --- }
649D: ~
649E: ~
649F: ~
64A0: 0130 { 188 3 ---  198 3 ---  189 3 ---  199 3 --- }
64A1: 0130 { 18A 6 ---  19A 6 ---  18B 6 ---  19B 6 --- }
64A2: 0025 { 184 2 ---  194 2 ---  185 2 ---  195 2 --- }
64A3: 0025 { 186 2 ---  196 2 ---  187 2 ---  197 2 --- }
64A4: 0025 { 1EC 4 ---  1FC 4 ---  1ED 4 ---  1FD 4 --- }
64A5: 0025 { 1EE 4 ---  1FE 4 ---  1EF 4 ---  1FF 4 --- }
64A6: 0025 { 1CC 4 ---  1DC 4 ---  1CD 4 ---  1DD 4 --- }
64A7: 0025 { 1CE 4 ---  1DE 4 ---  1CF 4 ---  1DF 4 --- }
64A8: 0025 { 0A0 4 ---  0B0 4 ---  0A0 4 x--  0B0 4 x-- }
64A9: 0025 { 0F8 1 x--  0F8 1 x--  0A1 4 ---  0B1 4 --- }
64AA: 0025 { 0A1 4 x--  0B1 4 x--  0F8 1 x--  0F8 1 x-- }
64AB: 0025 { 0F8 1 x--  0F8 1 x--  0F8 1 x--  188 4 x-- }
64AC: 0025 { 0F8 1 x--  187 4 x--  0F8 1 x--  186 4 x-- }
64AD: 0025 { 0F8 1 x--  185 4 x--  0F8 1 x--  184 4 x-- }
64AE: 0025 { 0F8 1 x--  0F8 1 x--  0F8 1 x--  0F8 1 x-- }
64AF: 0025 { 0F8 1 x--  0F8 1 x--  0F8 1 x--  0F8 1 x-- }
64B0: 0025 { 1A0 2 ---  1B0 2 ---  1A1 2 ---  1B1 2 --- }
64B1: 0025 { 1A2 2 ---  1B2 2 ---  1A3 2 ---  1B3 2 --- }
64B2: 0025 { 1A4 2 ---  1B4 2 ---  1A5 2 ---  1B5 2 --- }
64B3: 0025 { 1A6 2 ---  1B6 2 ---  1A7 2 ---  1B7 2 --- }
64B4: 0025 { 1A8 2 ---  1B8 2 ---  1A9 2 ---  1B9 2 --- }
64B5: 0025 { 1AA 2 ---  1BA 2 ---  1AB 2 ---  1BB 2 --- }
64B6: 0025 { 0F8 2 ---  0F8 2 ---  082 2 ---  092 2 --- }
64B7: 0025 { 083 2 ---  093 2 ---  084 2 ---  094 2 --- }
64B8: 0025 { 0B0 4 ---  0B0 4 ---  0B0 4 x--  0B0 4 x-- }
64B9: 0025 { 0C0 4 ---  0D0 4 ---  0C1 4 ---  0D1 4 --- }
64BA: 0025 { 0C1 4 x--  0D1 4 x--  0C0 4 x--  0D0 4 x-- }
64BB: 0025 { 0F8 1 x--  0F8 1 x--  0F8 1 x--  0F8 1 x-- }
64BC: 0025 { 197 4 x--  1A7 4 x--  196 4 x--  1A6 4 x-- }
64BD: 0025 { 195 4 x--  1A5 4 x--  194 4 x--  1A4 4 x-- }
64BE: 0025 { 193 4 x--  1A3 4 x--  192 4 x--  1A2 4 x-- }
64BF: 0025 { 191 4 x--  1A1 4 x--  190 4 x--  1A0 4 x-- }
64C0: 0025 { 1C0 2 ---  1D0 2 ---  1C1 2 ---  1D1 2 --- }
64C1: 0025 { 1C2 2 ---  1D2 2 ---  1C3 2 ---  1D3 2 --- }
64C2: 0025 { 1C4 2 ---  1D4 2 ---  1C5 2 ---  1D5 2 --- }
64C3: 0025 { 1C6 2 ---  1D6 2 ---  1C7 2 ---  1D7 2 --- }
64C4: 0025 { 1C8 2 ---  1D8 2 ---  1C9 2 ---  1D9 2 --- }
64C5: 0025 { 1CA 2 ---  1DA 2 ---  1CB 2 ---  1DB 2 --- }
64C6: 0025 { 0F8 2 ---  0F8 2 ---  0A4 2 x--  0B4 2 x-- }
64C7: 0025 { 0A3 2 x--  0B3 2 x--  0A2 2 x--  0B2 2 x-- }
64C8: 0025 { 0E1 4 ---  0E1 4 ---  0E1 4 x--  0E1 4 --- }
64C9: 0025 { 0E0 4 ---  0E1 4 ---  0E1 4 ---  0E1 4 --- }
64CA: 0025 { 0E1 4 x--  0E1 4 ---  0E0 4 x--  0E1 4 --- }
64CB: 0025 { 0F8 1 x--  0F8 1 x--  1B8 4 x--  1C8 4 x-- }
64CC: 0025 { 1B7 4 x--  1C7 4 x--  1B6 4 x--  1C6 4 x-- }
64CD: 0025 { 1B5 4 x--  1C5 4 x--  1B4 4 x--  1C4 4 x-- }
64CE: 0025 { 1B3 4 x--  1C3 4 x--  1B2 4 x--  1C2 4 x-- }
64CF: 0025 { 1B1 4 x--  1C1 4 x--  1B0 4 x--  1C0 4 x-- }
64D0: 0025 { 1E0 2 ---  1F0 2 ---  1E1 2 ---  1F1 2 --- }
64D1: 0025 { 1E2 2 ---  1F2 2 ---  1E3 2 ---  1F3 2 --- }
64D2: 0025 { 1E4 2 ---  1F4 2 ---  1E5 2 ---  1F5 2 --- }
64D3: 0025 { 1E6 2 ---  1F6 2 ---  1E7 2 ---  1F7 2 --- }
64D4: 0025 { 1E8 2 ---  1F8 2 ---  1E9 2 ---  1F9 2 --- }
64D5: 0025 { 1EA 2 ---  1FA 2 ---  1EB 2 ---  1FB 2 --- }
64D6: 0025 { 0F8 2 ---  0F8 2 ---  0C4 2 x--  0D4 2 x-- }
64D7: 0025 { 0C3 2 x--  0D3 2 x--  0C2 2 x--  0D2 2 x-- }
64D8: 0025 { 0F8 1 x--  0F8 1 x--  0B0 4 ---  0B0 4 --- }
64D9: 0025 { 0C1 4 x--  0D1 4 x--  0C0 4 x--  0D0 4 x-- }
64DA: 0025 { 0B0 4 x--  0B0 4 x--  0F8 1 x--  0F8 1 x-- }
64DB: 0025 { 0F8 1 x--  0F8 1 x--  1D8 4 x--  0F8 1 x-- }
64DC: 0025 { 1D7 4 x--  1E7 4 x--  1D6 4 x--  1E6 4 x-- }
64DD: 0025 { 1D5 4 x--  1E5 4 x--  1D4 4 x--  1E4 4 x-- }
64DE: 0025 { 1D3 4 x--  1E3 4 x--  1D2 4 x--  1E2 4 x-- }
64DF: 0025 { 1D1 4 x--  1E1 4 x--  1D0 4 x--  1E0 4 x-- }
64E0: ~
64E1: ~
64E2: 0025 { 0E0 4 ---  0E1 4 ---  0E0 4 x--  0E1 4 --- }
64E3: 0025 { 0E1 4 ---  0E1 4 ---  0B0 4 x--  0E0 4 x-- }
64E4: 0025 { 0B0 4 ---  0B0 4 ---  0E0 4 x--  0E1 4 --- }
64E5: 0025 { 0A0 4 ---  0B0 4 ---  0E0 4 ---  0E1 4 --- }
64E6: 0025 { 0F8 2 ---  0F8 2 ---  0E4 2 x--  0F8 2 --- }
64E7: 0025 { 0E3 2 x--  0F8 2 ---  0E2 2 x--  0F8 2 --- }
64E8: 0025 { 0F8 1 x--  0A0 4 ---  0F8 1 x--  0A0 4 x-- }
64E9: 0025 { 0B0 4 ---  0B0 4 ---  0E1 4 ---  0E1 4 --- }
64EA: 0025 { 0E1 4 x--  0E1 4 x--  0B0 4 x--  0B0 4 x-- }
64EB: 0025 { 0B0 4 ---  0E0 4 ---  0E1 4 ---  0E1 4 --- }
64EC: 0025 { 1F7 4 x--  0F8 1 x--  1F6 4 x--  0F8 1 x-- }
64ED: 0025 { 1F5 4 x--  18F 4 x--  1F4 4 x--  18E 4 x-- }
64EE: 0025 { 1F3 4 x--  18D 4 x--  1F2 4 x--  0F8 1 x-- }
64EF: 0025 { 1F1 4 x--  0F8 1 x--  0F8 1 x--  0F8 1 x-- }
64F0: ~
64F1: ~
64F2: ~
64F3: ~
64F4: ~
64F5: ~
64F6: ~
64F7: ~
64F8: ~
64F9: ~
64FA: ~
64FB: ~
64FC: 0130 { 004 4 x--  004 4 x--  004 4 x--  004 4 x-- }
64FD: 0025 { 19F 4 x--  1AF 4 x--  19E 4 x--  1AE 4 x-- }
64FE: 0025 { 19D 4 x--  1AD 4 x--  0F8 1 x--  0F8 1 x-- }
64FF: ~
