2400: 0025 { 200 6 ---  210 6 ---  201 6 ---  211 6 --- }
2401: 0025 { 202 6 ---  212 6 ---  203 6 ---  213 6 --- }
2402: 0025 { 204 6 ---  214 6 ---  205 6 ---  215 6 --- }
2403: 0025 { 205 6 x--  215 6 x--  204 6 x--  214 6 x-- }
2404: 0025 { 203 6 x--  213 6 x--  202 6 x--  212 6 x-- }
2405: 0025 { 201 6 x--  211 6 x--  200 6 x--  210 6 x-- }
2406: ~
2407: ~
2408: ~
2409: ~
240A: ~
240B: ~
240C: ~
240D: ~
240E: ~
240F: ~
2410: 0025 { 220 6 ---  230 6 ---  221 6 ---  231 6 --- }
2411: 0025 { 222 6 ---  232 6 ---  223 6 ---  233 6 --- }
2412: 0025 { 224 6 ---  234 6 ---  225 6 ---  235 6 --- }
2413: 0025 { 225 6 x--  235 6 x--  224 6 x--  234 6 x-- }
2414: 0025 { 223 6 x--  233 6 x--  222 6 x--  232 6 x-- }
2415: 0025 { 221 6 x--  231 6 x--  220 6 x--  230 6 x-- }
2416: ~
2417: ~
2418: ~
2419: ~
241A: ~
241B: ~
241C: ~
241D: ~
241E: ~
241F: ~
2420: 0025 { 240 6 ---  250 6 ---  241 6 ---  251 6 --- }
2421: 0025 { 242 6 ---  242 6 ---  253 6 ---  253 6 --- }
2422: 0025 { 244 6 ---  254 6 ---  245 6 ---  255 6 --- }
2423: 0025 { 245 6 x--  255 6 x--  244 6 x--  254 6 x-- }
2424: 0025 { 253 6 x--  253 6 x--  242 6 x--  242 6 x-- }
2425: 0025 { 241 6 x--  251 6 x--  240 6 x--  250 6 x-- }
2426: ~
2427: ~
2428: ~
2429: ~
242A: ~
242B: ~
242C: ~
242D: ~
242E: ~
242F: ~
2430: ~
2431: ~
2432: ~
2433: ~
2434: ~
2435: ~
2436: ~
2437: ~
2438: ~
2439: ~
243A: ~
243B: ~
243C: ~
243D: ~
243E: ~
243F: ~
2440: ~
2441: ~
2442: ~
2443: ~
2444: ~
2445: ~
2446: ~
2447: ~
2448: ~
2449: ~
244A: ~
244B: ~
244C: ~
244D: ~
244E: ~
244F: ~
2450: ~
2451: ~
2452: ~
2453: ~
2454: ~
2455: ~
2456: ~
2457: ~
2458: ~
2459: ~
245A: ~
245B: ~
245C: ~
245D: ~
245E: ~
245F: ~
2460: ~
2461: ~
2462: ~
2463: ~
2464: ~
2465: ~
2466: ~
2467: ~
2468: ~
2469: ~
246A: ~
246B: ~
246C: ~
246D: ~
246E: ~
246F: ~
2470: ~
2471: ~
2472: ~
2473: ~
2474: ~
2475: ~
2476: ~
2477: ~
2478: ~
2479: ~
247A: ~
247B: ~
247C: ~
247D: ~
247E: ~
247F: ~
2480: ~
2481: ~
2482: ~
2483: ~
2484: ~
2485: ~
2486: ~
2487: ~
2488: ~
2489: ~
248A: ~
248B: ~
248C: ~
248D: ~
248E: ~
248F: ~
2490: ~
2491: ~
2492: ~
2493: ~
2494: ~
2495: ~
2496: ~
2497: ~
2498: ~
2499: ~
249A: ~
249B: ~
249C: ~
249D: ~
249E: ~
249F: ~
24A0: ~
24A1: ~
24A2: ~
24A3: ~
24A4: ~
24A5: ~
24A6: ~
24A7: ~
24A8: ~
24A9: ~
24AA: ~
24AB: ~
24AC: ~
24AD: ~
24AE: ~
24AF: ~
24B0: ~
24B1: ~
24B2: ~
24B3: ~
24B4: ~
24B5: ~
24B6: ~
24B7: ~
24B8: 01AA { 0F8 0 ---  0F8 0 ---  0F8 0 ---  0F8 0 --- }
24B9: 0100 { 0F8 0 ---  0F8 0 ---  0F8 0 ---  0F8 0 --- }
24BA: 01AF { 0F8 0 ---  0F8 0 ---  0F8 0 ---  0F8 0 --- }
24BB: ~
24BC: ~
24BD: ~
24BE: ~
24BF: ~
24C0: ~
24C1: ~
24C2: ~
24C3: ~
24C4: ~
24C5: ~
24C6: ~
24C7: ~
24C8: 01E2 { 0F8 0 ---  0F8 0 ---  0F8 0 ---  0F8 0 --- }
24C9: 0025 { 230 6 -y-  230 6 -y-  231 6 -y-  231 6 -y- }
24CA: 01E4 { 0F8 0 ---  0F8 0 ---  0F8 0 ---  0F8 0 --- }
24CB: 0025 { 0F8 0 -y-  0F8 0 -y-  0F8 0 -y-  0F8 0 -y- }
24CC: 0130 { 004 4 x--  004 4 x--  004 4 x--  004 4 x-- }
24CD: 0130 { 004 4 x--  004 4 x--  004 4 x--  004 4 x-- }
24CE: 0025 { 0F8 0 -y-  0F8 0 -y-  0F8 0 -y-  0F8 0 -y- }
24CF: ~
24D0: 0025 { 1D3 6 -y-  1C3 6 -y-  1D4 6 -y-  1C4 6 -y- }
24D1: 0025 { 1D3 6 -y-  1C3 6 -y-  1D4 6 -y-  1C4 6 -y- }
24D2: 0025 { 020 7 -y-  020 7 -y-  021 7 -y-  021 7 -y- }
24D3: 0025 { 022 7 -y-  022 7 -y-  023 7 -y-  023 7 -y- }
24D4: 0025 { 06E 6 -y-  06C 6 -y-  06F 6 -y-  06D 6 -y- }
24D5: 0025 { 0D8 6 -y-  0C8 6 -y-  0D9 6 -y-  0C9 6 -y- }
24D6: 0025 { 0F8 2 -y-  00D 6 -y-  0F8 2 -y-  00D 6 -y- }
24D7: 0025 { 230 6 -y-  220 6 -y-  231 6 -y-  221 6 -y- }
24D8: 0025 { 0F8 0 -y-  213 6 -y-  0F8 0 -y-  0F8 0 -y- }
24D9: 0025 { 230 6 -y-  200 6 -y-  231 6 -y-  201 6 -y- }
24DA: 0025 { 0F8 0 xy-  0F8 0 xy-  0F8 0 xy-  213 6 xy- }
24DB: 0025 { 222 6 -y-  202 6 -y-  213 6 -y-  203 6 -y- }
24DC: 0025 { 0F8 0 -y-  213 6 -y-  0F8 0 -y-  0F8 0 -y- }
24DD: 0025 { 0F8 0 xy-  0F8 0 xy-  0F8 0 xy-  213 6 xy- }
24DE: 0025 { 213 6 xy-  203 6 xy-  222 6 xy-  202 6 xy- }
24DF: ~
24E0: 016B { 0F8 0 ---  0F8 0 ---  0F8 0 ---  0F8 0 --- }
24E1: 0124 { 0F8 0 ---  0F8 0 ---  0F8 0 ---  0F8 0 --- }
24E2: 0025 { 010 7 -y-  000 7 -y-  011 7 -y-  001 7 -y- }
24E3: 0025 { 012 7 -y-  002 7 -y-  013 7 -y-  003 7 -y- }
24E4: 002B { 0F8 0 ---  0F8 0 ---  0F8 0 ---  0F8 0 --- }
24E5: 012F { 0F8 0 ---  0F8 0 ---  0F8 0 ---  0F8 0 --- }
24E6: 0106 { 0F8 0 ---  0F8 0 ---  0F8 0 ---  0F8 0 --- }
24E7: 0025 { 210 6 -y-  200 6 -y-  211 6 -y-  201 6 -y- }
24E8: 0025 { 212 6 -y-  202 6 -y-  213 6 -y-  203 6 -y- }
24E9: 0025 { 214 6 -y-  204 6 -y-  214 6 -y-  204 6 -y- }
24EA: 0025 { 213 6 xy-  203 6 xy-  212 6 xy-  202 6 xy- }
24EB: 006E { 0F8 0 ---  0F8 0 ---  0F8 0 ---  0F8 0 --- }
24EC: 0025 { 212 6 -y-  202 6 -y-  213 6 -y-  203 6 -y- }
24ED: 0025 { 213 6 xy-  203 6 xy-  212 6 xy-  202 6 xy- }
24EE: ~
24EF: ~
24F0: 0130 { 180 2 ---  180 3 -y-  183 2 ---  182 3 -y- }
24F1: 0130 { 183 2 ---  182 3 -y-  182 2 ---  183 3 -y- }
24F2: 0130 { 183 2 x--  182 3 xy-  180 2 x--  180 3 xy- }
24F3: 0130 { 0F8 0 ---  0F8 0 ---  0F8 0 ---  0F8 0 --- }
24F4: 0025 { 032 4 -y-  030 4 -y-  033 4 -y-  031 4 -y- }
24F5: 0025 { 032 4 -y-  285 4 -y-  033 4 -y-  286 4 -y- }
24F6: 0025 { 032 4 -y-  285 4 -y-  033 4 -y-  031 4 -y- }
24F7: 0025 { 032 4 -y-  030 4 -y-  033 4 -y-  206 4 -y- }
24F8: 0025 { 214 6 -y-  207 6 -y-  214 6 -y-  204 6 -y- }
24F9: 0025 { 214 6 xy-  204 6 xy-  214 6 xy-  207 6 xy- }
24FA: 0020 { 0F8 0 ---  0F8 0 ---  0F8 0 ---  0F8 0 --- }
24FB: 0130 { 250 6 -y-  240 6 -y-  251 6 -y-  241 6 -y- }
24FC: 0130 { 1D3 6 -y-  1C3 6 -y-  1D4 6 -y-  1C4 6 -y- }
24FD: ~
24FE: ~
24FF: ~
