4000: 0130 { 0FB 3 -yp  04A 3 -yp  0FB 3 -yp  04B 3 -yp }
4001: 0130 { 048 3 x-p  049 3 x-p  04A 3 x-p  0FB 3 x-p }
4002: 0130 { 049 3 x-p  049 3 x-p  0FB 3 x-p  0FB 3 x-p }
4003: 0130 { 049 3 xyp  048 3 xyp  0FB 3 xyp  04A 3 xyp }
4004: 0130 { 0FB 3 -yp  04A 3 -yp  049 3 -yp  048 3 -yp }
4005: 0130 { 04C 3 -yp  0F8 3 -yp  04D 3 -yp  0F8 3 -yp }
4006: 0130 { 04E 3 -yp  04C 3 -yp  04F 3 -yp  04D 3 -yp }
4007: 0130 { 043 3 xyp  041 3 xyp  042 3 xyp  040 3 xyp }
4008: 0130 { 041 3 xyp  0F8 3 -yp  040 3 xyp  0F8 3 -yp }
4009: 0130 { 044 3 -yp  0F8 3 -yp  045 3 -yp  044 3 -yp }
400A: 0130 { 047 3 xyp  046 3 xyp  046 3 xyp  0F8 3 -yp }
400B: 0130 { 0FB 3 -yp  04E 3 -yp  0FB 3 -yp  04F 3 -yp }
400C: 0130 { 0FB 3 -yp  043 3 xyp  0FB 3 -yp  042 3 xyp }
400D: 0130 { 0FB 3 -yp  045 3 -yp  0FB 3 -yp  0FB 3 -yp }
400E: 0130 { 0FB 3 -yp  0FB 3 -yp  0FB 3 -yp  047 3 xyp }
400F: 0130 { 0FB 3 --p  0FB 3 --p  049 3 --p  049 3 --p }
4010: 0130 { 192 2 -y-  194 2 -y-  193 2 -y-  186 2 xy- }
4011: 0130 { 193 2 xy-  186 2 -y-  192 2 xy-  194 2 xy- }
4012: 0130 { 10E 1 ---  0F8 3 -yp  119 1 ---  0F8 3 -yp }
4013: 0130 { 10D 1 ---  0F8 3 -yp  12D 1 ---  0F8 3 -yp }
4014: 0130 { 12C 1 ---  0F8 3 -yp  118 1 ---  0F8 3 -yp }
4015: 0130 { 128 1 ---  0F8 3 -yp  129 1 ---  0F8 3 -yp }
4016: 0130 { 119 1 ---  0F8 3 -yp  0F8 3 -yp  0F8 3 -yp }
4017: 0130 { 10A 1 ---  0F8 3 -yp  11C 1 ---  0F8 3 -yp }
4018: 0130 { 119 1 ---  0F8 3 -yp  11D 1 ---  0F8 3 -yp }
4019: 0130 { 109 1 ---  0F8 3 -yp  10C 1 ---  0F8 3 -yp }
401A: 0130 { 10B 1 ---  0F8 3 -yp  0F8 3 -yp  0F8 3 -yp }
401B: 0130 { 10B 1 ---  0F8 3 -yp  12E 1 ---  0F8 3 -yp }
401C: 0130 { 10A 1 ---  0F8 3 -yp  11B 1 ---  0F8 3 -yp }
401D: 0130 { 11D 1 ---  0F8 3 -yp  128 1 ---  0F8 3 -yp }
401E: 0130 { 12E 1 ---  0F8 3 -yp  11E 1 ---  0F8 3 -yp }
401F: 0130 { 12D 1 ---  0F8 3 -yp  108 1 ---  0F8 3 -yp }
4020: 0130 { 119 1 ---  0F8 3 -yp  11E 1 ---  0F8 3 -yp }
4021: 0130 { 108 1 ---  0F8 3 -yp  11E 1 ---  0F8 3 -yp }
4022: 0130 { 10B 1 ---  0F8 3 -yp  0F8 3 -yp  0F8 3 -yp }
4023: 0130 { 108 1 ---  0F8 3 -yp  11C 1 ---  0F8 3 -yp }
4024: 0130 { 11C 1 ---  0F8 3 -yp  0F8 3 -yp  0F8 3 -yp }
4025: 0130 { 10E 1 ---  0F8 3 -yp  128 1 ---  0F8 3 -yp }
4026: 0130 { 12D 1 ---  0F8 3 -yp  0F8 3 -yp  0F8 3 -yp }
4027: 0130 { 138 1 ---  0F8 3 -yp  108 1 ---  0F8 3 -yp }
4028: 0130 { 12C 1 ---  0F8 3 -yp  0F8 3 -yp  0F8 3 -yp }
4029: 0130 { 12D 1 ---  0F8 3 -yp  118 1 ---  0F8 3 -yp }
402A: 0130 { 119 1 ---  0F8 3 -yp  12C 1 ---  0F8 3 -yp }
402B: 0130 { 12C 1 ---  0F8 3 -yp  10A 1 ---  0F8 3 -yp }
402C: 0130 { 10C 1 ---  0F8 3 -yp  11E 1 ---  0F8 3 -yp }
402D: 0130 { 119 1 ---  0F8 3 -yp  10A 1 ---  0F8 3 -yp }
402E: 0130 { 12F 1 ---  0F8 3 -yp  119 1 ---  0F8 3 -yp }
402F: 0130 { 10C 1 ---  0F8 3 -yp  138 1 ---  0F8 3 -yp }
4030: 0130 { 064 4 ---  182 2 ---  065 4 ---  183 2 --- }
4031: 0130 { 182 2 -y-  066 4 ---  183 2 -y-  067 4 --- }
4032: 0130 { 192 2 -y-  182 2 -y-  186 2 xy-  180 2 xy- }
4033: 0130 { 186 2 -y-  180 2 -y-  192 2 xy-  182 2 xy- }
4034: 0130 { 182 2 ---  192 2 ---  180 2 x--  186 2 x-- }
4035: 0130 { 180 2 ---  186 2 ---  182 2 x--  192 2 x-- }
4036: 0130 { 190 2 ---  186 2 ---  194 2 x--  192 2 x-- }
4037: 0130 { 194 2 ---  192 2 ---  190 2 x--  186 2 x-- }
4038: 0130 { 194 2 ---  192 2 ---  195 2 ---  193 2 --- }
4039: 0130 { 02D 4 ---  02D 4 -y-  02D 4 x--  02D 4 xy- }
403A: 0130 { 064 4 ---  182 2 ---  065 4 ---  183 2 --- }
403B: 0130 { 064 4 ---  066 4 ---  065 4 ---  067 4 --- }
403C: 0130 { 192 2 -y-  182 2 -y-  193 2 -y-  183 2 -y- }
403D: ~
403E: ~
403F: ~
4040: ~
4041: ~
4042: ~
4043: ~
4044: ~
4045: ~
4046: ~
4047: ~
4048: ~
4049: ~
404A: ~
404B: ~
404C: ~
404D: ~
404E: ~
404F: ~
4050: ~
4051: ~
4052: ~
4053: ~
4054: ~
4055: ~
4056: ~
4057: ~
4058: ~
4059: ~
405A: ~
405B: ~
405C: ~
405D: ~
405E: ~
405F: ~
4060: ~
4061: ~
4062: ~
4063: ~
4064: ~
4065: ~
4066: ~
4067: ~
4068: ~
4069: ~
406A: ~
406B: ~
406C: ~
406D: ~
406E: ~
406F: ~
4070: ~
4071: ~
4072: ~
4073: ~
4074: ~
4075: ~
4076: ~
4077: ~
4078: ~
4079: ~
407A: ~
407B: ~
407C: ~
407D: ~
407E: ~
407F: ~
4080: ~
4081: ~
4082: ~
4083: ~
4084: ~
4085: ~
4086: ~
4087: ~
4088: ~
4089: ~
408A: ~
408B: ~
408C: ~
408D: ~
408E: ~
408F: ~
4090: ~
4091: ~
4092: ~
4093: ~
4094: ~
4095: ~
4096: ~
4097: ~
4098: ~
4099: ~
409A: ~
409B: ~
409C: ~
409D: ~
409E: ~
409F: ~
40A0: ~
40A1: ~
40A2: ~
40A3: ~
40A4: ~
40A5: ~
40A6: ~
40A7: ~
40A8: ~
40A9: ~
40AA: ~
40AB: ~
40AC: ~
40AD: ~
40AE: ~
40AF: ~
40B0: ~
40B1: ~
40B2: ~
40B3: ~
40B4: ~
40B5: ~
40B6: ~
40B7: ~
40B8: ~
40B9: ~
40BA: ~
40BB: ~
40BC: ~
40BD: ~
40BE: ~
40BF: ~
40C0: ~
40C1: ~
40C2: ~
40C3: ~
40C4: ~
40C5: ~
40C6: ~
40C7: ~
40C8: ~
40C9: ~
40CA: ~
40CB: ~
40CC: ~
40CD: ~
40CE: ~
40CF: ~
40D0: ~
40D1: ~
40D2: ~
40D3: ~
40D4: ~
40D5: ~
40D6: ~
40D7: ~
40D8: ~
40D9: ~
40DA: ~
40DB: ~
40DC: ~
40DD: ~
40DE: ~
40DF: ~
40E0: ~
40E1: ~
40E2: ~
40E3: ~
40E4: ~
40E5: ~
40E6: ~
40E7: ~
40E8: ~
40E9: ~
40EA: ~
40EB: ~
40EC: ~
40ED: ~
40EE: ~
40EF: ~
40F0: ~
40F1: ~
40F2: ~
40F3: ~
40F4: ~
40F5: ~
40F6: ~
40F7: ~
40F8: ~
40F9: ~
40FA: ~
40FB: ~
40FC: ~
40FD: ~
40FE: ~
40FF: ~
