3400: 0130 { 11B 2 ---  12F 2 ---  11C 2 ---  1E9 2 --- }
3401: 0130 { 11D 2 ---  1EA 2 ---  11E 2 ---  132 2 --- }
3402: 0130 { 11E 2 ---  13B 2 ---  11F 2 ---  13C 2 --- }
3403: 0130 { 120 2 ---  13D 2 ---  11D 2 ---  13D 2 x-- }
3404: 0130 { 11E 2 ---  13D 2 x--  11F 2 ---  13B 2 x-- }
3405: 0130 { 120 2 ---  1EB 2 ---  121 2 ---  1EC 2 --- }
3406: 0130 { 120 2 ---  1ED 2 ---  121 2 ---  1EE 2 --- }
3407: 0130 { 122 2 ---  1EF 2 ---  123 2 ---  137 2 --- }
3408: 0089 { 0F8 5 x--  0F8 5 x--  2CA 5 ---  2DA 5 --- }
3409: 0166 { 2CB 5 ---  2DB 5 ---  2C6 5 ---  2D6 5 --- }
340A: 0167 { 2C7 5 ---  2D7 5 ---  2C8 5 ---  2D8 5 --- }
340B: 008A { 2C9 5 x--  2D9 5 x--  0F8 5 x--  0F8 5 x-- }
340C: 0130 { 1C4 2 ---  297 2 ---  17A 2 ---  298 2 --- }
340D: 0087 { 0F8 5 -y-  2E5 5 -y-  2F6 5 -y-  2E6 5 -y- }
340E: 0088 { 2F7 5 -y-  2E7 5 -y-  0F8 5 -y-  2E8 5 -y- }
340F: 62F0 { 2F5 7 ---  2F0 7 ---  2F8 7 ---  2F1 7 --- }
3410: 0130 { 14F 2 ---  173 2 ---  1F9 2 ---  20D 2 --- }
3411: 0130 { 1FA 2 ---  20E 2 ---  1FB 2 ---  20F 2 --- }
3412: 0130 { 13B 2 ---  13B 2 ---  144 2 ---  13C 2 --- }
3413: 0130 { 13D 2 ---  13E 2 x--  13E 2 ---  13D 2 x-- }
3414: 0130 { 144 2 ---  13C 2 x--  13B 2 x--  13B 2 x-- }
3415: 0130 { 1FC 2 ---  210 2 ---  1FD 2 ---  202 2 --- }
3416: 0130 { 1FE 2 ---  203 2 ---  1FF 2 ---  204 2 --- }
3417: 0130 { 200 2 ---  211 2 ---  156 2 ---  17B 2 --- }
3418: 008B { 0F8 5 x--  0F8 5 x--  2C9 5 ---  2D9 5 --- }
3419: 0166 { 2C5 5 ---  2D5 5 ---  2C6 5 ---  2D6 5 --- }
341A: 0167 { 2C7 5 ---  2D7 5 ---  2CC 5 ---  2DC 5 --- }
341B: 008C { 2CD 5 ---  2DD 5 ---  0F8 5 x--  0F8 5 x-- }
341C: 0089 { 0F8 5 xy-  0F8 5 xy-  2DA 5 -y-  2CA 5 -y- }
341D: 0166 { 2DB 5 -y-  2CB 5 -y-  2D6 5 -y-  2C6 5 -y- }
341E: 0167 { 2D7 5 -y-  2C7 5 -y-  2D8 5 -y-  2C8 5 -y- }
341F: 008A { 2D9 5 xy-  2C9 5 xy-  0F8 5 xy-  0F8 5 xy- }
3420: 0130 { 2C3 2 ---  1A8 2 ---  219 2 ---  13F 2 --- }
3421: 0130 { 1E9 2 ---  140 2 ---  1EA 2 ---  141 2 --- }
3422: 0130 { 13B 2 ---  13B 2 ---  13C 2 ---  144 2 --- }
3423: 0130 { 13D 2 ---  13D 2 ---  13E 2 ---  144 2 --- }
3424: 0130 { 144 2 ---  13B 2 x--  13B 2 x--  224 2 --- }
3425: 0130 { 21A 2 ---  225 2 ---  21B 2 ---  226 2 --- }
3426: 0130 { 21C 2 ---  227 2 ---  21D 2 ---  228 2 --- }
3427: 0130 { 21E 2 ---  229 2 ---  191 2 ---  1AF 2 --- }
3428: 0130 { 1C1 2 ---  29A 2 ---  1C2 2 ---  219 2 --- }
3429: 008D { 2E5 5 ---  0F8 5 ---  2E6 5 ---  2F6 5 --- }
342A: 008E { 2E7 5 ---  2F7 5 ---  2E8 5 ---  0F8 5 --- }
342B: 0130 { 1C3 2 ---  1E9 2 ---  1C4 2 ---  1EA 2 --- }
342C: 008B { 0F8 5 xy-  0F8 5 xy-  2D9 5 -y-  2C9 5 -y- }
342D: 0166 { 2D5 5 -y-  2C5 5 -y-  2D6 5 -y-  2C6 5 -y- }
342E: 0167 { 2D7 5 -y-  2C7 5 -y-  2DC 5 -y-  2CC 5 -y- }
342F: 008C { 2DD 5 -y-  2CD 5 -y-  0F8 5 xy-  0F8 5 xy- }
3430: 0130 { 1BE 2 ---  246 2 ---  15E 2 ---  13F 2 --- }
3431: 0130 { 15F 2 ---  140 2 ---  160 2 ---  141 2 --- }
3432: 0130 { 137 2 ---  156 2 ---  1F0 2 ---  201 2 --- }
3433: 0130 { 236 2 ---  247 2 ---  237 2 ---  248 2 --- }
3434: 0130 { 236 2 ---  247 2 ---  238 2 ---  249 2 --- }
3435: 0130 { 239 2 ---  24A 2 ---  23A 2 ---  24B 2 --- }
3436: 0130 { 23B 2 ---  24C 2 ---  23C 2 ---  24D 2 --- }
3437: 0130 { 23D 2 ---  24E 2 ---  1C5 2 ---  24F 2 --- }
3438: 0130 { 128 2 ---  13B 2 ---  125 2 ---  13C 2 --- }
3439: 0130 { 126 2 ---  13D 2 ---  125 2 ---  13E 2 --- }
343A: 0130 { 126 2 ---  13F 2 ---  127 2 ---  140 2 --- }
343B: 0130 { 125 2 ---  141 2 ---  126 2 ---  142 2 --- }
343C: 0130 { 127 2 ---  143 2 ---  125 2 ---  144 2 --- }
343D: 0130 { 126 2 ---  145 2 ---  124 2 x--  146 2 --- }
343E: 0130 { 124 2 ---  146 2 x--  126 2 x--  145 2 x-- }
343F: 0130 { 2E2 3 ---  2F2 3 ---  2E3 3 ---  2F3 3 --- }
3440: 0130 { 138 2 ---  2C3 2 ---  15E 2 ---  210 2 --- }
3441: 0130 { 15F 2 ---  202 2 ---  160 2 ---  203 2 --- }
3442: 0130 { 17B 2 ---  204 2 ---  212 2 ---  220 2 --- }
3443: 0130 { 25E 2 ---  26C 2 ---  25F 2 ---  26D 2 --- }
3444: 0130 { 25E 2 ---  26C 2 ---  260 2 ---  26E 2 --- }
3445: 0130 { 261 2 ---  26F 2 ---  254 2 ---  270 2 --- }
3446: 0130 { 255 2 ---  22B 2 ---  262 2 ---  271 2 --- }
3447: 0130 { 263 2 ---  272 2 ---  156 2 ---  17B 2 --- }
3448: 0130 { 15A 2 ---  13B 2 ---  15B 2 ---  13C 2 --- }
3449: 0130 { 15C 2 ---  13B 2 ---  15D 2 ---  13C 2 --- }
344A: 0130 { 15E 2 ---  124 2 -y-  15F 2 ---  13E 2 --- }
344B: 0130 { 160 2 ---  144 2 ---  161 2 ---  145 2 --- }
344C: 0130 { 162 2 ---  146 2 ---  163 2 ---  17D 2 --- }
344D: 0130 { 164 2 ---  143 2 ---  165 2 ---  165 2 -y- }
344E: 0130 { 165 2 x--  165 2 xy-  164 2 x--  143 2 x-- }
344F: 0159 { 2CE 6 ---  2DE 6 ---  2CF 6 ---  2DF 6 --- }
3450: 0130 { 1A8 2 ---  12F 2 ---  21A 2 ---  225 2 --- }
3451: 0130 { 21B 2 ---  226 2 ---  21C 2 ---  227 2 --- }
3452: 0130 { 21F 2 ---  228 2 ---  27B 2 ---  28A 2 --- }
3453: 0130 { 251 2 ---  28B 2 ---  252 2 ---  28C 2 --- }
3454: 0130 { 253 2 ---  28D 2 ---  27C 2 ---  28B 2 --- }
3455: 0130 { 27D 2 ---  28C 2 ---  27E 2 ---  28D 2 --- }
3456: 0130 { 27F 2 ---  262 2 ---  280 2 ---  263 2 --- }
3457: 0130 { 281 2 ---  27B 2 ---  156 2 ---  17B 2 --- }
3458: 0130 { 284 2 ---  290 2 ---  285 2 ---  291 2 --- }
3459: 0130 { 286 2 ---  292 2 ---  287 2 ---  293 2 --- }
345A: 0130 { 288 2 ---  294 2 ---  289 2 ---  295 2 --- }
345B: ~
345C: ~
345D: ~
345E: ~
345F: ~
3460: 0130 { 14F 2 ---  138 2 ---  210 2 ---  21A 2 --- }
3461: 0130 { 202 2 ---  21B 2 ---  203 2 ---  21C 2 --- }
3462: 0130 { 204 2 ---  21F 2 ---  296 2 ---  2A3 2 --- }
3463: 0130 { 297 2 ---  2A4 2 ---  298 2 ---  2A5 2 --- }
3464: 0130 { 299 2 ---  2A6 2 ---  297 2 ---  2A4 2 --- }
3465: 0130 { 298 2 ---  2A5 2 ---  299 2 ---  2A6 2 --- }
3466: 0130 { 271 2 ---  280 2 ---  272 2 ---  281 2 --- }
3467: 0130 { 28A 2 ---  296 2 ---  191 2 ---  1AF 2 --- }
3468: 0130 { 29D 2 ---  275 2 ---  29E 2 ---  276 2 --- }
3469: 0130 { 29F 2 ---  277 2 ---  2A0 2 ---  278 2 --- }
346A: 0130 { 2A1 2 ---  279 2 ---  2A2 2 ---  27A 2 --- }
346B: ~
346C: ~
346D: ~
346E: 0130 { 117 2 ---  12B 2 ---  118 2 ---  12C 2 --- }
346F: 0130 { 119 2 ---  12D 2 ---  11A 2 ---  12E 2 --- }
3470: 0130 { 2C3 2 ---  11B 2 -y-  225 2 ---  13C 2 --- }
3471: 0130 { 226 2 ---  13D 2 ---  227 2 ---  13E 2 --- }
3472: 0130 { 228 2 ---  144 2 ---  2AB 2 ---  145 2 --- }
3473: 0130 { 2AC 2 ---  146 2 ---  238 2 ---  13D 2 --- }
3474: 0130 { 2AD 2 ---  13E 2 ---  2AC 2 ---  144 2 --- }
3475: 0130 { 238 2 ---  145 2 ---  2AD 2 ---  146 2 --- }
3476: 0130 { 221 2 -y-  17D 2 ---  29A 2 -y-  143 2 --- }
3477: 0130 { 2A3 2 ---  1D9 2 ---  1C5 2 ---  165 2 -y- }
3478: 0130 { 2B1 2 ---  2BD 2 ---  2B2 2 ---  2BE 2 --- }
3479: 0130 { 2B3 2 ---  2BF 2 ---  2B4 2 ---  2C0 2 --- }
347A: 0130 { 2B5 2 ---  2C1 2 ---  2B6 2 ---  2C2 2 --- }
347B: ~
347C: ~
347D: ~
347E: 0130 { 14B 2 ---  16F 2 ---  14C 2 ---  170 2 --- }
347F: 0130 { 14D 2 ---  171 2 ---  14E 2 ---  172 2 --- }
3480: 0130 { 11B 2 ---  12F 2 ---  11C 2 ---  130 2 --- }
3481: 0130 { 11D 2 ---  131 2 ---  11E 2 ---  132 2 --- }
3482: 0130 { 11F 2 ---  133 2 ---  120 2 ---  134 2 --- }
3483: 0130 { 121 2 ---  131 2 ---  122 2 ---  135 2 --- }
3484: 0130 { 11D 2 ---  131 2 ---  11E 2 ---  132 2 --- }
3485: 0130 { 11F 2 ---  133 2 ---  120 2 ---  134 2 --- }
3486: 0130 { 120 2 ---  136 2 ---  121 2 ---  135 2 --- }
3487: 0130 { 122 2 ---  135 2 ---  123 2 ---  137 2 --- }
3488: 0025 { 11B 1 ---  12F 1 ---  11C 1 ---  1E9 1 --- }
3489: 0025 { 11D 1 ---  1EA 1 ---  11E 1 ---  132 1 --- }
348A: 0025 { 11E 1 ---  13B 1 ---  11F 1 ---  13C 1 --- }
348B: 0025 { 120 1 ---  13D 1 ---  11D 1 ---  13D 1 x-- }
348C: 0025 { 11E 1 ---  13D 1 x--  11F 1 ---  13B 1 x-- }
348D: 0025 { 120 1 ---  1EB 1 ---  121 1 ---  1EC 1 --- }
348E: 0025 { 120 1 ---  1ED 1 ---  121 1 ---  1EE 1 --- }
348F: 0025 { 122 1 ---  1EF 1 ---  123 1 ---  137 1 --- }
3490: 0130 { 14F 2 ---  173 2 ---  150 2 ---  174 2 --- }
3491: 0130 { 151 2 ---  175 2 ---  152 2 ---  176 2 --- }
3492: 0130 { 153 2 ---  177 2 ---  154 2 ---  178 2 --- }
3493: 0130 { 155 2 ---  179 2 ---  202 2 ---  1C4 2 --- }
3494: 0130 { 202 2 ---  17A 2 ---  203 2 ---  151 2 --- }
3495: 0130 { 204 2 ---  152 2 ---  155 2 ---  153 2 --- }
3496: 0130 { 1FE 2 ---  154 2 ---  1FF 2 ---  155 2 --- }
3497: 0130 { 155 2 ---  1FE 2 ---  156 2 ---  17B 2 --- }
3498: 0025 { 2C3 1 ---  11B 1 -y-  225 1 ---  13C 1 --- }
3499: 0025 { 226 1 ---  13D 1 ---  227 1 ---  13E 1 --- }
349A: 0025 { 228 1 ---  144 1 ---  2AB 1 ---  145 1 --- }
349B: 0025 { 2AC 1 ---  146 1 ---  238 1 ---  13D 1 --- }
349C: 0025 { 2AD 1 ---  13E 1 ---  2AC 1 ---  144 1 --- }
349D: 0025 { 238 1 ---  145 1 ---  2AD 1 ---  146 1 --- }
349E: 0025 { 221 1 -y-  17D 1 ---  29A 1 -y-  143 1 --- }
349F: 0025 { 2A3 1 ---  1D9 1 ---  1C5 1 ---  165 1 -y- }
34A0: 0130 { 2C3 2 ---  1A8 2 ---  2C4 2 ---  1A9 2 --- }
34A1: 0130 { 18C 2 ---  1AA 2 ---  18D 2 ---  1AB 2 --- }
34A2: 0130 { 18E 2 ---  1AC 2 ---  18F 2 ---  1AD 2 --- }
34A3: 0130 { 190 2 ---  1AE 2 ---  1EA 2 ---  22B 2 --- }
34A4: 0130 { 221 2 ---  22C 2 ---  175 2 ---  18C 2 --- }
34A5: 0130 { 176 2 ---  18D 2 ---  177 2 ---  18E 2 --- }
34A6: 0130 { 178 2 ---  18F 2 ---  179 2 ---  190 2 --- }
34A7: 0130 { 203 2 ---  22D 2 ---  191 2 ---  1AF 2 --- }
34A8: ~
34A9: ~
34AA: ~
34AB: ~
34AC: ~
34AD: ~
34AE: 0130 { 186 2 ---  1A4 2 ---  187 2 ---  1A5 2 --- }
34AF: 0130 { 188 2 ---  1A6 2 ---  189 2 ---  1A7 2 --- }
34B0: 0130 { 1BE 2 ---  246 2 ---  1BF 2 ---  250 2 --- }
34B1: 0130 { 1C0 2 ---  251 2 ---  1C1 2 ---  252 2 --- }
34B2: 0130 { 1C2 2 ---  253 2 ---  1C3 2 ---  151 2 --- }
34B3: 0130 { 1C4 2 ---  152 2 ---  17A 2 ---  153 2 --- }
34B4: 0130 { 1C1 2 ---  154 2 ---  1AA 2 ---  17A 2 --- }
34B5: 0130 { 1AB 2 ---  1C1 2 ---  1AC 2 ---  1C2 2 --- }
34B6: 0130 { 1AD 2 ---  1C3 2 ---  1AE 2 ---  1C4 2 --- }
34B7: 0130 { 22C 2 ---  23B 2 ---  1C5 2 ---  24F 2 --- }
34B8: ~
34B9: ~
34BA: ~
34BB: ~
34BC: ~
34BD: ~
34BE: 0130 { 1BA 2 ---  1D4 2 ---  1BB 2 ---  1D5 2 --- }
34BF: 0130 { 1BC 2 ---  1D6 2 ---  1BD 2 ---  1D7 2 --- }
34C0: 0130 { 138 2 ---  2C3 2 ---  15E 2 ---  210 2 --- }
34C1: 0130 { 15F 2 ---  202 2 ---  160 2 ---  203 2 --- }
34C2: 0130 { 17B 2 ---  204 2 ---  175 2 ---  18C 2 --- }
34C3: 0130 { 176 2 ---  18D 2 ---  177 2 ---  18E 2 --- }
34C4: 0130 { 178 2 ---  18F 2 ---  179 2 ---  190 2 --- }
34C5: 0130 { 151 2 ---  175 2 ---  152 2 ---  176 2 --- }
34C6: 0130 { 153 2 ---  177 2 ---  154 2 ---  178 2 --- }
34C7: 0130 { 155 2 ---  179 2 ---  156 2 ---  17B 2 --- }
34C8: 0130 { 11B 2 ---  12F 2 ---  11C 2 ---  130 2 --- }
34C9: 0130 { 11D 2 ---  131 2 ---  11E 2 ---  132 2 --- }
34CA: 0130 { 11F 2 ---  133 2 ---  120 2 ---  134 2 --- }
34CB: 0130 { 121 2 ---  131 2 ---  122 2 ---  135 2 --- }
34CC: 0130 { 11D 2 ---  131 2 ---  11E 2 ---  132 2 --- }
34CD: 0130 { 11F 2 ---  133 2 ---  120 2 ---  134 2 --- }
34CE: 0130 { 121 2 ---  136 2 ---  122 2 ---  135 2 --- }
34CF: 0130 { 11D 2 ---  131 2 ---  123 2 ---  137 2 --- }
34D0: 0130 { 1A8 2 ---  12F 2 ---  151 2 ---  175 2 --- }
34D1: 0130 { 152 2 ---  176 2 ---  153 2 ---  177 2 --- }
34D2: 0130 { 154 2 ---  178 2 ---  1AA 2 ---  179 2 --- }
34D3: 0130 { 1AB 2 ---  1C1 2 ---  1AC 2 ---  1C2 2 --- }
34D4: 0130 { 1AD 2 ---  1C3 2 ---  1AE 2 ---  1C4 2 --- }
34D5: 0130 { 18C 2 ---  1AA 2 ---  18D 2 ---  1AB 2 --- }
34D6: 0130 { 18E 2 ---  1AC 2 ---  18F 2 ---  1AD 2 --- }
34D7: 0130 { 190 2 ---  1AE 2 ---  191 2 ---  1AF 2 --- }
34D8: 0130 { 14F 2 ---  173 2 ---  150 2 ---  174 2 --- }
34D9: 0130 { 151 2 ---  175 2 ---  152 2 ---  176 2 --- }
34DA: 0130 { 153 2 ---  177 2 ---  154 2 ---  178 2 --- }
34DB: 0130 { 155 2 ---  179 2 ---  151 2 ---  175 2 --- }
34DC: 0130 { 151 2 ---  17A 2 ---  151 2 ---  175 2 --- }
34DD: 0130 { 152 2 ---  176 2 ---  153 2 ---  177 2 --- }
34DE: 0130 { 154 2 ---  178 2 ---  155 2 ---  179 2 --- }
34DF: 0130 { 151 2 ---  17A 2 ---  156 2 ---  17B 2 --- }
34E0: 0130 { 246 2 ---  246 2 ---  18C 2 ---  1AA 2 --- }
34E1: 0130 { 18D 2 ---  1AB 2 ---  18E 2 ---  1AC 2 --- }
34E2: 0130 { 18F 2 ---  1AD 2 ---  190 2 ---  1AE 2 --- }
34E3: 0130 { 1C1 2 ---  29A 2 ---  1C2 2 ---  219 2 --- }
34E4: 0130 { 1C3 2 ---  1E9 2 ---  1C4 2 ---  1EA 2 --- }
34E5: 0130 { 17A 2 ---  221 2 ---  1C1 2 ---  29A 2 --- }
34E6: 0130 { 1C2 2 ---  219 2 ---  1C3 2 ---  1E9 2 --- }
34E7: 0130 { 1C4 2 ---  1EA 2 ---  1C5 2 ---  24F 2 --- }
34E8: 0130 { 2C3 2 ---  1A8 2 ---  2C4 2 ---  1A9 2 --- }
34E9: 0130 { 18C 2 ---  1AA 2 ---  18D 2 ---  1AB 2 --- }
34EA: 0130 { 18E 2 ---  1AC 2 ---  18F 2 ---  1AD 2 --- }
34EB: 0130 { 190 2 ---  1AE 2 ---  17A 2 ---  151 2 --- }
34EC: 0130 { 17A 2 ---  17A 2 ---  18C 2 ---  1AA 2 --- }
34ED: 0130 { 18D 2 ---  1AB 2 ---  18E 2 ---  1AC 2 --- }
34EE: 0130 { 18F 2 ---  1AD 2 ---  190 2 ---  1AE 2 --- }
34EF: 0130 { 17A 2 ---  17A 2 ---  191 2 ---  1AF 2 --- }
34F0: 0130 { 138 2 ---  1D8 2 ---  17A 2 ---  13D 2 --- }
34F1: 0130 { 1C1 2 ---  13C 2 ---  1C2 2 ---  13D 2 --- }
34F2: 0130 { 1C3 2 ---  13C 2 ---  1C4 2 ---  13D 2 --- }
34F3: 0130 { 27D 2 -y-  13E 2 ---  2AE 2 ---  144 2 --- }
34F4: 0130 { 270 2 ---  1D9 2 ---  22B 2 ---  13D 2 --- }
34F5: 0130 { 22C 2 ---  13C 2 ---  27C 2 -y-  13D 2 --- }
34F6: 0130 { 2A7 2 ---  143 2 ---  1F9 2 ---  1D9 2 --- }
34F7: 0130 { 1FA 2 ---  1D9 2 ---  2A8 2 ---  165 2 -y- }
34F8: 0130 { 1BE 2 ---  1D8 2 ---  1BF 2 ---  13D 2 --- }
34F9: 0130 { 1C0 2 ---  13C 2 ---  1C1 2 ---  13D 2 --- }
34FA: 0130 { 1C2 2 ---  13E 2 ---  1C3 2 ---  144 2 --- }
34FB: 0130 { 1C4 2 ---  145 2 ---  17A 2 ---  146 2 --- }
34FC: 0130 { 1C1 2 ---  17D 2 ---  17A 2 ---  143 2 --- }
34FD: 0130 { 1C1 2 ---  1D9 2 ---  1C2 2 ---  13D 2 --- }
34FE: 0130 { 1C3 2 ---  13C 2 ---  1C4 2 ---  13D 2 --- }
34FF: 0130 { 1C1 2 ---  17D 2 ---  1C5 2 ---  165 2 -y- }
