3F00: 0130 { 0F8 0 ---  0F8 0 ---  0F8 0 ---  0F8 0 --- }
3F01: 0130 { 153 0 ---  154 0 ---  0F9 0 ---  155 0 --- }
3F02: 0130 { 0F9 0 ---  155 0 ---  0F9 0 ---  155 0 --- }
3F03: 0130 { 0F9 0 ---  155 0 ---  153 0 x--  156 0 --- }
3F04: 0130 { 0F8 0 ---  106 0 ---  100 0 ---  107 0 --- }
3F05: 0130 { 101 0 ---  0FC 0 ---  102 0 ---  0FC 0 --- }
3F06: 0130 { 103 0 ---  0FC 0 ---  104 0 ---  108 0 --- }
3F07: 0130 { 105 0 ---  109 0 ---  0F8 0 ---  10A 0 --- }
3F08: 0130 { 10B 0 ---  10E 0 ---  0FC 0 ---  0FC 0 --- }
3F09: 0130 { 0FC 0 ---  0FC 0 ---  0FC 0 ---  0FC 0 --- }
3F0A: 0130 { 10C 0 ---  10F 0 ---  10D 0 ---  110 0 --- }
3F0B: 0130 { 111 0 ---  111 0 ---  0FC 0 ---  0FC 0 --- }
3F0C: 0130 { 114 0 ---  114 0 -y-  0FC 0 ---  0FC 0 --- }
3F0D: 0130 { 112 0 ---  112 0 ---  113 0 ---  113 0 --- }
3F0E: 0130 { 0FC 0 ---  0FC 0 ---  114 0 ---  114 0 -y- }
3F0F: 0130 { 0F8 0 ---  127 0 ---  123 0 ---  0FF 0 --- }
3F10: 0130 { 124 0 ---  0FF 0 ---  125 0 ---  0FF 0 --- }
3F11: 0130 { 126 0 ---  128 0 ---  0F8 0 ---  129 0 --- }
3F12: 0130 { 12A 0 ---  12D 0 ---  0FF 0 ---  0FF 0 --- }
3F13: 0130 { 0FF 0 ---  0FF 0 ---  130 0 ---  130 0 -y- }
3F14: 0130 { 12B 0 ---  12E 0 ---  12C 0 ---  12F 0 --- }
3F15: 0130 { 118 1 ---  0FC 1 ---  119 1 ---  108 1 --- }
3F16: 0130 { 11A 1 ---  11D 1 ---  0FF 1 ---  11E 1 --- }
3F17: 0130 { 0F9 0 ---  155 0 ---  157 0 x--  159 0 --- }
3F18: 0130 { 12E 0 ---  12E 0 ---  12F 0 ---  12F 0 --- }
3F19: 0130 { 10C 1 ---  10F 1 ---  120 1 ---  122 1 --- }
3F1A: 0130 { 0FF 1 ---  11B 1 ---  115 1 ---  11C 1 --- }
3F1B: 0130 { 116 1 ---  0FC 1 ---  117 1 ---  0FC 1 --- }
3F1C: 0130 { 118 0 ---  0FC 0 ---  119 0 ---  108 0 --- }
3F1D: 0130 { 11A 0 ---  11D 0 ---  0FF 0 ---  11E 0 --- }
3F1E: 0130 { 11F 1 ---  121 1 ---  0FC 1 ---  0FC 1 --- }
3F1F: 0130 { 10C 0 ---  10F 0 ---  120 0 ---  122 0 --- }
3F20: 0130 { 116 0 ---  0FC 0 ---  117 0 ---  0FC 0 --- }
3F21: 0130 { 144 1 ---  146 1 ---  145 1 ---  0F9 1 --- }
3F22: 0130 { 0F9 0 ---  0F9 0 ---  0F9 0 ---  0F9 0 --- }
3F23: 0130 { 145 1 x--  0F9 1 ---  144 1 x--  146 1 x-- }
3F24: 0130 { 14D 0 ---  14F 0 ---  13D 0 ---  150 0 --- }
3F25: 0130 { 13D 0 ---  141 0 ---  13D 0 ---  141 0 --- }
3F26: 0130 { 13D 0 ---  151 0 ---  14E 0 ---  152 0 --- }
3F27: 0130 { 12D 0 ---  12D 0 ---  0FF 0 ---  0FF 0 --- }
3F28: 0130 { 0FF 0 ---  0FF 0 ---  0FF 0 ---  0FF 0 --- }
3F29: 0130 { 12D 0 ---  12D 0 ---  130 0 ---  130 0 -y- }
3F2A: 0130 { 0FF 0 ---  11B 0 ---  115 0 ---  11C 0 --- }
3F2B: 0130 { 11F 0 ---  121 0 ---  0FC 0 ---  0FC 0 --- }
3F2C: 0130 { 157 0 ---  158 0 ---  0F9 0 ---  155 0 --- }
3F2D: 0130 { 139 0 ---  13B 0 ---  13A 0 ---  0F9 0 --- }
3F2E: 0130 { 13C 0 ---  13F 0 ---  13D 0 ---  140 0 --- }
3F2F: 0130 { 15B 0 ---  0F8 0 ---  15C 0 ---  0F8 0 --- }
3F30: 0025 { 275 7 ---  275 7 ---  246 7 ---  247 7 --- }
3F31: 0025 { 240 7 ---  240 7 ---  240 7 x--  240 7 x-- }
3F32: 0025 { 240 7 ---  240 7 ---  21D 7 ---  277 7 --- }
3F33: 0025 { 240 7 ---  240 7 ---  277 7 ---  277 7 --- }
3F34: 0025 { 277 7 x--  277 7 x--  240 7 ---  240 7 --- }
3F35: 0025 { 277 7 ---  277 7 ---  245 7 x--  240 7 x-- }
3F36: 0025 { 277 7 x--  277 7 x--  240 7 x--  240 7 x-- }
3F37: 0025 { 250 7 ---  250 7 ---  250 7 x--  250 7 x-- }
3F38: 0025 { 272 7 x--  272 7 ---  250 7 ---  250 7 --- }
3F39: 0025 { 240 7 ---  265 7 ---  240 7 x--  265 7 x-- }
3F3A: 0025 { 277 7 ---  245 7 x--  260 7 x--  261 7 x-- }
3F3B: 0025 { 277 7 ---  21D 7 ---  240 7 x--  240 7 x-- }
3F3C: 0025 { 275 7 ---  275 7 ---  240 7 ---  240 7 --- }
3F3D: 0025 { 275 7 ---  275 7 ---  275 7 ---  275 7 --- }
3F3E: 0025 { 241 7 ---  243 7 ---  242 7 ---  244 7 --- }
3F3F: 0025 { 277 7 ---  277 7 ---  240 7 ---  265 7 --- }
3F40: 0025 { 277 7 x--  277 7 x--  240 7 x--  240 7 x-- }
3F41: 0025 { 21E 7 x--  272 7 x--  250 7 ---  250 7 --- }
3F42: 0025 { 245 7 ---  240 7 ---  277 7 x--  277 7 x-- }
3F43: 0025 { 240 7 x--  240 7 x--  277 7 ---  277 7 --- }
3F44: 0025 { 242 7 x--  244 7 x--  241 7 x--  243 7 x-- }
3F45: 0025 { 240 7 ---  266 7 ---  240 7 x--  266 7 x-- }
3F46: 0025 { 240 7 ---  240 7 ---  277 7 ---  245 7 x-- }
3F47: 0025 { 260 7 x--  261 7 x--  277 7 ---  277 7 --- }
3F48: 0025 { 240 7 x--  240 7 x--  275 7 x--  275 7 x-- }
3F49: 0025 { 275 7 x--  258 7 ---  275 7 x--  258 7 x-- }
3F4A: 0025 { 275 7 x--  253 7 ---  275 7 x--  275 7 x-- }
3F4B: 0025 { 277 7 ---  277 7 ---  21D 7 ---  277 7 --- }
3F4C: 0025 { 250 7 ---  267 7 ---  250 7 x--  267 7 x-- }
3F4D: 0025 { 246 7 x--  247 7 x--  275 7 x--  275 7 x-- }
3F4E: 0025 { 21F 7 ---  21F 7 -y-  21F 7 x--  21F 7 xy- }
3F4F: 0025 { 250 7 ---  250 7 ---  275 7 ---  275 7 --- }
3F50: 0025 { 260 7 ---  261 7 ---  277 7 x--  245 7 --- }
3F51: 0025 { 272 7 x--  272 7 ---  272 7 ---  272 7 --- }
3F52: 0025 { 21C 7 ---  21C 7 -y-  21C 7 x--  21C 7 xy- }
3F53: 0025 { 275 7 ---  275 7 ---  275 7 ---  253 7 x-- }
3F54: 0025 { 272 7 x--  259 7 xy-  250 7 ---  253 7 -y- }
3F55: 0025 { 275 7 x--  258 7 ---  250 7 x--  25A 7 x-- }
3F56: 0025 { 277 7 x--  277 7 x--  277 7 ---  277 7 --- }
3F57: 0025 { 277 7 x--  245 7 ---  277 7 ---  277 7 --- }
3F58: 0025 { 275 7 x--  275 7 x--  250 7 x--  250 7 x-- }
3F59: 0025 { 277 7 ---  245 7 x--  246 7 x--  247 7 x-- }
3F5A: 0025 { 258 7 -y-  275 7 xy-  258 7 xy-  275 7 xy- }
3F5B: 0025 { 253 7 -y-  275 7 xy-  275 7 xy-  275 7 xy- }
3F5C: 0025 { 253 7 x--  250 7 x--  258 7 ---  272 7 --- }
3F5D: 0025 { 25A 7 -y-  250 7 -y-  258 7 xy-  275 7 -y- }
3F5E: 0025 { 255 7 ---  256 7 ---  275 7 x--  253 7 --- }
3F5F: 0025 { 250 7 xy-  250 7 xy-  272 7 -y-  21E 7 -y- }
3F60: 0025 { 272 7 ---  272 7 x--  255 7 ---  256 7 --- }
3F61: 0025 { 275 7 ---  253 7 ---  250 7 x--  250 7 x-- }
3F62: 0025 { 250 7 x--  259 7 ---  272 7 ---  272 7 x-- }
3F63: 0025 { 250 7 ---  25A 7 ---  275 7 ---  258 7 x-- }
3F64: 0025 { 266 7 -y-  240 7 -y-  266 7 xy-  240 7 xy- }
3F65: 0025 { 267 7 -y-  250 7 -y-  267 7 xy-  250 7 xy- }
3F66: 0025 { 277 7 x--  245 7 ---  240 7 x--  240 7 x-- }
3F67: 0025 { 275 7 -y-  275 7 -y-  253 7 xy-  275 7 -y- }
3F68: 0025 { 250 7 -y-  250 7 -y-  275 7 xy-  253 7 x-- }
3F69: 0025 { 253 7 -y-  275 7 -y-  250 7 xy-  250 7 xy- }
3F6A: 0025 { 250 7 -y-  250 7 -y-  253 7 xy-  253 7 x-- }
3F6B: 0025 { 253 7 -y-  253 7 ---  250 7 xy-  250 7 xy- }
3F6C: 0025 { 275 7 -y-  275 7 -y-  253 7 xy-  253 7 x-- }
3F6D: 0025 { 253 7 -y-  253 7 ---  275 7 xy-  275 7 xy- }
3F6E: 0025 { 253 7 -y-  275 7 -y-  253 7 xy-  253 7 x-- }
3F6F: 0025 { 253 7 -y-  253 7 ---  253 7 xy-  275 7 xy- }
3F70: 0100 { 002 7 ---  012 7 ---  003 7 ---  013 7 --- }
3F71: 0025 { 012 7 ---  014 7 ---  013 7 ---  015 7 --- }
3F72: 0025 { 253 7 -y-  275 7 -y-  250 7 xy-  250 7 x-- }
3F73: 0025 { 253 7 -y-  275 7 -y-  253 7 xy-  275 7 x-- }
3F74: 0025 { 259 7 x--  272 7 xy-  253 7 ---  259 7 x-- }
3F75: 0025 { 259 7 x--  272 7 ---  253 7 ---  250 7 --- }
3F76: 0025 { 272 7 x--  267 7 -y-  272 7 ---  267 7 xy- }
3F77: 0025 { 259 7 ---  272 7 ---  272 7 ---  272 7 -y- }
3F78: 0025 { 250 7 -y-  250 7 -y-  253 7 xy-  275 7 xy- }
3F79: 0025 { 275 7 xy-  275 7 xy-  247 7 -y-  246 7 -y- }
3F7A: 0025 { 245 7 -y-  21D 7 ---  240 7 x--  240 7 x-- }
3F7B: 0025 { 272 7 -y-  272 7 -y-  267 7 -y-  250 7 -y- }
3F7C: 0025 { 272 7 -y-  21E 7 -y-  267 7 -y-  250 7 -y- }
3F7D: 0025 { 240 7 x--  240 7 x--  275 7 x--  253 7 x-- }
3F7E: 0025 { 246 7 x--  247 7 x--  250 7 x--  250 7 x-- }
3F7F: 0025 { 275 7 ---  253 7 ---  275 7 x--  253 7 x-- }
3F80: 0130 { 000 7 ---  010 7 ---  003 7 ---  013 7 --- }
3F81: 0130 { 003 7 x--  013 7 x--  000 7 x--  010 7 x-- }
3F82: 01AA { 0F8 7 ---  016 7 ---  007 7 ---  017 7 --- }
3F83: 01AF { 007 7 x--  017 7 x--  0F8 7 x--  016 7 x-- }
3F84: 01E4 { 027 7 ---  014 7 ---  013 7 ---  015 7 --- }
3F85: 01E2 { 013 7 x--  015 7 x--  027 7 x--  014 7 x-- }
3F86: 0130 { 004 7 ---  010 7 ---  015 7 ---  013 7 --- }
3F87: 0130 { 015 7 x--  013 7 x--  004 7 x--  010 7 x-- }
3F88: 0025 { 259 7 -y-  253 7 xy-  272 7 ---  259 7 -y- }
3F89: 0025 { 250 7 ---  250 7 ---  275 7 x--  253 7 x-- }
3F8A: 0025 { 253 7 -y-  266 7 -y-  275 7 xy-  266 7 xy- }
3F8B: 0025 { 275 7 -y-  266 7 -y-  253 7 xy-  266 7 xy- }
3F8C: 0025 { 253 7 -y-  266 7 -y-  253 7 xy-  266 7 xy- }
3F8D: 0025 { 253 7 -y-  275 7 -y-  253 7 xy-  275 7 xy- }
3F8E: 0025 { 250 7 ---  268 7 ---  250 7 x--  268 7 x-- }
3F8F: 0025 { 253 7 x--  250 7 x--  256 7 x--  272 7 --- }
3F90: 0100 { 001 7 ---  040 7 ---  003 7 ---  013 7 --- }
3F91: 0100 { 003 7 x--  013 7 x--  001 7 x--  040 7 x-- }
3F92: 0025 { 050 7 ---  040 7 ---  014 7 ---  013 7 --- }
3F93: 0025 { 014 7 x--  013 7 x--  050 7 x--  040 7 x-- }
3F94: 012F { 05F 5 xy-  05D 5 xy-  05E 5 xy-  05C 5 xy- }
3F95: 012F { 2E8 5 ---  2F8 5 ---  2E9 5 ---  2F9 5 --- }
3F96: 0159 { 04A 0 --p  0FB 0 --p  04B 0 --p  0FB 0 --p }
3F97: 01FF { 0FB 0 --p  0FB 0 --p  0FB 0 --p  0FB 0 --p }
3F98: 0031 { 0F8 2 -y-  0F8 2 -y-  077 2 -y-  075 2 -y- }
3F99: 0032 { 074 1 --p  075 1 --p  0F8 1 ---  0F8 1 --- }
3F9A: 0025 { 250 7 ---  25A 7 ---  275 7 ---  258 7 x-- }
3F9B: 0025 { 240 7 ---  240 7 ---  245 7 xy-  277 7 --- }
3F9C: 0025 { 261 7 xy-  260 7 xy-  277 7 -y-  277 7 -y- }
3F9D: 0025 { 240 7 -y-  245 7 -y-  277 7 xy-  277 7 xy- }
3F9E: 0025 { 243 7 -y-  241 7 -y-  244 7 -y-  242 7 -y- }
3F9F: 0025 { 275 7 -y-  275 7 -y-  247 7 -y-  246 7 -y- }
3FA0: 0130 { 010 7 -y-  000 7 -y-  013 7 -y-  003 7 -y- }
3FA1: 0130 { 012 7 -y-  002 7 -y-  013 7 -y-  003 7 -y- }
3FA2: 0130 { 013 7 xy-  003 7 xy-  010 7 xy-  000 7 xy- }
3FA3: 01E4 { 014 7 -y-  027 7 -y-  015 7 -y-  013 7 -y- }
3FA4: 01E2 { 015 7 xy-  013 7 xy-  014 7 xy-  027 7 xy- }
3FA5: 0100 { 00D 7 ---  040 7 ---  003 7 ---  013 7 --- }
3FA6: 0100 { 003 7 x--  013 7 x--  00D 7 x--  040 7 x-- }
3FA7: 0130 { 011 7 ---  010 7 ---  003 7 ---  013 7 --- }
3FA8: 0130 { 003 7 x--  013 7 x--  011 7 x--  010 7 x-- }
3FA9: 0130 { 012 7 ---  014 7 ---  013 7 ---  015 7 --- }
3FAA: 0025 { 245 7 xy-  277 7 -y-  261 7 xy-  260 7 xy- }
3FAB: 0025 { 275 7 -y-  275 7 -y-  247 7 -y-  246 7 -y- }
3FAC: 0025 { 247 7 -y-  246 7 -y-  245 7 -y-  277 7 xy- }
3FAD: 0025 { 265 7 -y-  240 7 -y-  265 7 xy-  240 7 xy- }
3FAE: 0025 { 277 7 -y-  277 7 -y-  240 7 xy-  245 7 xy- }
3FAF: 0025 { 245 7 -y-  277 7 -y-  240 7 xy-  240 7 xy- }
3FB0: 0130 { 183 2 x--  195 2 -y-  182 2 x--  186 2 xy- }
3FB1: 0130 { 186 2 ---  182 2 -y-  184 2 x--  180 2 xy- }
3FB2: 0130 { 184 2 ---  190 2 -y-  192 2 x--  186 2 xy- }
3FB3: 0130 { 180 2 ---  180 2 -y-  183 2 ---  182 2 xy- }
3FB4: 0130 { 182 2 ---  183 2 xy-  180 2 x--  180 2 xy- }
3FB5: 0130 { 193 2 --p  186 2 -yp  184 2 x-p  190 2 xyp }
3FB6: 0130 { 184 2 -yp  190 2 -yp  190 2 x-p  184 2 xyp }
3FB7: 0130 { 190 2 --p  184 2 -yp  186 2 x-p  195 2 x-p }
3FB8: 0130 { 182 2 ---  183 2 -y-  183 2 ---  182 2 xy- }
3FB9: 0130 { 182 2 ---  186 2 -y-  183 2 ---  192 2 xy- }
3FBA: 0025 { 245 7 -y-  277 7 -y-  277 7 -y-  277 7 -y- }
3FBB: 0025 { 261 7 -y-  260 7 -y-  245 7 -y-  277 7 xy- }
3FBC: 0025 { 277 7 ---  277 7 ---  240 7 ---  240 7 --- }
3FBD: 0025 { 277 7 -y-  277 7 -y-  265 7 -y-  240 7 -y- }
3FBE: 0025 { 240 7 -y-  240 7 -y-  245 7 xy-  277 7 xy- }
3FBF: 0025 { 245 7 xy-  277 7 -y-  247 7 xy-  246 7 xy- }
3FC0: 0130 { 180 2 --p  190 2 --p  180 2 x-p  184 2 xyp }
3FC1: 0130 { 184 2 -yp  180 2 -yp  190 2 x-p  180 2 xyp }
3FC2: 0130 { 193 2 ---  183 2 xy-  186 2 x--  182 2 xy- }
3FC3: 0130 { 182 2 --p  186 2 -yp  183 2 --p  192 2 xyp }
3FC4: 0147 { 1D7 2 --p  190 2 --p  183 2 --p  193 2 --p }
3FC5: 014A { 190 2 -y-  1D7 2 -y-  195 2 ---  182 2 xy- }
3FC6: 014A { 193 2 ---  182 2 -y-  190 2 xy-  1D7 2 xy- }
3FC7: 0130 { 1D7 2 ---  1D7 2 -y-  183 2 ---  182 2 xy- }
3FC8: 0130 { 183 2 x--  182 2 -y-  1D7 2 x--  1D7 2 xy- }
3FC9: 0130 { 192 2 ---  195 2 xy-  186 2 x--  186 2 xy- }
3FCA: 0025 { 240 7 x--  240 7 x--  275 7 x--  275 7 x-- }
3FCB: 0025 { 247 7 xy-  246 7 xy-  275 7 xy-  275 7 xy- }
3FCC: 0025 { 244 7 xy-  242 7 xy-  243 7 xy-  241 7 xy- }
3FCD: 0025 { 277 7 xy-  277 7 xy-  245 7 xy-  277 7 xy- }
3FCE: 0025 { 277 7 ---  277 7 ---  245 7 x--  240 7 x-- }
3FCF: 0025 { 277 7 ---  277 7 ---  240 7 ---  265 7 --- }
3FD0: 0130 { 186 2 ---  186 2 -y-  192 2 x--  195 2 -y- }
3FD1: 014D { 190 2 -yp  180 2 -yp  193 2 -yp  183 2 -yp }
3FD2: 0146 { 191 2 --p  190 2 --p  183 2 --p  193 2 --p }
3FD3: 016E { 0F8 2 ---  1B4 2 ---  075 2 ---  24C 2 --- }
3FD4: 01D8 { 1A6 2 ---  192 2 ---  075 2 ---  075 2 --- }
3FD5: 0030 { 0F8 2 ---  0F8 2 ---  075 2 ---  075 2 --- }
3FD6: 0035 { 0F8 2 ---  0F8 2 ---  076 2 ---  075 2 --- }
3FD7: 0033 { 075 1 --p  075 1 --p  0F8 1 --p  0F8 1 --p }
3FD8: 0178 { 075 1 ---  075 1 ---  1B5 1 ---  1B9 1 --- }
3FD9: 003F { 075 1 --p  075 1 --p  195 1 --p  193 1 --p }
3FDA: 0025 { 275 7 x--  275 7 x--  275 7 -y-  253 7 x-- }
3FDB: 0025 { 253 7 -y-  275 7 x--  275 7 -y-  275 7 -y- }
3FDC: 0025 { 275 7 xy-  275 7 xy-  253 7 xy-  275 7 --- }
3FDD: 0025 { 275 7 xy-  253 7 ---  275 7 ---  275 7 --- }
3FDE: 0025 { 246 7 x--  247 7 x--  275 7 x--  275 7 x-- }
3FDF: 0025 { 277 7 ---  245 7 ---  240 7 x--  240 7 x-- }
3FE0: 0130 { 02E 7 ---  02E 7 -y-  02E 7 ---  02E 7 -y- }
3FE1: ~
3FE2: ~
3FE3: ~
3FE4: ~
3FE5: ~
3FE6: ~
3FE7: ~
3FE8: ~
3FE9: ~
3FEA: ~
3FEB: ~
3FEC: 0025 { 256 7 -y-  255 7 -y-  253 7 -y-  275 7 xy- }
3FED: 0025 { 250 7 x--  253 7 xy-  272 7 ---  259 7 -y- }
3FEE: 0025 { 267 7 xy-  250 7 xy-  272 7 xy-  272 7 xy- }
3FEF: 0025 { 272 7 ---  272 7 ---  250 7 ---  267 7 --- }
3FF0: ~
3FF1: ~
3FF2: ~
3FF3: ~
3FF4: ~
3FF5: ~
3FF6: ~
3FF7: ~
3FF8: ~
3FF9: ~
3FFA: ~
3FFB: ~
3FFC: 0025 { 253 7 x--  259 7 ---  259 7 ---  272 7 -y- }
3FFD: 0025 { 068 7 ---  06A 7 ---  069 7 ---  06B 7 --- }
3FFE: 0025 { 0B3 3 ---  0C3 3 ---  0B4 3 ---  0C4 3 --- }
3FFF: 020F { 0F8 4 ---  0F8 4 ---  0F8 4 ---  0F8 4 --- }
