7600: 0130 { 0AC 4 ---  0BC 4 ---  0AD 4 ---  0B7 4 --- }
7601: 0130 { 0AC 4 ---  0B6 4 ---  0AD 4 ---  0BD 4 --- }
7602: ~
7603: ~
7604: 0130 { 0F8 5 ---  0CA 4 ---  0F8 5 ---  0F7 4 --- }
7605: 0130 { 0F8 5 x--  0F7 4 x--  0F8 5 x--  0CA 4 x-- }
7606: 0130 { 004 4 x--  004 4 x--  004 4 x--  004 4 x-- }
7607: 0130 { 004 4 x--  004 4 x--  004 4 x--  004 4 x-- }
7608: 0130 { 004 4 x--  004 4 x--  004 4 x--  004 4 x-- }
7609: 0130 { 004 4 x--  004 4 x--  004 4 x--  004 4 x-- }
760A: ~
760B: 0020 { 004 2 ---  014 2 ---  005 2 ---  015 2 --- }
760C: 0020 { 006 2 ---  016 2 ---  007 2 ---  017 2 --- }
760D: 0025 { 00C 7 ---  01C 7 ---  00D 7 ---  01D 7 --- }
760E: 0020 { 08C 2 ---  09C 2 ---  08D 2 ---  09D 2 --- }
760F: 0020 { 08E 2 ---  09E 2 ---  08F 2 ---  09F 2 --- }
7610: ~
7611: ~
7612: 0130 { 0F8 5 ---  0CA 4 ---  0F8 5 ---  0C6 4 --- }
7613: 0130 { 0CA 4 ---  0C7 4 ---  0C6 4 ---  0D6 4 --- }
7614: 0130 { 0E7 4 ---  0D7 4 ---  0F6 4 ---  0E6 4 --- }
7615: 0130 { 0F6 4 x--  0E6 4 x--  0E7 4 x--  0D7 4 x-- }
7616: 0130 { 0C6 4 x--  0D6 4 x--  0CA 4 x--  0C7 4 x-- }
7617: 0130 { 0F8 5 x--  0C6 4 x--  0F8 5 x--  0CA 4 x-- }
7618: 0130 { 004 4 x--  004 4 x--  004 4 x--  004 4 x-- }
7619: 0130 { 004 4 x--  004 4 x--  004 4 x--  004 4 x-- }
761A: ~
761B: 0020 { 024 2 ---  034 2 ---  025 2 ---  035 2 --- }
761C: 0020 { 026 2 ---  036 2 ---  027 2 ---  037 2 --- }
761D: 0025 { 2AE 7 ---  2BE 7 ---  2AF 7 ---  2BF 7 --- }
761E: 0020 { 0E6 2 ---  0F6 2 ---  0E7 2 ---  0F7 2 --- }
761F: 0020 { 00E 2 ---  01E 2 ---  00F 2 ---  01F 2 --- }
7620: 0130 { 0F8 5 ---  0CA 4 ---  0F8 5 ---  0A8 4 --- }
7621: 0130 { 0CA 4 ---  0A9 4 ---  0CB 4 ---  0B8 4 --- }
7622: 0130 { 0CC 4 ---  0D2 4 ---  0CD 4 ---  0F8 5 --- }
7623: 0130 { 0F3 4 ---  2F6 0 ---  0F2 4 ---  10E 0 --- }
7624: ~
7625: 0130 { 004 4 x--  004 4 x--  004 4 x--  004 4 x-- }
7626: 0130 { 0F2 4 x--  17F 0 ---  0F3 4 x--  0F8 5 x-- }
7627: 0130 { 0CD 4 x--  0F8 5 x--  0CC 4 x--  0D2 4 x-- }
7628: 0130 { 0CB 4 x--  0B8 4 x--  0CA 4 x--  0A9 4 x-- }
7629: 0130 { 0F8 5 x--  0A8 4 x--  0F8 5 x--  0CA 4 x-- }
762A: ~
762B: 0020 { 028 2 ---  038 2 ---  029 2 ---  039 2 --- }
762C: 0020 { 02A 2 ---  03A 2 ---  02B 2 ---  03B 2 --- }
762D: ~
762E: 0020 { 02C 2 ---  03C 2 ---  02D 2 ---  03D 2 --- }
762F: 0020 { 02E 2 ---  03E 2 ---  02F 2 ---  03F 2 --- }
7630: ~
7631: ~
7632: ~
7633: ~
7634: ~
7635: ~
7636: ~
7637: ~
7638: ~
7639: ~
763A: ~
763B: ~
763C: 0025 { 0F8 4 ---  08C 2 ---  0F8 4 ---  08D 2 --- }
763D: 0025 { 0F8 4 ---  0F8 4 ---  0F8 4 ---  0F8 4 --- }
763E: 0025 { 0F8 4 ---  0F8 4 ---  2A8 7 ---  2B8 7 --- }
763F: 0025 { 2A9 7 ---  2B9 7 ---  0F8 4 ---  0F8 4 --- }
7640: ~
7641: ~
7642: ~
7643: ~
7644: ~
7645: ~
7646: ~
7647: ~
7648: ~
7649: ~
764A: ~
764B: ~
764C: 0025 { 09C 2 ---  0F8 4 ---  09D 2 ---  0F8 4 --- }
764D: 0025 { 0F8 4 ---  0F8 4 ---  0F8 4 ---  0F8 4 --- }
764E: 0025 { 0F8 4 ---  004 5 ---  0F8 4 ---  005 5 --- }
764F: 0025 { 0F8 4 ---  006 5 ---  0F8 4 ---  007 5 --- }
7650: ~
7651: ~
7652: ~
7653: ~
7654: ~
7655: ~
7656: ~
7657: ~
7658: 0025 { 004 4 ---  004 4 ---  004 4 ---  004 4 --- }
7659: 0025 { 004 4 ---  004 4 ---  004 4 ---  004 4 --- }
765A: ~
765B: ~
765C: 0025 { 0F8 4 ---  024 5 ---  0F8 4 ---  025 5 --- }
765D: 0025 { 0F8 4 ---  026 5 ---  0F8 4 ---  027 5 --- }
765E: 0025 { 014 5 ---  028 5 ---  015 5 ---  029 5 --- }
765F: 0025 { 016 5 ---  02A 5 ---  017 5 ---  02B 5 --- }
7660: ~
7661: ~
7662: ~
7663: ~
7664: ~
7665: ~
7666: ~
7667: ~
7668: 0025 { 004 4 ---  004 4 ---  004 4 ---  004 4 --- }
7669: 0025 { 004 4 ---  004 4 ---  004 4 ---  004 4 --- }
766A: 0025 { 004 4 ---  004 4 ---  004 4 ---  004 4 --- }
766B: 0025 { 004 4 ---  004 4 ---  004 4 ---  004 4 --- }
766C: 0025 { 034 5 ---  0F8 4 ---  035 5 ---  0F8 4 --- }
766D: 0025 { 036 5 ---  0F8 4 ---  037 5 ---  0F8 4 --- }
766E: 0025 { 038 5 ---  0F8 4 ---  039 5 ---  0F8 4 --- }
766F: 0025 { 03A 5 ---  0F8 4 ---  03B 5 ---  0F8 4 --- }
7670: ~
7671: ~
7672: ~
7673: ~
7674: ~
7675: ~
7676: ~
7677: ~
7678: ~
7679: ~
767A: ~
767B: ~
767C: ~
767D: ~
767E: 0025 { 0F8 7 ---  0F8 7 ---  00E 7 ---  01E 7 --- }
767F: 0025 { 00F 7 ---  01F 7 ---  0F8 7 ---  0F8 7 --- }
7680: ~
7681: ~
7682: ~
7683: ~
7684: ~
7685: ~
7686: ~
7687: ~
7688: ~
7689: ~
768A: ~
768B: ~
768C: ~
768D: ~
768E: 0025 { 0F8 7 ---  0F8 7 ---  02E 7 ---  03E 7 --- }
768F: 0025 { 02F 7 ---  03F 7 ---  0F8 7 ---  0F8 7 --- }
7690: ~
7691: ~
7692: ~
7693: ~
7694: ~
7695: ~
7696: ~
7697: ~
7698: ~
7699: ~
769A: ~
769B: ~
769C: ~
769D: ~
769E: 0020 { 020 2 ---  030 2 ---  007 2 ---  037 2 --- }
769F: 0020 { 008 2 ---  0C7 2 ---  027 2 ---  0D7 2 --- }
76A0: ~
76A1: ~
76A2: ~
76A3: ~
76A4: ~
76A5: ~
76A6: ~
76A7: ~
76A8: ~
76A9: ~
76AA: ~
76AB: ~
76AC: ~
76AD: ~
76AE: 0020 { 185 2 ---  19F 2 ---  18E 2 ---  1AE 2 --- }
76AF: 0020 { 18F 2 ---  1AF 2 ---  19E 2 ---  1BE 2 --- }
76B0: ~
76B1: ~
76B2: ~
76B3: ~
76B4: ~
76B5: ~
76B6: ~
76B7: ~
76B8: ~
76B9: ~
76BA: ~
76BB: ~
76BC: ~
76BD: ~
76BE: 0020 { 1CE 2 ---  28E 2 ---  2A0 2 ---  28F 2 --- }
76BF: 0020 { 2B6 2 ---  29E 2 ---  2B7 2 ---  29F 2 --- }
76C0: ~
76C1: ~
76C2: ~
76C3: ~
76C4: ~
76C5: ~
76C6: ~
76C7: ~
76C8: ~
76C9: ~
76CA: ~
76CB: ~
76CC: ~
76CD: ~
76CE: 0025 { 0F8 7 ---  0F8 7 ---  20F 7 ---  259 7 --- }
76CF: 0025 { 254 7 ---  25A 7 ---  0F8 7 ---  0F8 7 --- }
76D0: ~
76D1: ~
76D2: ~
76D3: ~
76D4: ~
76D5: ~
76D6: ~
76D7: ~
76D8: ~
76D9: ~
76DA: ~
76DB: ~
76DC: ~
76DD: ~
76DE: ~
76DF: ~
76E0: ~
76E1: ~
76E2: ~
76E3: ~
76E4: ~
76E5: ~
76E6: ~
76E7: ~
76E8: ~
76E9: ~
76EA: ~
76EB: ~
76EC: ~
76ED: ~
76EE: ~
76EF: ~
76F0: ~
76F1: ~
76F2: ~
76F3: ~
76F4: ~
76F5: ~
76F6: ~
76F7: ~
76F8: ~
76F9: ~
76FA: ~
76FB: ~
76FC: ~
76FD: ~
76FE: ~
76FF: ~
