6A00: 0025 { 100 1 ---  110 1 ---  101 1 ---  111 1 --- }
6A01: 0025 { 102 1 ---  112 1 ---  103 1 ---  113 1 --- }
6A02: 0025 { 103 1 ---  114 1 ---  105 1 ---  115 1 --- }
6A03: 0025 { 106 1 ---  116 1 ---  107 1 ---  117 1 --- }
6A04: 0025 { 108 1 ---  118 1 ---  109 1 ---  119 1 --- }
6A05: 0025 { 10A 1 ---  11A 1 ---  10B 1 ---  11B 1 --- }
6A06: 0025 { 10C 1 ---  11C 1 ---  10D 1 ---  11D 1 --- }
6A07: 0025 { 10E 1 ---  11E 1 ---  100 1 x--  11F 1 --- }
6A08: 0025 { 180 4 ---  190 4 ---  181 4 ---  191 4 --- }
6A09: 0025 { 181 4 ---  192 4 ---  181 4 ---  193 4 --- }
6A0A: 0025 { 181 4 ---  194 4 ---  181 4 ---  195 4 --- }
6A0B: 0025 { 181 4 ---  196 4 ---  181 4 ---  197 4 --- }
6A0C: 0025 { 181 4 ---  196 4 ---  181 4 ---  199 4 --- }
6A0D: 0025 { 181 4 ---  196 4 ---  181 4 ---  19B 4 --- }
6A0E: 0025 { 181 4 ---  196 4 ---  181 4 ---  19D 4 --- }
6A0F: 0025 { 181 4 ---  196 4 ---  18F 4 ---  19F 4 --- }
6A10: 0025 { 120 1 ---  130 1 ---  121 1 ---  131 1 --- }
6A11: 0025 { 122 1 ---  132 1 ---  123 1 ---  133 1 --- }
6A12: 0025 { 124 1 ---  134 1 ---  125 1 ---  135 1 --- }
6A13: 0025 { 126 1 ---  136 1 ---  127 1 ---  137 1 --- }
6A14: 0025 { 128 1 ---  138 1 ---  129 1 ---  139 1 --- }
6A15: 0025 { 12A 1 ---  11C 1 ---  11C 1 ---  11C 1 --- }
6A16: 0025 { 11C 1 ---  11C 1 ---  12D 1 ---  13D 1 --- }
6A17: 0025 { 12E 1 ---  13E 1 ---  12F 1 ---  13F 1 --- }
6A18: 0025 { 1A0 4 ---  1A0 4 ---  1A1 4 ---  1B1 4 --- }
6A19: 0025 { 1A2 4 ---  1B2 4 ---  1A3 4 ---  1B3 4 --- }
6A1A: 0025 { 1A4 4 ---  1B4 4 ---  1A5 4 ---  1B5 4 --- }
6A1B: 0025 { 1A6 4 ---  1B6 4 ---  1A7 4 ---  1B7 4 --- }
6A1C: 0025 { 1A8 4 ---  1B8 4 ---  1A9 4 ---  1B9 4 --- }
6A1D: 0025 { 1AA 4 ---  1BA 4 ---  1AB 4 ---  1BB 4 --- }
6A1E: 0025 { 1AC 4 ---  1BC 4 ---  1AD 4 ---  1BD 4 --- }
6A1F: 0025 { 1AE 4 ---  1BE 4 ---  1BF 4 ---  1BF 4 --- }
6A20: 0025 { 140 1 ---  150 1 ---  141 1 ---  151 1 --- }
6A21: 0025 { 142 1 ---  152 1 ---  143 1 ---  153 1 --- }
6A22: 0025 { 144 1 ---  154 1 ---  145 1 ---  155 1 --- }
6A23: 0025 { 146 1 ---  156 1 ---  147 1 ---  157 1 --- }
6A24: 0025 { 148 1 ---  158 1 ---  149 1 ---  159 1 --- }
6A25: 0025 { 11C 1 ---  15A 1 ---  11C 1 ---  15A 1 --- }
6A26: 0025 { 11C 1 ---  15A 1 ---  11C 1 ---  15A 1 --- }
6A27: 0025 { 14E 1 ---  15E 1 ---  14F 1 ---  15F 1 --- }
6A28: 0025 { 1A0 4 ---  1D0 4 ---  1C1 4 ---  1D1 4 --- }
6A29: 0025 { 1C2 4 ---  1D2 4 ---  1C3 4 ---  1D2 4 --- }
6A2A: 0025 { 1C4 4 ---  1D2 4 ---  1C5 4 ---  1D5 4 --- }
6A2B: 0025 { 1C6 4 ---  1D6 4 ---  1C7 4 ---  1D8 4 --- }
6A2C: 0025 { 1C8 4 ---  1D8 4 ---  1C9 4 ---  1D9 4 --- }
6A2D: 0025 { 1CA 4 ---  1DA 4 ---  1CB 4 ---  1DB 4 --- }
6A2E: 0025 { 1CC 4 ---  1DC 4 ---  1CD 4 ---  1DD 4 --- }
6A2F: 0025 { 1CE 4 ---  1DE 4 ---  1CF 4 ---  1D0 4 x-- }
6A30: 0025 { 16E 1 ---  17E 1 ---  16F 1 ---  17F 1 --- }
6A31: 0025 { 0F8 5 ---  0A6 7 ---  0F8 5 ---  0A7 7 --- }
6A32: 0025 { 0F8 5 ---  0A8 7 ---  0F8 5 ---  0A9 7 --- }
6A33: 0025 { 16E 1 ---  17E 1 ---  16F 1 ---  17F 1 --- }
6A34: 0025 { 168 1 ---  178 1 ---  169 1 ---  179 1 --- }
6A35: 0025 { 16A 1 ---  17A 1 ---  16B 1 ---  17B 1 --- }
6A36: 0025 { 16C 1 ---  17C 1 ---  16D 1 ---  17D 1 --- }
6A37: 0025 { 16E 1 ---  17E 1 ---  16F 1 ---  17F 1 --- }
6A38: 0025 { 1EE 4 ---  1FE 4 ---  1EF 4 ---  1FF 4 --- }
6A39: 0025 { 0F8 5 ---  000 7 ---  0F8 5 ---  001 7 --- }
6A3A: 0025 { 0F8 5 ---  002 7 ---  0F8 5 ---  003 7 --- }
6A3B: 0025 { 1EF 4 x--  1FF 4 x--  1EE 4 x--  1FE 4 x-- }
6A3C: 0025 { 1E8 4 ---  1F8 4 ---  1E9 4 ---  1F9 4 --- }
6A3D: 0025 { 1EA 4 ---  1FA 4 ---  1EB 4 ---  1FB 4 --- }
6A3E: 0025 { 1E9 4 x--  1FC 4 ---  1E8 4 x--  1FD 4 --- }
6A3F: 0025 { 1EE 4 ---  1FE 4 ---  1EF 4 ---  1FF 4 --- }
6A40: 0025 { 17E 1 -y-  17E 1 ---  17F 1 -y-  17F 1 --- }
6A41: 0025 { 0B6 7 ---  0D6 7 ---  0B7 7 ---  0D7 7 --- }
6A42: 0025 { 0B8 7 ---  0F8 5 ---  0B9 7 ---  0F8 5 --- }
6A43: 0025 { 17E 1 -y-  17E 1 ---  17F 1 -y-  17F 1 --- }
6A44: 0025 { 160 1 ---  170 1 ---  161 1 ---  171 1 --- }
6A45: 0025 { 162 1 ---  172 1 ---  163 1 ---  173 1 --- }
6A46: 0025 { 164 1 ---  174 1 ---  165 1 ---  175 1 --- }
6A47: 0025 { 17E 1 -y-  17E 1 ---  17F 1 -y-  17F 1 --- }
6A48: 0025 { 1E6 4 ---  1F6 4 ---  1E7 4 ---  1F7 4 --- }
6A49: 0025 { 010 7 ---  0F8 5 ---  011 7 ---  0F8 5 --- }
6A4A: 0025 { 012 7 ---  0F8 5 ---  013 7 ---  0F8 5 --- }
6A4B: 0025 { 1E7 4 x--  1F7 4 x--  1E6 4 x--  1F6 4 x-- }
6A4C: 0025 { 1E0 4 ---  1F0 4 ---  1E1 4 ---  1F1 4 --- }
6A4D: 0025 { 1E2 4 ---  1F2 4 ---  1E3 4 ---  1F3 4 --- }
6A4E: 0025 { 1E4 4 ---  1F4 4 ---  1E5 4 ---  1F5 4 --- }
6A4F: 0025 { 1E6 4 ---  1F6 4 ---  1E7 4 ---  1F7 4 --- }
6A50: 0025 { 17E 1 -y-  16E 1 -y-  17F 1 -y-  16F 1 -y- }
6A51: 0025 { 0E6 7 ---  0F6 7 ---  0E7 7 ---  0F7 7 --- }
6A52: 0025 { 275 1 x--  253 1 x--  0F8 5 ---  0F8 5 --- }
6A53: 0025 { 17E 1 -y-  16E 1 -y-  17F 1 -y-  16F 1 -y- }
6A54: 0025 { 14B 1 ---  15B 1 ---  14C 1 ---  15C 1 --- }
6A55: 0025 { 14D 1 ---  15D 1 ---  14D 1 x--  15D 1 x-- }
6A56: 0025 { 14C 1 x--  15C 1 x--  14B 1 x--  15B 1 x-- }
6A57: 0025 { 17E 1 -y-  16E 1 -y-  17F 1 -y-  16F 1 -y- }
6A58: 0025 { 182 4 ---  184 4 ---  183 4 ---  185 4 --- }
6A59: 0025 { 0F8 5 ---  008 7 ---  0F8 5 ---  009 7 --- }
6A5A: 0025 { 0F8 5 ---  00A 7 ---  0F8 5 ---  00B 7 --- }
6A5B: 0025 { 183 4 x--  185 4 x--  182 4 x--  184 4 x-- }
6A5C: 0025 { 1EC 4 ---  18C 4 ---  1ED 4 ---  18D 4 --- }
6A5D: 0025 { 188 4 ---  18D 4 ---  189 4 ---  18D 4 --- }
6A5E: 0025 { 18A 4 ---  18D 4 ---  18B 4 ---  18E 4 --- }
6A5F: 0025 { 182 4 ---  184 4 ---  183 4 ---  185 4 --- }
6A60: 0025 { 0F8 5 ---  28A 1 ---  0F8 5 ---  0F8 5 --- }
6A61: 0025 { 0F8 5 ---  288 1 ---  0F8 5 ---  289 1 --- }
6A62: 0025 { 0F8 5 ---  0F8 5 ---  0F8 5 ---  202 5 --- }
6A63: 0025 { 0F8 5 ---  203 5 ---  0F8 5 ---  20C 5 --- }
6A64: 0025 { 0F8 5 ---  20D 5 ---  0F8 5 ---  186 5 --- }
6A65: 0025 { 0F8 5 ---  187 5 ---  0F8 5 ---  0F8 5 --- }
6A66: 0025 { 0F8 5 ---  0AC 4 ---  0F8 5 ---  0AD 4 --- }
6A67: 0025 { 0F8 5 ---  0F8 5 ---  0F8 5 ---  0F8 5 --- }
6A68: 0025 { 0F8 5 ---  19A 4 ---  0F8 5 ---  0F8 5 --- }
6A69: 0025 { 018 7 ---  0F8 5 ---  019 7 ---  0F8 5 --- }
6A6A: 0025 { 01A 7 ---  0F8 5 ---  01B 7 ---  0F8 5 --- }
6A6B: 0025 { 0F8 5 ---  0F8 5 ---  28E 6 ---  29E 6 --- }
6A6C: 0025 { 28F 6 ---  29F 6 ---  0F8 5 ---  0F8 5 --- }
6A6D: 0025 { 0F8 5 ---  0F8 5 ---  0F8 5 ---  000 7 --- }
6A6E: 0025 { 0F8 5 ---  001 7 ---  0F8 5 ---  002 7 --- }
6A6F: 0025 { 0F8 5 ---  003 7 ---  0F8 5 ---  0F8 5 --- }
6A70: 0025 { 280 1 ---  290 1 ---  281 1 ---  291 1 --- }
6A71: 0025 { 282 1 ---  292 1 ---  283 1 ---  293 1 --- }
6A72: 0025 { 260 5 ---  270 5 ---  261 5 ---  271 5 --- }
6A73: 0025 { 262 5 ---  272 5 ---  263 5 ---  273 5 --- }
6A74: 0025 { 264 5 ---  274 5 ---  265 5 ---  275 5 --- }
6A75: 0025 { 266 5 ---  276 5 ---  267 5 ---  277 5 --- }
6A76: 0025 { 0BC 4 ---  0CC 4 ---  0BD 4 ---  0CD 4 --- }
6A77: 0025 { 0CA 4 ---  0CB 4 ---  0F8 5 ---  0F8 5 --- }
6A78: 0025 { 0F8 5 ---  0F8 5 ---  19C 4 ---  1B0 4 --- }
6A79: 0025 { 19E 4 ---  1C0 4 ---  0F8 5 ---  0F8 5 --- }
6A7A: 0025 { 0F8 5 ---  1D3 4 ---  0F8 5 ---  0F8 5 --- }
6A7B: 0025 { 0F8 5 ---  0F8 5 ---  29E 6 ---  2AE 6 --- }
6A7C: 0025 { 29F 6 ---  2AF 6 ---  0F8 5 ---  0F8 5 --- }
6A7D: 0025 { 0F8 5 ---  0F8 5 ---  010 7 ---  0F8 5 --- }
6A7E: 0025 { 011 7 ---  0F8 5 ---  012 7 ---  0F8 5 --- }
6A7F: 0025 { 013 7 ---  0F8 5 ---  0F8 5 ---  0F8 5 --- }
6A80: 0025 { 200 5 ---  210 5 ---  201 5 ---  211 5 --- }
6A81: 0025 { 201 5 ---  211 5 ---  201 5 ---  211 5 --- }
6A82: 0025 { 204 5 ---  214 5 ---  205 5 ---  215 5 --- }
6A83: 0025 { 206 5 ---  216 5 ---  207 5 ---  217 5 --- }
6A84: 0025 { 208 5 ---  218 5 ---  209 5 ---  219 5 --- }
6A85: 0025 { 20A 5 ---  21A 5 ---  20B 5 ---  211 5 --- }
6A86: 0025 { 20E 5 ---  211 5 ---  20E 5 ---  211 5 --- }
6A87: 0025 { 20E 5 ---  211 5 ---  20F 5 ---  21F 5 --- }
6A88: 0025 { 004 5 ---  014 5 ---  005 5 ---  015 5 --- }
6A89: 0025 { 006 5 ---  016 5 ---  007 5 ---  017 5 --- }
6A8A: 0025 { 0F8 5 ---  0F8 5 ---  0F8 5 ---  1AF 4 --- }
6A8B: 0025 { 0F8 5 ---  0F8 5 ---  2BE 6 ---  2BE 6 --- }
6A8C: 0025 { 2BF 6 ---  2BF 6 ---  0F8 5 ---  0F8 5 --- }
6A8D: 0025 { 0F8 5 ---  0F8 5 ---  0F8 5 ---  008 7 --- }
6A8E: 0025 { 0F8 5 ---  009 7 ---  0F8 5 ---  00A 7 --- }
6A8F: 0025 { 0F8 5 ---  00B 7 ---  0F8 5 ---  0F8 5 --- }
6A90: 0025 { 220 5 ---  230 5 ---  221 5 ---  231 5 --- }
6A91: 0025 { 222 5 ---  232 5 ---  223 5 ---  233 5 --- }
6A92: 0025 { 224 5 ---  234 5 ---  225 5 ---  235 5 --- }
6A93: 0025 { 226 5 ---  236 5 ---  227 5 ---  237 5 --- }
6A94: 0025 { 228 5 ---  238 5 ---  229 5 ---  239 5 --- }
6A95: 0025 { 22A 5 ---  23A 5 ---  22B 5 ---  23B 5 --- }
6A96: 0025 { 22C 5 ---  23C 5 ---  22D 5 ---  23D 5 --- }
6A97: 0025 { 22E 5 ---  23E 5 ---  22F 5 ---  23F 5 --- }
6A98: 0025 { 024 5 ---  034 5 ---  025 5 ---  035 5 --- }
6A99: 0025 { 026 5 ---  036 5 ---  027 5 ---  037 5 --- }
6A9A: 0025 { 028 5 ---  038 5 ---  029 5 ---  039 5 --- }
6A9B: 0025 { 02A 5 ---  03A 5 ---  02B 5 ---  03B 5 --- }
6A9C: 0025 { 0F8 5 ---  0F8 5 ---  0F8 5 ---  198 4 --- }
6A9D: 0025 { 0F8 5 ---  0F8 5 ---  018 7 ---  0F8 5 --- }
6A9E: 0025 { 019 7 ---  0F8 5 ---  01A 7 ---  0F8 5 --- }
6A9F: 0025 { 01B 7 ---  0F8 5 ---  0F8 5 ---  0F8 5 --- }
6AA0: 0025 { 240 5 ---  250 5 ---  241 5 ---  251 5 --- }
6AA1: 0025 { 242 5 ---  252 5 ---  243 5 ---  251 5 --- }
6AA2: 0025 { 244 5 ---  252 5 ---  245 5 ---  255 5 --- }
6AA3: 0025 { 246 5 ---  256 5 ---  247 5 ---  257 5 --- }
6AA4: 0025 { 247 5 x--  258 5 ---  249 5 ---  259 5 --- }
6AA5: 0025 { 24A 5 ---  25A 5 ---  24B 5 ---  251 5 --- }
6AA6: 0025 { 24C 5 ---  252 5 ---  24D 5 ---  251 5 --- }
6AA7: 0025 { 24E 5 ---  252 5 ---  24F 5 ---  25F 5 --- }
6AA8: 0025 { 0F8 5 ---  004 5 ---  0F8 5 ---  005 5 --- }
6AA9: 0025 { 0F8 5 ---  006 5 ---  0F8 5 ---  007 5 --- }
6AAA: 0025 { 0F8 5 ---  2D6 5 ---  0F8 5 ---  2D7 5 --- }
6AAB: 0025 { 0F8 5 ---  0F8 5 ---  1D4 4 ---  1C0 4 x-- }
6AAC: 0025 { 1D7 4 ---  1B0 4 x--  0F8 5 ---  0F8 5 --- }
6AAD: 0025 { 0F8 5 ---  0F8 5 ---  0FD 2 ---  0FD 2 --- }
6AAE: 0025 { 0FD 2 x--  0FD 2 x--  0F8 5 ---  0F8 5 --- }
6AAF: 0025 { 0F8 5 ---  020 7 ---  0F8 5 ---  021 7 --- }
6AB0: 0025 { 26F 5 x--  27E 5 ---  26F 5 ---  27F 5 --- }
6AB1: 0025 { 0F8 5 ---  28E 6 ---  0F8 5 ---  28F 6 --- }
6AB2: 0025 { 28F 6 x--  29F 6 x--  28E 6 x--  29E 6 x-- }
6AB3: 0025 { 26F 5 x--  27F 5 x--  26E 5 x--  27E 5 x-- }
6AB4: 0025 { 268 5 ---  278 5 ---  269 5 ---  279 5 --- }
6AB5: 0025 { 269 5 ---  27A 5 ---  26B 5 ---  27B 5 --- }
6AB6: 0025 { 26C 5 ---  27C 5 ---  26D 5 ---  27D 5 --- }
6AB7: 0025 { 26E 5 ---  27E 5 ---  26F 5 ---  27F 5 --- }
6AB8: 0025 { 014 5 ---  0F8 5 ---  015 5 ---  0F8 5 --- }
6AB9: 0025 { 016 5 ---  0F8 5 ---  017 5 ---  0F8 5 --- }
6ABA: 0025 { 2E6 5 ---  2F6 5 ---  2E7 5 ---  2F7 5 --- }
6ABB: 0025 { 2E8 5 ---  2F8 5 ---  2E9 5 ---  2F9 5 --- }
6ABC: 0025 { 2EA 5 ---  2FA 5 ---  2EB 5 ---  2FB 5 --- }
6ABD: 0025 { 0F8 5 ---  0F8 5 ---  0F4 2 ---  0E8 2 --- }
6ABE: 0025 { 0F5 2 ---  0E9 2 ---  0F8 5 ---  0F8 5 --- }
6ABF: 0025 { 030 7 ---  0F8 5 ---  031 7 ---  0F8 5 --- }
6AC0: 0025 { 21B 5 ---  27E 5 ---  21C 5 ---  27F 5 --- }
6AC1: 0025 { 29E 6 ---  2AE 6 ---  29F 6 ---  2AF 6 --- }
6AC2: 0025 { 2AF 6 x--  2BF 6 x--  2AE 6 x--  2BE 6 x-- }
6AC3: 0025 { 21C 5 x--  27F 5 x--  21B 5 x--  27E 5 x-- }
6AC4: 0025 { 212 5 ---  28B 5 ---  213 5 ---  28C 5 --- }
6AC5: 0025 { 25B 5 ---  28D 5 ---  25C 5 ---  2A0 5 --- }
6AC6: 0025 { 25D 5 ---  2A1 5 ---  25E 5 ---  2A2 5 --- }
6AC7: 0025 { 21B 5 ---  27E 5 ---  21C 5 ---  27F 5 --- }
6AC8: 0025 { 0F8 5 ---  0F8 5 ---  024 5 ---  034 5 --- }
6AC9: 0025 { 025 5 ---  035 5 ---  026 5 ---  036 5 --- }
6ACA: 0025 { 027 5 ---  037 5 ---  028 5 ---  038 5 --- }
6ACB: 0025 { 029 5 ---  039 5 ---  02A 5 ---  03A 5 --- }
6ACC: 0025 { 02B 5 ---  03B 5 ---  0F8 5 ---  0F8 5 --- }
6ACD: 0025 { 0A5 2 xy-  082 2 xy-  096 2 xy-  0B1 2 xy- }
6ACE: 0025 { 0F8 5 ---  0F8 5 ---  0AF 6 x--  0BF 6 x-- }
6ACF: 0025 { 0AE 6 x--  0BE 6 x--  0F8 5 ---  0F8 5 --- }
6AD0: 0025 { 21B 5 ---  21D 5 ---  21C 5 ---  21E 5 --- }
6AD1: 0025 { 2BE 6 ---  2BE 6 ---  2BF 6 ---  2BF 6 --- }
6AD2: 0025 { 28F 6 x--  29F 6 x--  28E 6 x--  29E 6 x-- }
6AD3: 0025 { 21C 5 x--  21E 5 x--  21B 5 x--  21D 5 x-- }
6AD4: 0025 { 29B 5 ---  248 5 ---  29C 5 ---  253 5 --- }
6AD5: 0025 { 29D 5 ---  254 5 ---  29D 5 x--  254 5 x-- }
6AD6: 0025 { 29C 5 x--  253 5 x--  29B 5 x--  248 5 x-- }
6AD7: 0025 { 21B 5 ---  21D 5 ---  21C 5 ---  21E 5 --- }
6AD8: 0025 { 0F8 5 x--  194 4 ---  0F8 5 x--  1D4 4 --- }
6AD9: 0025 { 0F8 5 ---  0F8 5 ---  1C5 4 ---  1D5 4 --- }
6ADA: 0025 { 1C5 4 x--  1D5 4 x--  0F8 5 x--  0F8 5 x-- }
6ADB: ~
6ADC: 0025 { 0F8 5 ---  0F8 5 ---  0F8 5 ---  2D3 5 --- }
6ADD: 0025 { 0F8 5 ---  2D4 5 ---  0F8 5 ---  2D5 5 --- }
6ADE: 0025 { 0F8 5 ---  0F8 5 ---  0CE 6 ---  0CE 6 --- }
6ADF: 0025 { 0CF 6 ---  0CF 6 ---  0F8 5 ---  0F8 5 --- }
6AE0: 0025 { 284 1 ---  294 1 ---  285 1 ---  295 1 --- }
6AE1: 0025 { 286 1 ---  296 1 ---  287 1 ---  297 1 --- }
6AE2: 0025 { 29F 6 x--  2AF 6 x--  29E 6 x--  2AE 6 x-- }
6AE3: 0025 { 2BF 6 x--  0DE 6 ---  2BE 6 x--  0DF 6 --- }
6AE4: 0025 { 2BE 6 ---  0DF 6 x--  2BF 6 ---  0DE 6 x-- }
6AE5: 0025 { 167 1 ---  177 1 ---  12B 1 ---  13B 1 --- }
6AE6: 0025 { 12C 1 ---  13C 1 ---  104 1 ---  13A 1 --- }
6AE7: 0025 { 10F 1 ---  14A 1 ---  0F8 5 ---  0F8 5 --- }
6AE8: 0025 { 0F8 5 x--  1D4 4 x--  0F8 5 x--  194 4 x-- }
6AE9: 0025 { 0F8 5 ---  0F8 5 ---  1A8 4 ---  1B8 4 --- }
6AEA: 0025 { 1A8 4 x--  1B8 4 x--  0F8 5 x--  0F8 5 x-- }
6AEB: 0025 { 2E0 5 ---  2F0 5 ---  2E1 5 ---  2F1 5 --- }
6AEC: 0025 { 2E2 5 ---  2F2 5 ---  2E3 5 ---  2F3 5 --- }
6AED: 0025 { 2E4 5 ---  2F4 5 ---  2E5 5 ---  2F5 5 --- }
6AEE: 0025 { 0F8 5 ---  0F8 5 ---  0CF 6 x--  0DF 6 x-- }
6AEF: 0025 { 0CE 6 x--  0DE 6 x--  0F8 5 ---  0F8 5 --- }
6AF0: 0025 { 0F8 5 ---  298 1 ---  0F8 5 ---  299 1 --- }
6AF1: ~
6AF2: 0025 { 2BE 6 ---  2BE 6 ---  2BF 6 ---  2BF 6 --- }
6AF3: 0025 { 0EE 6 ---  0FE 6 ---  0EF 6 ---  0FF 6 --- }
6AF4: 0025 { 0EF 6 x--  0FF 6 x--  0EE 6 x--  0FE 6 x-- }
6AF5: 0025 { 000 4 ---  010 4 ---  001 4 ---  011 4 --- }
6AF6: 0025 { 002 4 ---  012 4 ---  003 4 ---  013 4 --- }
6AF7: ~
6AF8: 0025 { 185 4 ---  195 4 ---  186 4 ---  196 4 --- }
6AF9: 0025 { 187 4 ---  197 4 ---  188 4 ---  198 4 --- }
6AFA: 0025 { 188 4 x--  198 4 x--  187 4 x--  197 4 x-- }
6AFB: 0025 { 186 4 x--  196 4 x--  185 4 x--  195 4 x-- }
6AFC: 0025 { 0F8 5 x--  0F8 5 x--  0F8 5 x--  1D6 4 --- }
6AFD: 0025 { 0F8 5 x--  1D6 4 x--  0F8 5 x--  0F8 5 x-- }
6AFE: 0025 { 0F8 5 ---  0F8 5 ---  0EF 6 x--  0FF 6 x-- }
6AFF: 0025 { 0EE 6 x--  0FE 6 x--  0F8 5 ---  0F8 5 --- }
