4200: 0025 { 0F8 4 ---  0F8 4 ---  08C 3 ---  09C 3 --- }
4201: 0025 { 08D 3 ---  09D 3 ---  08E 3 ---  09E 3 --- }
4202: 0025 { 08F 3 ---  09F 3 ---  0F8 4 ---  0F8 4 --- }
4203: 0025 { 2F3 1 ---  2F7 1 ---  2F4 1 ---  2C8 1 --- }
4204: 0025 { 2F5 1 ---  2D8 1 ---  2F6 1 ---  2E8 1 --- }
4205: 0130 { 212 3 -y-  222 3 -y-  223 3 xy-  221 3 -y- }
4206: 0130 { 222 3 ---  212 3 ---  221 3 ---  223 3 x-- }
4207: 0130 { 204 1 ---  214 1 ---  207 1 ---  217 1 --- }
4208: 0130 { 201 3 x--  201 3 xy-  200 3 x--  200 3 xy- }
4209: 0130 { 204 1 ---  213 1 ---  205 1 ---  215 1 --- }
420A: 0130 { 206 1 ---  216 1 ---  207 1 ---  25F 1 --- }
420B: 0130 { 202 3 ---  222 3 x--  201 3 ---  223 3 x-- }
420C: 0130 { 204 1 ---  214 1 ---  205 1 ---  215 1 --- }
420D: 0130 { 206 1 ---  216 1 ---  207 1 ---  217 1 --- }
420E: 0130 { 200 3 ---  210 3 ---  201 3 ---  211 3 --- }
420F: 0130 { 202 3 ---  212 3 ---  201 3 ---  211 3 --- }
4210: 0025 { 0F8 4 ---  084 3 ---  0AC 3 ---  085 3 --- }
4211: 0025 { 0AD 3 ---  0BD 3 ---  0AE 3 ---  0BE 3 --- }
4212: 0025 { 0AF 3 ---  0BF 3 ---  0F8 4 ---  0F8 4 --- }
4213: 0025 { 0F8 4 ---  086 3 ---  082 3 ---  092 3 --- }
4214: 0025 { 083 3 ---  093 3 ---  0F8 4 ---  0F8 4 --- }
4215: 0130 { 2E3 3 ---  280 3 ---  2E4 3 ---  280 3 --- }
4216: 0130 { 223 3 -y-  221 3 xy-  212 3 xy-  222 3 xy- }
4217: 0025 { 0CA 3 ---  0F7 3 ---  0CB 3 ---  0C8 2 --- }
4218: 0025 { 0CC 3 ---  0C9 2 ---  0F8 4 ---  0C4 2 --- }
4219: 0025 { 28A 2 x--  29A 2 x--  289 2 x--  299 2 x-- }
421A: 0025 { 28B 3 ---  29B 3 ---  28C 3 ---  29C 3 --- }
421B: 0130 { 221 3 ---  211 3 ---  220 3 x--  210 3 x-- }
421C: 0130 { 202 3 ---  202 3 -y-  201 3 ---  201 3 -y- }
421D: 0130 { 201 3 x--  211 3 x--  200 3 x--  210 3 x-- }
421E: 0130 { 220 3 ---  210 3 ---  221 3 ---  211 3 --- }
421F: 0130 { 222 3 ---  212 3 ---  221 3 ---  211 3 --- }
4220: 0025 { 094 3 ---  0DE 2 x--  095 3 ---  0CF 2 --- }
4221: 0025 { 08A 3 ---  09A 3 ---  088 3 ---  098 3 --- }
4222: 0025 { 089 3 ---  099 3 ---  0F8 4 ---  0F8 4 --- }
4223: 0025 { 096 3 ---  0A6 3 ---  097 3 ---  0A7 3 --- }
4224: 0025 { 212 3 -y-  2FF 3 xy-  223 3 xy-  222 3 --- }
4225: 0130 { 2E4 3 x--  280 3 x--  2E3 3 x--  280 3 x-- }
4226: 0025 { 0F8 4 ---  0F8 4 ---  0F8 4 ---  0CD 3 --- }
4227: 0025 { 0F6 3 ---  0F5 3 ---  0D8 2 ---  0C6 2 --- }
4228: 0025 { 0D9 2 ---  0C7 2 ---  0D4 2 ---  0C0 2 x-- }
4229: 0025 { 285 2 ---  295 2 ---  286 2 ---  296 2 --- }
422A: 0025 { 280 1 x--  26E 1 x--  280 1 x--  26D 1 x-- }
422B: 0130 { 212 3 -y-  202 3 -y-  211 3 -y-  201 3 -y- }
422C: 0130 { 211 3 xy-  201 3 xy-  210 3 xy-  200 3 xy- }
422D: 0130 { 219 3 ---  219 3 ---  219 3 ---  219 3 --- }
422E: 0130 { 211 3 ---  223 3 ---  212 3 ---  222 3 --- }
422F: 0130 { 211 3 ---  221 3 ---  212 3 ---  222 3 --- }
4230: 0025 { 0F8 4 ---  0F8 4 ---  0DF 2 ---  0EF 2 --- }
4231: 0025 { 0AA 3 ---  0BA 3 ---  0AB 3 ---  0BB 3 --- }
4232: 0025 { 0CE 3 ---  0DE 3 ---  0F8 4 ---  0F8 4 --- }
4233: 0025 { 0B6 3 ---  0B6 3 -y-  0B6 3 x--  0B6 3 x-- }
4234: 0130 { 0F8 4 x--  0F8 4 x--  0F8 4 x--  0B7 0 --- }
4235: 0025 { 1FC 2 ---  1FC 2 ---  0F2 6 x--  168 6 x-- }
4236: 0025 { 0F1 6 x--  167 6 x--  0CD 3 -y-  0F8 3 --- }
4237: 0025 { 0F0 3 ---  0EE 3 ---  0D6 2 ---  0F8 4 --- }
4238: 0025 { 0D7 2 ---  0F8 4 ---  0D0 2 x--  0F8 4 --- }
4239: 0025 { 280 2 ---  280 2 ---  287 2 ---  297 2 --- }
423A: 0025 { 280 2 ---  280 2 ---  20C 2 x--  21C 2 x-- }
423B: 0025 { 20B 2 x--  21B 2 x--  20A 2 x--  219 2 x-- }
423C: 0025 { 209 2 x--  219 2 x--  208 2 x--  218 2 x-- }
423D: 0025 { 280 2 ---  280 2 ---  280 2 ---  290 2 --- }
423E: 0025 { 281 2 ---  291 2 ---  282 2 ---  292 2 --- }
423F: 0025 { 283 2 ---  293 2 ---  284 2 ---  294 2 --- }
4240: 0025 { 2CA 1 ---  2DA 1 ---  2BF 1 ---  2CF 1 --- }
4241: 0025 { 2DF 1 ---  2EF 1 ---  2CD 1 ---  2DD 1 --- }
4242: 0025 { 0C0 0 ---  0D0 0 ---  0C1 0 ---  0D1 0 --- }
4243: 0130 { 21E 1 xy-  20E 1 xy-  21D 1 xy-  20D 1 xy- }
4244: 0130 { 23E 1 xy-  22E 1 xy-  23D 1 xy-  22D 1 xy- }
4245: 0130 { 25E 1 xy-  24E 1 xy-  25D 1 xy-  24D 1 xy- }
4246: 0130 { 20E 1 x--  21E 1 x--  20D 1 x--  21D 1 x-- }
4247: 0025 { 2A5 2 ---  2B5 2 ---  2A6 2 ---  2B6 2 --- }
4248: 0025 { 2A7 2 ---  2B7 2 ---  280 2 ---  280 2 --- }
4249: 0025 { 288 2 ---  298 2 ---  280 2 ---  280 2 --- }
424A: 0025 { 280 2 ---  280 2 ---  21C 2 x--  25C 3 x-- }
424B: 0025 { 22B 2 x--  25B 3 x--  22A 2 x--  25A 3 x-- }
424C: 0025 { 229 2 x--  259 3 x--  228 2 x--  258 3 x-- }
424D: 0025 { 280 2 ---  280 2 ---  2A0 2 ---  2B0 2 --- }
424E: 0025 { 2A1 2 ---  2B1 2 ---  2A2 2 ---  2B2 2 --- }
424F: 0025 { 2A3 2 ---  2B3 2 ---  2A4 2 ---  2B4 2 --- }
4250: 0130 { 1C3 5 ---  19F 5 ---  18F 5 ---  1C3 5 --- }
4251: 0130 { 1C3 5 ---  1AF 5 ---  1C3 5 ---  1C3 5 --- }
4252: 0130 { 1C3 5 ---  1AF 5 ---  19F 5 ---  1C3 5 --- }
4253: 0130 { 1C3 5 ---  18F 5 ---  1C3 5 ---  1C3 5 --- }
4254: 0130 { 19F 5 ---  1C3 5 ---  18F 5 ---  1AF 5 --- }
4255: 0130 { 1AF 5 ---  1C3 5 ---  1C3 5 ---  1C3 5 --- }
4256: 0130 { 22E 1 x--  23E 1 x--  22D 1 x--  23D 1 x-- }
4257: 0025 { 2C5 2 ---  2D5 2 ---  2C6 2 ---  2D6 2 --- }
4258: 0025 { 2C7 2 ---  2D7 2 ---  280 2 ---  280 2 --- }
4259: 0025 { 280 2 ---  27D 3 ---  280 2 ---  27E 3 --- }
425A: 0025 { 280 2 ---  280 2 ---  26C 3 x--  27C 3 x-- }
425B: 0025 { 26B 3 x--  27B 3 x--  26A 3 x--  27A 3 x-- }
425C: 0025 { 269 3 x--  279 3 x--  268 3 x--  278 3 x-- }
425D: 0025 { 280 2 ---  280 2 ---  2C0 2 ---  2D0 2 --- }
425E: 0025 { 2C1 2 ---  2D1 2 ---  2C2 2 ---  2D2 2 --- }
425F: 0025 { 2C3 2 ---  2D3 2 ---  2C4 2 ---  2D4 2 --- }
4260: 0130 { 1AF 5 ---  18F 5 ---  19F 5 ---  1C3 5 --- }
4261: 0130 { 19F 5 ---  18F 5 ---  1C3 5 ---  1C3 5 --- }
4262: 0130 { 18F 5 ---  19F 5 ---  1AF 5 ---  1C3 5 --- }
4263: 0130 { 19F 5 ---  1AF 5 ---  1C3 5 ---  1C3 5 --- }
4264: 0130 { 1C3 5 ---  1C3 5 ---  19F 5 ---  18F 5 --- }
4265: 0130 { 1C3 5 ---  1C3 5 ---  1C3 5 ---  1C3 5 --- }
4266: 0130 { 24E 1 x--  25E 1 x--  24D 1 x--  25D 1 x-- }
4267: 0025 { 2E5 2 ---  280 2 ---  2E6 2 ---  280 2 --- }
4268: 0025 { 2E7 2 ---  280 2 ---  280 2 ---  280 2 --- }
4269: 0106 { 238 3 ---  248 3 ---  239 3 ---  249 3 --- }
426A: 0106 { 23A 3 ---  280 2 ---  23A 3 ---  280 2 --- }
426B: 0106 { 23B 3 ---  248 3 ---  23C 3 ---  249 3 --- }
426C: 0130 { 18B 5 ---  18B 5 ---  18B 5 ---  18B 5 --- }
426D: 0130 { 18B 5 ---  18B 5 ---  18B 5 ---  18B 5 --- }
426E: 0130 { 18B 5 ---  18B 5 ---  18B 5 ---  18B 5 --- }
426F: 0130 { 18B 5 ---  18B 5 ---  18B 5 ---  18B 5 --- }
4270: 0130 { 211 3 ---  221 3 ---  2FF 3 ---  222 3 --- }
4271: 0025 { 2FF 3 x--  212 3 ---  212 3 ---  223 3 x-- }
4272: 0025 { 211 3 ---  221 3 ---  212 3 ---  2FF 3 -y- }
4273: 0025 { 1DB 5 ---  1EB 5 ---  18B 5 ---  1EC 5 --- }
4274: 0130 { 212 3 -y-  202 3 -y-  2FF 3 ---  201 3 -y- }
4275: 0025 { 280 2 ---  280 2 ---  280 2 ---  0C2 0 --- }
4276: 0025 { 18B 5 ---  18B 5 ---  1DB 5 ---  1EB 5 --- }
4277: 0025 { 15F 5 x--  1EC 5 ---  18B 5 ---  18B 5 --- }
4278: 0025 { 280 1 ---  280 1 ---  2C9 1 ---  2D9 1 --- }
4279: 0025 { 2CA 1 ---  2DA 1 ---  2CB 1 ---  2DB 1 --- }
427A: 0025 { 2CC 1 ---  2DC 1 ---  2CD 1 ---  2DD 1 --- }
427B: 0106 { 24A 1 ---  280 2 ---  23A 1 ---  280 2 --- }
427C: 0106 { 23A 1 ---  280 2 ---  23A 1 ---  280 2 --- }
427D: 0106 { 23A 1 ---  280 2 ---  24A 1 x--  280 2 --- }
427E: 0025 { 24A 1 ---  280 2 ---  23A 1 ---  280 2 --- }
427F: 0025 { 2A8 1 ---  2B8 1 ---  2A9 1 ---  2B9 1 --- }
4280: 0025 { 18B 5 ---  18B 5 ---  18B 5 ---  18B 5 --- }
4281: 004D { 109 5 ---  189 5 ---  109 5 ---  18A 5 --- }
4282: 0025 { 18B 5 ---  18B 5 ---  18B 5 ---  18C 5 --- }
4283: 0025 { 1FB 5 ---  18D 5 ---  1FC 5 ---  18D 5 x-- }
4284: 0025 { 18B 5 ---  18C 5 x--  18B 5 ---  18B 5 --- }
4285: 0025 { 02B 4 ---  02A 4 ---  088 4 ---  030 0 --- }
4286: 0025 { 18B 5 ---  15E 5 x--  1FB 5 ---  15D 5 x-- }
4287: 0025 { 1FC 5 ---  15D 5 ---  18B 5 ---  15E 5 --- }
4288: 0025 { 280 1 ---  2F8 1 ---  2E9 1 ---  2F9 1 --- }
4289: 0025 { 2EA 1 ---  2FA 1 ---  2EB 1 ---  2FB 1 --- }
428A: 0025 { 2EC 1 ---  2FC 1 ---  2ED 1 ---  2FD 1 --- }
428B: 0025 { 2EE 1 ---  2FE 1 ---  280 2 ---  280 2 --- }
428C: 0025 { 280 1 ---  2CE 1 ---  280 1 ---  280 1 --- }
428D: 0025 { 280 1 ---  2DE 1 ---  280 1 ---  280 1 --- }
428E: 0025 { 23A 1 ---  280 2 ---  24A 1 x--  280 2 --- }
428F: 0025 { 2AA 1 ---  2BA 1 ---  2AB 1 ---  2BB 1 --- }
4290: 0196 { 197 5 ---  1A7 5 ---  198 5 ---  1A8 5 --- }
4291: 019B { 199 5 ---  1A9 5 ---  19A 5 ---  1AA 5 --- }
4292: 0025 { 19B 5 ---  1AB 5 ---  19C 5 ---  1AC 5 --- }
4293: 0025 { 19D 5 ---  1AD 5 ---  19E 5 ---  1AE 5 --- }
4294: 0025 { 19C 5 x--  1AC 5 x--  19B 5 x--  1AB 5 x-- }
4295: 0025 { 18B 5 ---  18B 5 ---  18B 5 ---  17F 5 x-- }
4296: 0025 { 16E 5 x--  17E 5 x--  16D 5 x--  17D 5 x-- }
4297: 0025 { 16D 5 ---  17D 5 ---  16E 5 ---  17E 5 --- }
4298: 0025 { 18B 5 ---  17F 5 ---  18B 5 ---  18B 5 --- }
4299: 0025 { 2AC 1 ---  2BC 1 ---  2AD 1 ---  2BD 1 --- }
429A: 0025 { 2BE 1 ---  280 2 ---  280 2 ---  280 2 --- }
429B: 0025 { 2AD 1 x--  2BD 1 x--  2AC 1 x--  2BC 1 x-- }
429C: 0130 { 18B 5 ---  18B 5 ---  18B 5 ---  18B 5 --- }
429D: 0130 { 18B 5 ---  18B 5 ---  18B 5 ---  18B 5 --- }
429E: 0130 { 18B 5 ---  18B 5 ---  18B 5 ---  18B 5 --- }
429F: 002B { 0C0 6 ---  0D0 6 ---  0C1 6 ---  0D1 6 --- }
42A0: 01DE { 1B7 5 ---  1C7 5 ---  1B8 5 ---  1C8 5 --- }
42A1: 0130 { 1B9 5 ---  1C9 5 ---  1BA 5 ---  1CA 5 --- }
42A2: 0025 { 1BB 5 ---  1CB 5 ---  1BC 5 ---  1CC 5 --- }
42A3: 0025 { 1BD 5 ---  1CD 5 ---  1BD 5 x--  1CD 5 x-- }
42A4: 0025 { 1BC 5 x--  1CC 5 x--  1BB 5 x--  1CB 5 x-- }
42A5: 0025 { 101 5 ---  111 5 ---  102 5 ---  112 5 --- }
42A6: 0025 { 103 5 ---  113 5 ---  104 5 ---  114 5 --- }
42A7: 0025 { 105 5 ---  115 5 ---  106 5 ---  116 5 --- }
42A8: 0025 { 107 5 ---  117 5 ---  108 5 ---  118 5 --- }
42A9: 0025 { 2BE 1 ---  280 2 ---  280 2 ---  280 2 --- }
42AA: 0025 { 280 2 ---  280 2 ---  2BE 1 x--  280 2 --- }
42AB: 0025 { 280 2 ---  280 2 ---  2BE 1 x--  280 2 --- }
42AC: 0025 { 280 1 ---  28F 1 ---  280 1 ---  29F 1 --- }
42AD: 0025 { 212 3 ---  222 3 ---  211 3 ---  221 3 --- }
42AE: 0025 { 1F0 4 ---  1F2 4 ---  1F1 4 ---  1F3 4 --- }
42AF: 0025 { 1D2 4 ---  0F8 4 ---  1D2 4 x--  0F8 4 --- }
42B0: 0130 { 187 5 ---  1C3 5 ---  188 5 ---  1C3 5 --- }
42B1: 0130 { 1C3 5 ---  1C3 5 ---  1C3 5 ---  1C3 5 --- }
42B2: 0025 { 1D0 4 ---  031 0 ---  1D1 4 ---  02A 4 x-- }
42B3: 0025 { 1DD 5 ---  1FD 5 ---  1DE 5 ---  1FE 5 --- }
42B4: 0025 { 01E 4 ---  02A 4 ---  01F 4 ---  03A 4 --- }
42B5: 0025 { 121 5 ---  131 5 ---  122 5 ---  132 5 --- }
42B6: 0025 { 123 5 ---  133 5 ---  124 5 ---  134 5 --- }
42B7: 0025 { 125 5 ---  135 5 ---  126 5 ---  136 5 --- }
42B8: 0025 { 127 5 ---  137 5 ---  128 5 ---  138 5 --- }
42B9: 0025 { 01F 4 x--  1C0 4 ---  01E 4 x--  1C1 4 --- }
42BA: 0025 { 280 2 ---  270 1 ---  280 2 ---  271 1 --- }
42BB: 0025 { 2BA 1 ---  272 1 ---  2BB 1 ---  273 1 --- }
42BC: 0025 { 28D 1 ---  29D 1 ---  28E 1 ---  29E 1 --- }
42BD: 0025 { 1D7 4 ---  1C4 4 ---  1D8 4 ---  1C5 4 --- }
42BE: 0025 { 1D9 4 ---  1C6 4 ---  1DA 4 ---  1C6 4 x-- }
42BF: 0025 { 1D8 4 x--  1C5 4 x--  1D7 4 x--  1C4 4 x-- }
42C0: 0025 { 109 5 ---  109 5 ---  109 5 ---  180 5 --- }
42C1: 0025 { 109 5 ---  181 5 ---  109 5 ---  182 5 --- }
42C2: 0025 { 109 5 ---  183 5 ---  109 5 ---  184 5 --- }
42C3: 0025 { 109 5 ---  185 5 ---  109 5 ---  186 5 --- }
42C4: 0025 { 100 5 ---  110 5 ---  140 5 ---  150 5 --- }
42C5: 0025 { 141 5 ---  151 5 ---  142 5 ---  152 5 --- }
42C6: 0025 { 143 5 ---  153 5 ---  144 5 ---  154 5 --- }
42C7: 0025 { 145 5 ---  155 5 ---  146 5 ---  156 5 --- }
42C8: 0025 { 147 5 ---  157 5 ---  148 5 ---  158 5 --- }
42C9: 0025 { 149 5 ---  159 5 ---  100 5 ---  110 5 --- }
42CA: 0025 { 274 1 ---  270 1 -y-  2AF 1 ---  271 1 -y- }
42CB: 0025 { 275 1 ---  272 1 -y-  277 1 ---  24C 1 --- }
42CC: 0025 { 2F5 4 ---  01F 4 xy-  00D 4 ---  01F 4 -y- }
42CD: 0025 { 1D4 4 ---  1E4 4 ---  1D5 4 ---  1E5 4 --- }
42CE: 001F { 1D6 4 ---  1F4 4 ---  1D6 4 x--  1F4 4 x-- }
42CF: 0025 { 1D5 4 x--  1E5 4 x--  1D4 4 x--  1E4 4 x-- }
42D0: 0025 { 109 5 ---  109 5 ---  190 5 ---  1A0 5 --- }
42D1: 0130 { 191 5 ---  1A1 5 ---  192 5 ---  1A2 5 --- }
42D2: 0130 { 193 5 ---  1A3 5 ---  194 5 ---  1A4 5 --- }
42D3: 0130 { 195 5 ---  1A5 5 ---  196 5 ---  1A6 5 --- }
42D4: 0025 { 100 5 ---  110 5 ---  160 5 ---  170 5 --- }
42D5: 0025 { 161 5 ---  171 5 ---  162 5 ---  172 5 --- }
42D6: 0025 { 163 5 ---  173 5 ---  164 5 ---  174 5 --- }
42D7: 0025 { 164 5 x--  174 5 x--  163 5 x--  173 5 x-- }
42D8: 0025 { 162 5 x--  172 5 x--  161 5 x--  171 5 x-- }
42D9: 0025 { 160 5 x--  170 5 x--  100 5 ---  110 5 --- }
42DA: 0025 { 270 1 ---  274 1 ---  271 1 ---  2AF 1 --- }
42DB: 0025 { 272 1 ---  275 1 ---  24C 1 -y-  277 1 --- }
42DC: 0025 { 00E 4 ---  01F 4 xy-  00F 4 ---  01F 4 -y- }
42DD: 0025 { 1E4 4 ---  1CE 4 ---  1F5 4 ---  1BF 4 --- }
42DE: 0020 { 1F4 4 ---  1F4 4 ---  1F4 4 x--  1F4 4 x-- }
42DF: 0025 { 1F5 4 x--  1BF 4 x--  1E4 4 x--  1CE 4 x-- }
42E0: 0130 { 18F 5 ---  1D3 5 ---  1C3 5 ---  19F 5 --- }
42E1: 0130 { 1B1 5 ---  1C1 5 ---  1B2 5 ---  1C2 5 --- }
42E2: 0130 { 1B3 5 ---  1C3 5 ---  1B4 5 ---  1C3 5 --- }
42E3: 0130 { 1B5 5 ---  1C3 5 ---  1B6 5 ---  1C3 5 --- }
42E4: 0130 { 1C3 5 ---  1C3 5 ---  18F 5 ---  1C3 5 --- }
42E5: 0130 { 1C3 5 ---  19F 5 ---  1AF 5 ---  1C3 5 --- }
42E6: 0025 { 100 5 ---  110 5 ---  165 5 ---  175 5 --- }
42E7: 0025 { 166 5 ---  176 5 ---  100 5 ---  110 5 --- }
42E8: 0025 { 02B 4 ---  01E 4 -y-  2DE 4 ---  01F 4 -y- }
42E9: 0025 { 2DF 4 ---  01F 4 xy-  2F4 4 ---  01F 4 -y- }
42EA: 0025 { 274 1 ---  270 1 -y-  2AF 1 ---  271 1 -y- }
42EB: 0025 { 22C 1 ---  272 1 -y-  277 1 ---  273 1 -y- }
42EC: 0025 { 01A 4 ---  01F 4 xy-  01B 4 ---  01F 4 -y- }
42ED: 0025 { 01C 4 ---  01F 4 xy-  02B 4 x--  01E 4 xy- }
42EE: 0025 { 1E6 2 ---  1F6 2 ---  1E7 2 ---  1F7 2 --- }
42EF: 0025 { 1EF 2 ---  1FF 2 ---  18B 2 ---  18B 2 --- }
42F0: 0130 { 1C3 5 ---  1C3 5 ---  1C3 5 ---  1C3 5 --- }
42F1: 0130 { 1D1 5 ---  1C1 5 ---  1D2 5 ---  1C2 5 --- }
42F2: 0130 { 1D3 5 ---  1D3 5 ---  1E3 5 ---  1E3 5 --- }
42F3: 0130 { 1C3 5 ---  1D3 5 ---  1C3 5 ---  1E3 5 --- }
42F4: 0130 { 1C3 5 ---  1C3 5 ---  1C3 5 ---  19F 5 --- }
42F5: 0130 { 18F 5 ---  1C3 5 ---  1C3 5 ---  19F 5 --- }
42F6: 0025 { 100 5 ---  184 5 ---  167 5 ---  177 5 --- }
42F7: 0025 { 168 5 ---  178 5 ---  100 5 ---  183 5 --- }
42F8: 0025 { 02C 4 ---  03C 4 ---  0F8 3 ---  0F8 3 --- }
42F9: 0025 { 0F8 3 ---  0F8 3 ---  02C 4 ---  03C 4 --- }
42FA: 0106 { 1C0 5 ---  110 5 ---  1E0 5 ---  110 5 --- }
42FB: 0106 { 1D0 5 ---  110 5 ---  1E0 5 ---  110 5 --- }
42FC: 0130 { 1B0 5 ---  1D1 5 ---  1C2 5 ---  1D2 5 --- }
42FD: 0025 { 0F8 4 ---  1C2 4 ---  0F8 4 ---  1C2 4 x-- }
42FE: 0025 { 1E8 2 ---  1F8 2 ---  1E9 2 ---  1F9 2 --- }
42FF: 0025 { 1EA 2 ---  1FA 2 ---  1DC 2 ---  183 5 --- }
