6C00: 0025 { 100 1 ---  110 1 ---  101 1 ---  111 1 --- }
6C01: 0025 { 102 1 ---  112 1 ---  103 1 ---  113 1 --- }
6C02: 0025 { 104 1 ---  114 1 ---  0F8 1 ---  115 1 --- }
6C03: 0025 { 106 1 ---  116 1 ---  107 1 ---  117 1 --- }
6C04: 0025 { 108 1 ---  118 1 ---  0F8 1 ---  119 1 --- }
6C05: 0025 { 10A 1 ---  11A 1 ---  10B 1 ---  11B 1 --- }
6C06: 0025 { 10C 1 ---  11C 1 ---  10D 1 ---  11D 1 --- }
6C07: 0025 { 10E 1 ---  11E 1 ---  0F8 1 ---  11F 1 --- }
6C08: 0025 { 0F8 1 ---  0F8 1 ---  0F8 1 ---  250 5 --- }
6C09: 0025 { 0F8 1 ---  250 5 x--  0F8 1 ---  0F8 1 x-- }
6C0A: 0025 { 00E 7 ---  01E 7 ---  00F 7 ---  01F 7 --- }
6C0B: ~
6C0C: 0025 { 0F8 1 ---  0F8 1 ---  250 5 ---  260 5 --- }
6C0D: 0025 { 251 5 ---  261 5 ---  251 5 x--  261 5 x-- }
6C0E: 0025 { 250 5 x--  260 5 x--  0F8 1 ---  0F8 1 --- }
6C0F: ~
6C10: 0025 { 120 1 ---  130 1 ---  121 1 ---  131 1 --- }
6C11: 0025 { 122 1 ---  132 1 ---  123 1 ---  133 1 --- }
6C12: 0025 { 124 1 ---  134 1 ---  125 1 ---  135 1 --- }
6C13: 0025 { 126 1 ---  136 1 ---  127 1 ---  137 1 --- }
6C14: 0025 { 128 1 ---  138 1 ---  129 1 ---  139 1 --- }
6C15: 0025 { 12A 1 ---  13A 1 ---  12B 1 ---  13B 1 --- }
6C16: 0025 { 12C 1 ---  13C 1 ---  12D 1 ---  13D 1 --- }
6C17: 0025 { 12E 1 ---  13E 1 ---  12F 1 ---  13F 1 --- }
6C18: 0025 { 0F8 1 ---  0F8 1 ---  260 5 ---  0F8 1 --- }
6C19: 0025 { 260 5 x--  0F8 1 ---  0F8 1 x--  0F8 1 --- }
6C1A: ~
6C1B: ~
6C1C: 0025 { 0F8 1 ---  0F8 1 ---  265 5 ---  275 5 --- }
6C1D: 0025 { 266 5 ---  276 5 ---  267 5 ---  277 5 --- }
6C1E: 0025 { 246 5 ---  256 5 ---  0F8 1 ---  0F8 1 --- }
6C1F: ~
6C20: 0025 { 140 1 ---  150 1 ---  2AB 1 ---  2AB 1 --- }
6C21: 0025 { 158 1 ---  280 1 x--  2AB 1 ---  15A 1 --- }
6C22: 0025 { 2AB 1 ---  2AB 1 ---  2AB 1 ---  2AB 1 --- }
6C23: 0025 { 2AB 1 ---  2AB 1 ---  2AB 1 ---  15A 1 --- }
6C24: 0025 { 2AB 1 ---  158 1 x--  149 1 ---  159 1 --- }
6C25: 0025 { 14A 1 ---  15A 1 ---  14B 1 ---  15B 1 --- }
6C26: 0025 { 14C 1 ---  15C 1 ---  14D 1 ---  15D 1 --- }
6C27: 0025 { 14E 1 ---  15E 1 ---  14F 1 ---  15F 1 --- }
6C28: 0025 { 200 5 ---  210 5 ---  201 5 ---  211 5 --- }
6C29: 0025 { 202 5 ---  212 5 ---  202 5 ---  213 5 --- }
6C2A: 0025 { 202 5 ---  214 5 ---  202 5 ---  215 5 --- }
6C2B: 0025 { 202 5 ---  215 5 ---  202 5 ---  215 5 --- }
6C2C: 0025 { 202 5 x--  215 5 ---  202 5 x--  215 5 x-- }
6C2D: 0025 { 202 5 x--  215 5 x--  202 5 x--  214 5 x-- }
6C2E: 0025 { 202 5 x--  213 5 x--  202 5 x--  212 5 x-- }
6C2F: 0025 { 201 5 x--  211 5 x--  200 5 x--  210 5 x-- }
6C30: 0025 { 160 1 ---  17F 1 x--  161 1 ---  105 1 --- }
6C31: 0025 { 162 1 ---  105 1 ---  162 1 ---  105 1 --- }
6C32: 0025 { 162 1 ---  105 1 ---  162 1 ---  105 1 --- }
6C33: 0025 { 162 1 ---  105 1 ---  167 1 ---  17E 1 x-- }
6C34: 0025 { 168 1 ---  17D 1 x--  169 1 ---  17C 1 x-- }
6C35: 0025 { 16A 1 ---  17B 1 x--  16B 1 ---  17B 1 --- }
6C36: 0025 { 16C 1 ---  17C 1 ---  16D 1 ---  17D 1 --- }
6C37: 0025 { 16E 1 ---  17E 1 ---  16F 1 ---  17F 1 --- }
6C38: 0025 { 220 5 ---  23F 5 x--  221 5 ---  231 5 --- }
6C39: 0025 { 222 5 ---  232 5 ---  223 5 ---  233 5 --- }
6C3A: 0025 { 224 5 ---  234 5 ---  225 5 ---  235 5 --- }
6C3B: 0025 { 215 5 ---  236 5 ---  215 5 ---  237 5 --- }
6C3C: 0025 { 215 5 ---  238 5 ---  215 5 x--  239 5 --- }
6C3D: 0025 { 225 5 x--  23A 5 ---  224 5 x--  234 5 x-- }
6C3E: 0025 { 223 5 x--  233 5 x--  222 5 x--  23D 5 --- }
6C3F: 0025 { 221 5 x--  23E 5 ---  220 5 x--  23F 5 --- }
6C40: 0025 { 164 1 ---  166 1 ---  165 1 ---  175 1 --- }
6C41: 0025 { 0F8 1 ---  0F8 1 ---  0F8 1 ---  0F8 1 --- }
6C42: 0025 { 0F8 1 ---  0F8 1 ---  0F8 1 ---  0F8 1 --- }
6C43: 0025 { 165 1 x--  175 1 x--  163 1 x--  166 1 x-- }
6C44: 0025 { 176 1 ---  2E0 1 ---  177 1 ---  2E1 1 --- }
6C45: 0025 { 178 1 ---  2E2 1 ---  179 1 ---  2E3 1 --- }
6C46: 0025 { 17A 1 ---  2E4 1 ---  145 1 ---  2E5 1 --- }
6C47: 0025 { 163 1 ---  166 1 ---  165 1 ---  175 1 --- }
6C48: 0025 { 24F 5 x--  25F 5 x--  24E 5 x--  25E 5 x-- }
6C49: 0025 { 242 5 ---  255 5 x--  243 5 ---  254 5 x-- }
6C4A: 0025 { 244 5 ---  254 5 ---  245 5 ---  255 5 --- }
6C4B: 0025 { 24E 5 ---  25E 5 ---  24F 5 ---  257 5 --- }
6C4C: 0025 { 248 5 ---  255 5 x--  249 5 ---  255 5 x-- }
6C4D: 0025 { 24A 5 ---  254 5 x--  244 5 x--  254 5 --- }
6C4E: 0025 { 243 5 x--  255 5 ---  24D 5 ---  255 5 --- }
6C4F: 0025 { 24E 5 ---  25E 5 ---  24F 5 ---  25F 5 --- }
6C50: 0025 { 164 1 ---  166 1 ---  165 1 ---  175 1 --- }
6C51: 0025 { 0F8 1 ---  0F8 1 ---  0F8 1 ---  0F8 1 --- }
6C52: 0025 { 0F8 1 ---  0F8 1 ---  0F8 1 ---  0F8 1 --- }
6C53: 0025 { 165 1 x--  175 1 x--  164 1 x--  166 1 x-- }
6C54: 0025 { 2F0 1 ---  2E6 1 ---  2F1 1 ---  2E7 1 --- }
6C55: 0025 { 2F2 1 ---  2E8 1 ---  2F3 1 ---  2E9 1 --- }
6C56: 0025 { 2F4 1 ---  2EA 1 ---  2F5 1 ---  2EB 1 --- }
6C57: 0025 { 164 1 ---  166 1 ---  165 1 ---  175 1 --- }
6C58: 0025 { 26F 5 x--  27F 5 x--  26E 5 x--  27E 5 x-- }
6C59: 0130 { 0F8 0 ---  2C2 3 ---  0F8 0 ---  2C3 3 --- }
6C5A: 0130 { 0F8 0 ---  2C4 3 ---  0F8 0 ---  2C5 3 --- }
6C5B: 0025 { 26E 5 ---  27E 5 ---  26F 5 ---  27F 5 --- }
6C5C: 0025 { 25D 5 x--  268 5 ---  259 5 ---  269 5 --- }
6C5D: 0025 { 25A 5 ---  26A 5 ---  25B 5 ---  26B 5 --- }
6C5E: 0025 { 25C 5 ---  26C 5 ---  25D 5 ---  26D 5 --- }
6C5F: 0025 { 26E 5 ---  27E 5 ---  26F 5 ---  27F 5 --- }
6C60: 0025 { 171 1 ---  109 1 ---  172 1 ---  174 1 --- }
6C61: 0025 { 0F8 1 ---  0F8 1 ---  0F8 1 ---  0F8 1 --- }
6C62: 0025 { 0F8 1 ---  0F8 1 ---  0F8 1 ---  0F8 1 --- }
6C63: 0025 { 171 1 ---  109 1 ---  172 1 ---  10F 1 --- }
6C64: 0025 { 2F6 1 ---  170 1 ---  2F7 1 ---  170 1 --- }
6C65: 0025 { 2F8 1 ---  170 1 ---  2F9 1 ---  170 1 --- }
6C66: 0025 { 2FA 1 ---  170 1 ---  2FB 1 ---  170 1 --- }
6C67: 0025 { 171 1 ---  173 1 ---  172 1 ---  174 1 --- }
6C68: 0025 { 27F 5 xy-  27F 5 x--  27E 5 xy-  27E 5 x-- }
6C69: 0130 { 2D2 3 ---  2E2 3 ---  2D3 3 ---  2E3 3 --- }
6C6A: 0130 { 2D4 3 ---  2E4 3 ---  2D5 3 ---  2E5 3 --- }
6C6B: 0025 { 27E 5 -y-  27E 5 ---  27F 5 -y-  27F 5 --- }
6C6C: 0025 { 278 5 ---  20C 5 ---  279 5 ---  20D 5 --- }
6C6D: 0025 { 27A 5 ---  20E 5 ---  27B 5 ---  20F 5 --- }
6C6E: 0025 { 27C 5 ---  21D 5 ---  27D 5 ---  22D 5 --- }
6C6F: 0025 { 27E 5 -y-  27E 5 ---  27F 5 -y-  27F 5 --- }
6C70: 0025 { 180 4 ---  190 4 ---  181 4 ---  191 4 --- }
6C71: 0025 { 182 4 ---  192 4 ---  183 4 ---  193 4 --- }
6C72: 0025 { 184 4 ---  194 4 ---  185 4 ---  195 4 --- }
6C73: 0025 { 186 4 ---  199 4 x--  187 4 ---  197 4 --- }
6C74: 0025 { 187 4 x--  197 4 x--  186 4 x--  196 4 x-- }
6C75: 0025 { 185 4 x--  195 4 x--  184 4 x--  194 4 x-- }
6C76: 0025 { 183 4 x--  193 4 x--  182 4 x--  192 4 x-- }
6C77: 0025 { 181 4 x--  191 4 x--  180 4 x--  190 4 x-- }
6C78: 0025 { 21F 5 x--  22F 5 x--  21E 5 x--  22E 5 x-- }
6C79: 0130 { 2F2 3 ---  0F8 0 ---  2F3 3 ---  0F8 0 --- }
6C7A: 0130 { 2F4 3 ---  0F8 0 ---  2F5 3 ---  0F8 0 --- }
6C7B: 0025 { 21E 5 ---  22E 5 ---  21F 5 ---  22F 5 --- }
6C7C: 0025 { 23C 5 x--  24C 5 x--  23B 5 x--  24B 5 x-- }
6C7D: 0025 { 2CA 5 ---  258 5 x--  2CA 5 x--  258 5 --- }
6C7E: 0025 { 23B 5 ---  24B 5 ---  23C 5 ---  24C 5 --- }
6C7F: 0025 { 21E 5 ---  22E 5 ---  21F 5 ---  22F 5 --- }
6C80: 0025 { 1A0 4 ---  1B0 4 ---  1A1 4 ---  1B1 4 --- }
6C81: 0025 { 1A2 4 ---  1B2 4 ---  1A3 4 ---  1B3 4 --- }
6C82: 0025 { 193 4 ---  193 4 ---  1A5 4 ---  193 4 --- }
6C83: 0025 { 1A9 4 x--  1B9 4 x--  1A8 4 x--  1B8 4 x-- }
6C84: 0025 { 1A7 4 x--  1B7 4 x--  1A6 4 x--  1B6 4 x-- }
6C85: 0025 { 1A5 4 x--  193 4 x--  193 4 x--  193 4 x-- }
6C86: 0025 { 1A3 4 x--  1B3 4 x--  1A2 4 x--  1B2 4 x-- }
6C87: 0025 { 1A1 4 x--  1B1 4 x--  1A0 4 x--  1B0 4 x-- }
6C88: 0025 { 0F8 1 ---  0F8 1 ---  0F8 1 ---  2B0 1 --- }
6C89: 0025 { 0F8 1 ---  2B1 1 ---  0F8 1 ---  2B2 1 --- }
6C8A: 0025 { 0F8 1 ---  2B3 1 ---  0F8 1 ---  2B4 1 --- }
6C8B: 0025 { 0F8 1 ---  2B5 1 ---  0F8 1 ---  2B6 1 --- }
6C8C: 0025 { 0F8 1 ---  2B7 1 ---  0F8 1 ---  0F8 1 --- }
6C8D: 0025 { 0F8 1 ---  0F8 1 ---  28C 2 ---  29C 2 --- }
6C8E: 0025 { 28D 2 ---  29D 2 ---  0F8 1 ---  0F8 1 --- }
6C8F: ~
6C90: 0025 { 1C0 4 ---  1D0 4 ---  1C1 4 ---  1D1 4 --- }
6C91: 0025 { 1C2 4 ---  1D2 4 ---  1C3 4 ---  1D3 4 --- }
6C92: 0025 { 1C4 4 ---  1D4 4 ---  1C5 4 ---  1D5 4 --- }
6C93: 0025 { 1C9 4 x--  1D9 4 x--  1C7 4 ---  1D7 4 --- }
6C94: 0025 { 1C7 4 x--  1D7 4 x--  1C6 4 x--  1D3 4 x-- }
6C95: 0025 { 1C5 4 x--  1D5 4 x--  1C4 4 x--  1D4 4 x-- }
6C96: 0025 { 1C3 4 x--  1D3 4 x--  1C2 4 x--  1D2 4 x-- }
6C97: 0025 { 1C1 4 x--  1D1 4 x--  1C0 4 x--  1D0 4 x-- }
6C98: 0025 { 0F8 1 ---  0F8 1 ---  2C0 1 ---  2D0 1 --- }
6C99: 0025 { 2C1 1 ---  2D1 1 ---  2C2 1 ---  2D2 1 --- }
6C9A: 0025 { 2C3 1 ---  2D3 1 ---  2C4 1 ---  2D4 1 --- }
6C9B: 0025 { 2C5 1 ---  2D5 1 ---  2C6 1 ---  2D6 1 --- }
6C9C: 0025 { 2C7 1 ---  2D7 1 ---  0F8 1 ---  0F8 1 --- }
6C9D: 0025 { 028 3 ---  038 3 ---  2AD 2 ---  2BD 2 --- }
6C9E: 0025 { 2AD 2 x--  2BD 2 x--  029 3 ---  039 3 --- }
6C9F: ~
6CA0: 0025 { 1AE 4 ---  1BE 4 ---  1AF 4 ---  1BF 4 --- }
6CA1: ~
6CA2: ~
6CA3: 0025 { 1E6 4 ---  1F6 4 ---  1E7 4 ---  1F7 4 --- }
6CA4: 0025 { 1E8 4 ---  1F8 4 ---  1E9 4 ---  1F9 4 --- }
6CA5: 0025 { 1EA 4 ---  1FA 4 ---  1EB 4 ---  1FB 4 --- }
6CA6: 0025 { 1EC 4 ---  1FC 4 ---  1ED 4 ---  1FD 4 --- }
6CA7: 0025 { 1AE 4 ---  1BE 4 ---  1AF 4 ---  1BF 4 --- }
6CA8: ~
6CA9: 0025 { 2D8 1 ---  0F8 1 ---  2D9 1 ---  0F8 1 --- }
6CAA: 0025 { 2DA 1 ---  0F8 1 ---  2DB 1 ---  0F8 1 --- }
6CAB: 0025 { 2AA 1 ---  0F8 1 ---  0F8 1 ---  0F8 1 --- }
6CAC: 0025 { 0F8 1 ---  0F8 1 ---  028 3 ---  038 3 --- }
6CAD: 0025 { 2CC 2 ---  2DC 2 ---  2CD 2 ---  2DD 2 --- }
6CAE: 0025 { 2CD 2 x--  2DD 2 x--  2CC 2 x--  2DC 2 x-- }
6CAF: 0025 { 029 3 ---  039 3 ---  0F8 1 ---  0F8 1 --- }
6CB0: 0025 { 1CE 4 ---  1DE 4 ---  1CF 4 ---  1DF 4 --- }
6CB1: ~
6CB2: ~
6CB3: 0025 { 1CF 4 x--  1DF 4 x--  1CE 4 x--  1DE 4 x-- }
6CB4: 0025 { 18A 4 ---  19A 4 ---  18B 4 ---  19B 4 --- }
6CB5: 0025 { 18C 4 ---  19C 4 ---  18D 4 ---  19D 4 --- }
6CB6: 0025 { 18E 4 ---  19E 4 ---  18F 4 ---  19F 4 --- }
6CB7: 0025 { 1CE 4 ---  1DE 4 ---  1CF 4 ---  1DF 4 --- }
6CB8: ~
6CB9: ~
6CBA: 0025 { 0F8 1 ---  0F8 1 ---  241 5 ---  2B8 5 --- }
6CBB: 0025 { 252 5 ---  2B9 5 ---  253 5 ---  2BA 5 --- }
6CBC: 0025 { 247 5 ---  2BB 5 ---  270 5 ---  2C8 5 --- }
6CBD: 0025 { 271 5 ---  2C9 5 ---  0F8 1 ---  0F8 1 --- }
6CBE: 0025 { 0F8 1 x--  0F8 1 x--  28D 2 x--  29D 2 x-- }
6CBF: 0025 { 28C 2 x--  29C 2 x--  0F8 1 x--  0F8 1 x-- }
6CC0: 0025 { 28A 4 ---  29A 4 ---  28B 4 ---  29B 4 --- }
6CC1: ~
6CC2: ~
6CC3: 0025 { 1EF 4 x--  1FF 4 x--  1EE 4 x--  1FE 4 x-- }
6CC4: 0025 { 1AA 4 ---  1BA 4 ---  1AB 4 ---  1BB 4 --- }
6CC5: 0025 { 1AC 4 ---  1BC 4 ---  1AD 4 ---  1BD 4 --- }
6CC6: 0025 { 1CA 4 ---  1DA 4 ---  1CB 4 ---  1DB 4 --- }
6CC7: 0025 { 1EE 4 ---  1FE 4 ---  1EF 4 ---  1FF 4 --- }
6CC8: 0025 { 0F8 1 ---  0F8 1 ---  216 5 ---  226 5 --- }
6CC9: 0025 { 217 5 ---  227 5 ---  218 5 ---  228 5 --- }
6CCA: 0025 { 219 5 ---  229 5 ---  21A 5 ---  22A 5 --- }
6CCB: 0025 { 21B 5 ---  22B 5 ---  21C 5 ---  22C 5 --- }
6CCC: 0025 { 262 5 ---  272 5 ---  263 5 ---  273 5 --- }
6CCD: 0025 { 264 5 ---  274 5 ---  205 5 ---  20A 5 --- }
6CCE: 0025 { 206 5 ---  20B 5 ---  207 5 ---  230 5 --- }
6CCF: 0025 { 208 5 ---  240 5 ---  0F8 1 ---  0F8 1 --- }
6CD0: 0025 { 0F8 1 ---  0F8 1 ---  1A4 4 ---  1B4 4 --- }
6CD1: 0025 { 188 4 ---  1E0 4 ---  189 4 ---  1E1 4 --- }
6CD2: 0025 { 289 4 ---  1E2 4 ---  289 4 ---  1E3 4 --- }
6CD3: 0025 { 289 4 ---  1E4 4 ---  289 4 ---  1E5 4 --- }
6CD4: 0025 { 198 4 ---  290 4 ---  289 4 ---  291 4 --- }
6CD5: 0025 { 282 4 ---  292 4 ---  283 4 ---  293 4 --- }
6CD6: 0025 { 289 4 ---  294 4 ---  285 4 ---  295 4 --- }
6CD7: 0025 { 286 4 ---  296 4 ---  289 4 ---  297 4 --- }
6CD8: 0025 { 289 4 ---  298 4 ---  289 4 ---  299 4 --- }
6CD9: 0025 { 0F8 1 ---  1CD 4 ---  0F8 1 ---  0F8 1 --- }
6CDA: 0025 { 0F8 1 ---  0F8 1 ---  141 3 ---  142 3 --- }
6CDB: 0025 { 141 3 x--  142 3 x--  0F8 1 ---  0F8 1 --- }
6CDC: 0025 { 2EC 2 ---  2FC 2 ---  2ED 2 ---  2FD 2 --- }
6CDD: 0025 { 2EE 2 ---  2FE 2 ---  2EF 2 ---  2FF 2 --- }
6CDE: 0025 { 2EF 2 x--  2FF 2 x--  2EE 2 x--  2FE 2 x-- }
6CDF: 0025 { 2ED 2 x--  2FD 2 x--  2EC 2 x--  2FC 2 x-- }
6CE0: 0025 { 0F8 1 ---  0F8 1 ---  0F8 1 ---  0F8 1 --- }
6CE1: 0025 { 1F0 4 ---  0F8 1 ---  1F1 4 ---  0F8 1 --- }
6CE2: 0025 { 1F2 4 ---  0F8 1 ---  1F3 4 ---  0F8 1 --- }
6CE3: 0025 { 1F4 4 ---  0F8 1 ---  1F5 4 ---  0F8 1 --- }
6CE4: 0025 { 2A0 4 ---  0F8 1 ---  2A1 4 ---  1DC 4 --- }
6CE5: 0025 { 2A2 4 ---  1DC 4 x--  2A3 4 ---  0F8 1 --- }
6CE6: 0025 { 2A4 4 ---  0F8 1 ---  2A5 4 ---  0F8 1 --- }
6CE7: 0025 { 2A6 4 ---  0F8 1 ---  2A7 4 ---  0F8 1 --- }
6CE8: 0025 { 2A8 4 ---  0F8 1 ---  2A9 4 ---  0F8 1 --- }
6CE9: 0025 { 1DD 4 ---  0F8 1 ---  0F8 1 ---  0F8 1 --- }
6CEA: 0130 { 2C2 3 ---  2D2 3 ---  2C3 3 ---  2D3 3 --- }
6CEB: 0130 { 2C4 3 ---  2D4 3 ---  2C5 3 ---  2D5 3 --- }
6CEC: 0025 { 2C0 3 ---  2D0 3 ---  2C1 3 ---  2D1 3 --- }
6CED: 0025 { 2C1 3 x--  2D1 3 x--  2C0 3 x--  2D0 3 x-- }
6CEE: 0025 { 105 1 ---  105 1 ---  105 1 ---  105 1 --- }
6CEF: ~
6CF0: 0130 { 0F8 3 ---  0F8 3 ---  0F8 3 ---  2E6 3 --- }
6CF1: 0130 { 0F8 3 ---  2E7 3 ---  0F8 3 ---  0F8 3 --- }
6CF2: 0130 { 0F8 3 ---  0F8 3 ---  2F6 3 ---  0F8 3 --- }
6CF3: 0130 { 2F7 3 ---  0F8 3 ---  0F8 3 ---  0F8 3 --- }
6CF4: ~
6CF5: ~
6CF6: ~
6CF7: ~
6CF8: ~
6CF9: ~
6CFA: ~
6CFB: ~
6CFC: ~
6CFD: ~
6CFE: ~
6CFF: ~
