5800: 0106 { 180 2 ---  190 2 ---  181 2 ---  191 2 --- }
5801: 0106 { 182 2 ---  192 2 ---  181 2 ---  191 2 --- }
5802: 0106 { 182 2 ---  192 2 ---  183 2 ---  193 2 --- }
5803: 0106 { 180 2 ---  190 2 ---  183 2 ---  193 2 --- }
5804: 0025 { 00C 4 ---  01C 4 ---  00D 4 ---  1D4 4 --- }
5805: 0025 { 00D 4 x--  01D 4 x--  00C 4 x--  01C 4 x-- }
5806: 0130 { 1AA 1 ---  1AB 1 ---  1AB 1 ---  1AE 1 --- }
5807: 01AF { 1A4 2 ---  1B4 2 ---  0F8 2 ---  1B5 2 --- }
5808: 01AA { 0F8 2 x--  1B5 2 x--  1A5 2 ---  1B4 2 x-- }
5809: 01A0 { 1A8 2 ---  1B8 2 ---  1A9 2 ---  1B9 2 --- }
580A: 01A5 { 0F8 2 ---  1A8 2 ---  0F8 2 ---  1A9 2 --- }
580B: 0130 { 1C0 2 ---  1D0 2 ---  1C1 2 ---  1D1 2 --- }
580C: 0130 { 1C1 2 ---  1D1 2 ---  1C1 2 ---  1D1 2 --- }
580D: 0130 { 1C1 2 ---  1D1 2 ---  1C2 2 ---  1D2 2 --- }
580E: 0130 { 0F8 0 x--  0F8 0 x--  0F8 0 x--  115 4 --- }
580F: 0130 { 106 4 ---  116 4 ---  107 4 ---  117 4 --- }
5810: 0025 { 184 2 ---  194 2 ---  185 2 ---  195 2 --- }
5811: 0025 { 186 2 ---  196 2 ---  187 2 ---  197 2 --- }
5812: 0025 { 188 2 ---  198 2 ---  189 2 ---  199 2 --- }
5813: 0025 { 0F8 0 ---  0F8 0 ---  0F8 0 ---  03B 4 --- }
5814: 0025 { 02C 4 ---  03C 4 ---  02D 4 ---  03D 4 --- }
5815: 0025 { 02D 4 x--  03D 4 x--  02C 4 x--  03C 4 x-- }
5816: 0025 { 0F8 0 x--  03B 4 x--  0F8 0 x--  0F8 0 x-- }
5817: 01E4 { 1A6 2 ---  0F8 2 ---  1A7 2 ---  1B7 2 --- }
5818: 01E2 { 1B6 2 ---  1B7 2 x--  1A6 2 x--  0F8 2 x-- }
5819: 0025 { 19D 2 ---  0F8 2 ---  19E 2 ---  0F8 2 --- }
581A: 01E0 { 1B8 2 ---  19D 2 ---  1B9 2 ---  19E 2 --- }
581B: 0130 { 1D0 2 ---  1D0 2 ---  1D1 2 ---  1D1 2 --- }
581C: 0130 { 1D1 2 ---  1D1 2 ---  1D1 2 ---  1D1 2 --- }
581D: 0130 { 1D1 2 ---  1D1 2 ---  1D2 2 ---  1D2 2 --- }
581E: 0130 { 0F8 0 x--  0F8 0 x--  125 4 ---  135 4 --- }
581F: 0130 { 126 4 ---  136 4 ---  127 4 ---  137 4 --- }
5820: 0025 { 1A0 2 ---  1B0 2 ---  1A1 2 ---  1B1 2 --- }
5821: 0025 { 1A2 2 ---  1B2 2 ---  1A3 2 ---  1B3 2 --- }
5822: 0130 { 1C0 2 ---  1C3 2 ---  1C2 2 ---  1C5 2 --- }
5823: 0025 { 04A 4 ---  05A 4 ---  04B 4 ---  05B 4 --- }
5824: 0025 { 04C 4 ---  05C 4 ---  04D 4 ---  05D 4 --- }
5825: 0025 { 04D 4 x--  05D 4 x--  04C 4 x--  05C 4 x-- }
5826: 0025 { 04B 4 x--  05B 4 x--  04A 4 x--  05A 4 x-- }
5827: 0025 { 0F8 0 x--  0F8 0 x--  184 2 ---  194 2 --- }
5828: 0025 { 185 2 ---  195 2 ---  0F8 0 x--  0F8 0 x-- }
5829: 0196 { 0F8 2 x--  1A9 2 x--  0F8 2 x--  18E 2 --- }
582A: 019B { 1A9 2 x--  1B9 2 x--  18D 2 ---  1B8 2 x-- }
582B: 0130 { 1D0 2 ---  1C3 2 ---  1D1 2 ---  1C4 2 --- }
582C: 0130 { 1D1 2 ---  1C4 2 ---  1D1 2 ---  1C4 2 --- }
582D: 0130 { 1D1 2 ---  1C4 2 ---  1D2 2 ---  1C5 2 --- }
582E: 0130 { 0F8 0 x--  0F8 0 x--  145 4 ---  155 4 --- }
582F: 0130 { 146 4 ---  156 4 ---  147 4 ---  157 4 --- }
5830: 0025 { 1A3 2 x--  1B3 2 x--  1A2 2 x--  1B2 2 x-- }
5831: 0025 { 1A1 2 x--  1B1 2 x--  1A0 2 x--  1B0 2 x-- }
5832: 0025 { 0F8 0 ---  0F8 0 ---  069 4 ---  079 4 --- }
5833: 0025 { 06A 4 ---  07A 4 ---  06B 4 ---  07B 4 --- }
5834: 0025 { 06C 4 ---  07C 4 ---  06D 4 ---  07D 4 --- }
5835: 0025 { 06D 4 x--  07D 4 x--  06C 4 x--  07C 4 x-- }
5836: 0025 { 06B 4 x--  07B 4 x--  06A 4 x--  07A 4 x-- }
5837: 0025 { 069 4 x--  079 4 x--  0F8 0 x--  0F8 0 x-- }
5838: 0025 { 0F8 0 x--  0F8 0 x--  186 2 ---  196 2 --- }
5839: 01DE { 1B9 2 x--  19E 2 x--  1B8 2 x--  19D 2 x-- }
583A: 0025 { 19E 2 x--  0F8 2 x--  19D 2 x--  0F8 2 x-- }
583B: 0130 { 1C6 6 ---  1D6 6 ---  1C7 6 ---  1D7 6 --- }
583C: 0130 { 1C8 6 ---  1D8 6 ---  1C9 6 ---  1D9 6 --- }
583D: 0130 { 0F8 0 x--  172 4 ---  0F8 0 x--  173 4 --- }
583E: 0130 { 0F8 0 x--  174 4 ---  165 4 ---  175 4 --- }
583F: 0130 { 166 4 ---  176 4 ---  167 4 ---  177 4 --- }
5840: 0025 { 0F8 0 ---  07E 4 ---  0F8 0 ---  07F 4 --- }
5841: 0025 { 0F8 0 ---  07F 4 x--  0F8 0 ---  07E 4 x-- }
5842: 0025 { 0F8 0 ---  013 4 ---  004 4 ---  014 4 --- }
5843: 0025 { 005 4 ---  015 4 ---  006 4 ---  016 4 --- }
5844: 0025 { 007 4 ---  017 4 ---  008 4 ---  018 4 --- }
5845: 0025 { 008 4 x--  018 4 x--  007 4 x--  017 4 x-- }
5846: 0025 { 006 4 x--  016 4 x--  005 4 x--  015 4 x-- }
5847: 0025 { 004 4 x--  014 4 x--  0F8 0 x--  013 4 x-- }
5848: 0025 { 187 2 ---  197 2 ---  0F8 0 x--  0F8 0 x-- }
5849: 01AA { 18A 2 ---  19A 2 ---  18B 2 ---  19B 2 --- }
584A: 01E2 { 18C 2 ---  0F8 2 ---  0F8 2 ---  0F8 2 --- }
584B: 0130 { 1E6 6 ---  1F6 6 ---  1E7 6 ---  1F7 6 --- }
584C: 0130 { 0F8 0 x--  118 4 ---  109 4 ---  119 4 --- }
584D: 0130 { 10A 4 ---  11A 4 ---  10B 4 ---  11B 4 --- }
584E: 0130 { 10C 4 ---  11C 4 ---  10D 4 ---  11D 4 --- }
584F: 0130 { 10E 4 ---  11E 4 ---  10F 4 ---  11F 4 --- }
5850: 0025 { 0F8 0 ---  00F 4 ---  0F8 0 ---  00F 4 x-- }
5851: 0025 { 0F8 0 ---  0F8 0 ---  022 4 ---  032 4 --- }
5852: 0025 { 023 4 ---  033 4 ---  024 4 ---  034 4 --- }
5853: 0025 { 025 4 ---  035 4 ---  026 4 ---  036 4 --- }
5854: 0025 { 027 4 ---  037 4 ---  028 4 ---  038 4 --- }
5855: 0025 { 028 4 x--  038 4 x--  027 4 x--  037 4 x-- }
5856: 0025 { 026 4 x--  036 4 x--  025 4 x--  035 4 x-- }
5857: 0025 { 024 4 x--  034 4 x--  023 4 x--  033 4 x-- }
5858: 0025 { 022 4 x--  032 4 x--  0F8 0 x--  0F8 0 x-- }
5859: 01E4 { 0F8 2 x--  0F8 2 x--  18C 2 x--  0F8 2 x-- }
585A: 01AF { 18B 2 x--  19B 2 x--  18A 2 x--  19A 2 x-- }
585B: 0130 { 1E8 6 ---  1F8 6 ---  1E9 6 ---  1F9 6 --- }
585C: 0130 { 128 4 ---  138 4 ---  129 4 ---  139 4 --- }
585D: 0130 { 12A 4 ---  13A 4 ---  12B 4 ---  13B 4 --- }
585E: 0130 { 12C 4 ---  13C 4 ---  12D 4 ---  13D 4 --- }
585F: 0130 { 12E 4 ---  13E 4 ---  12F 4 ---  13F 4 --- }
5860: 0025 { 0F8 0 ---  0F8 0 ---  040 4 ---  050 4 --- }
5861: 0025 { 041 4 ---  051 4 ---  042 4 ---  052 4 --- }
5862: 0025 { 043 4 ---  053 4 ---  044 4 ---  054 4 --- }
5863: 0025 { 045 4 ---  055 4 ---  046 4 ---  056 4 --- }
5864: 0025 { 047 4 ---  057 4 ---  048 4 ---  058 4 --- }
5865: 0025 { 048 4 x--  058 4 x--  047 4 x--  057 4 x-- }
5866: 0025 { 046 4 x--  056 4 x--  045 4 x--  055 4 x-- }
5867: 0025 { 044 4 x--  054 4 x--  043 4 x--  053 4 x-- }
5868: 0025 { 042 4 x--  052 4 x--  041 4 x--  051 4 x-- }
5869: 0025 { 040 4 x--  050 4 x--  0F8 0 x--  0F8 0 x-- }
586A: 0130 { 1AA 1 ---  1AE 1 x--  1AB 1 ---  1AA 1 --- }
586B: 0130 { 0F8 0 x--  0F8 0 x--  172 4 ---  104 4 --- }
586C: 0130 { 148 4 ---  158 4 ---  149 4 ---  159 4 --- }
586D: 0130 { 14A 4 ---  15A 4 ---  14B 4 ---  15B 4 --- }
586E: 0130 { 14C 4 ---  15C 4 ---  14D 4 ---  15D 4 --- }
586F: 0130 { 14E 4 ---  15E 4 ---  14F 4 ---  15F 4 --- }
5870: 0025 { 0F8 0 ---  0F8 0 ---  060 4 ---  070 4 --- }
5871: 0025 { 061 4 ---  071 4 ---  062 4 ---  072 4 --- }
5872: 0025 { 063 4 ---  073 4 ---  064 4 ---  074 4 --- }
5873: 0025 { 065 4 ---  075 4 ---  066 4 ---  076 4 --- }
5874: 0025 { 067 4 ---  077 4 ---  068 4 ---  078 4 --- }
5875: 0025 { 068 4 x--  078 4 x--  067 4 x--  077 4 x-- }
5876: 0025 { 066 4 x--  076 4 x--  065 4 x--  075 4 x-- }
5877: 0025 { 064 4 x--  074 4 x--  063 4 x--  073 4 x-- }
5878: 0025 { 062 4 x--  072 4 x--  061 4 x--  071 4 x-- }
5879: 0025 { 060 4 x--  070 4 x--  0F8 0 x--  0F8 0 x-- }
587A: 0130 { 1AA 1 ---  1BA 1 ---  1BC 1 ---  1AC 1 --- }
587B: 0130 { 0F8 0 x--  0F8 0 x--  114 4 ---  124 4 --- }
587C: 0130 { 168 4 ---  178 4 ---  169 4 ---  179 4 --- }
587D: 0130 { 16A 4 ---  17A 4 ---  16B 4 ---  17B 4 --- }
587E: 0130 { 16C 4 ---  17C 4 ---  16D 4 ---  17D 4 --- }
587F: 0130 { 16E 4 ---  17E 4 ---  16F 4 ---  17F 4 --- }
5880: 0130 { 011 4 ---  021 4 ---  011 4 x--  021 4 x-- }
5881: 0025 { 0F8 0 ---  0F8 0 ---  0F8 0 ---  000 4 --- }
5882: 0025 { 00E 4 ---  001 4 ---  00E 4 x--  001 4 x-- }
5883: 0025 { 0F8 0 x--  000 4 x--  0F8 0 x--  0F8 0 x-- }
5884: 0025 { 0F8 0 ---  0F8 0 ---  1DD 7 x--  0F8 0 --- }
5885: 0025 { 0F8 0 --p  1E0 3 x-p  0F8 0 x-p  0F8 0 x-p }
5886: 0025 { 0F8 0 x-p  0F8 0 x-p  0F8 0 --p  1E1 3 x-p }
5887: 0130 { 1AA 1 ---  1BA 1 ---  1AB 1 ---  1BB 1 --- }
5888: 0130 { 1AA 1 ---  1BA 1 ---  1AB 1 ---  1AE 1 --- }
5889: 0130 { 1AA 1 ---  1BD 1 ---  1AB 1 ---  1BE 1 --- }
588A: 0130 { 1AA 1 ---  1BD 1 ---  1BC 1 ---  1BE 1 --- }
588B: 0130 { 133 4 ---  143 4 ---  134 4 ---  144 4 --- }
588C: 0130 { 200 4 ---  210 4 ---  201 4 ---  211 4 --- }
588D: 0130 { 202 4 ---  212 4 ---  203 4 ---  213 4 --- }
588E: 0130 { 204 4 ---  214 4 ---  205 4 ---  215 4 --- }
588F: 0130 { 206 4 ---  216 4 ---  207 4 ---  217 4 --- }
5890: 01F0 { 011 4 ---  021 4 ---  011 4 x--  021 4 x-- }
5891: 0025 { 0F8 0 ---  002 4 ---  010 4 ---  020 4 --- }
5892: 0025 { 011 4 ---  021 4 ---  011 4 x--  021 4 x-- }
5893: 0025 { 010 4 x--  020 4 x--  0F8 0 x--  002 4 x-- }
5894: 0025 { 0F8 0 ---  0F8 0 ---  0F8 0 ---  1CD 7 x-- }
5895: 0025 { 1F0 3 x-p  1CC 7 x-p  0F8 0 x-p  0F8 0 x-p }
5896: 0025 { 0F8 0 x-p  0F8 0 x-p  1F1 3 x-p  1CB 7 x-p }
5897: 0130 { 1AA 1 ---  1BA 1 ---  1AB 1 ---  1BB 1 --- }
5898: 0130 { 1AA 1 ---  1BA 1 ---  1AC 1 ---  1BC 1 --- }
5899: 0130 { 1AC 1 x--  1BC 1 x--  1AA 1 x--  1BA 1 x-- }
589A: 0130 { 0F8 0 x--  0B8 4 ---  0F8 0 x--  0B9 4 --- }
589B: 0130 { 153 4 ---  100 4 ---  154 4 ---  101 4 --- }
589C: 0130 { 220 4 ---  230 4 ---  221 4 ---  231 4 --- }
589D: 0130 { 222 4 ---  232 4 ---  223 4 ---  233 4 --- }
589E: 0130 { 224 4 ---  234 4 ---  225 4 ---  235 4 --- }
589F: 0130 { 226 4 ---  236 4 ---  227 4 ---  237 4 --- }
58A0: 0025 { 0F8 0 ---  0F8 0 ---  0F8 0 x--  039 4 --- }
58A1: 0025 { 012 4 ---  00B 4 ---  030 4 ---  009 4 --- }
58A2: 0025 { 031 4 ---  00A 4 ---  031 4 x--  00A 4 x-- }
58A3: 0025 { 030 4 x--  009 4 x--  012 4 x--  00B 4 x-- }
58A4: 0025 { 0F8 0 x--  039 4 x--  0F8 0 x--  0F8 0 x-- }
58A5: 0106 { 1CE 2 x-p  1DE 2 x-p  181 2 --p  191 2 --p }
58A6: 0106 { 182 2 --p  192 2 --p  1EE 2 x-p  1FE 2 x-p }
58A7: 0025 { 040 4 x--  050 4 x--  040 4 ---  050 4 --- }
58A8: 0130 { 1BC 1 x--  1BD 1 ---  1BA 1 ---  1BE 1 --- }
58A9: 0130 { 0F8 0 x--  0F8 0 x--  0AB 4 ---  0BB 4 --- }
58AA: 0130 { 0AC 4 ---  0BC 4 ---  0AD 4 ---  0BD 4 --- }
58AB: 0130 { 110 4 ---  120 4 ---  111 4 ---  121 4 --- }
58AC: 0130 { 240 4 ---  250 4 ---  241 4 ---  251 4 --- }
58AD: 0130 { 242 4 ---  252 4 ---  243 4 ---  253 4 --- }
58AE: 0130 { 244 4 ---  254 4 ---  245 4 ---  255 4 --- }
58AF: 0130 { 246 4 ---  256 4 ---  247 4 ---  257 4 --- }
58B0: 0025 { 003 4 ---  06E 4 ---  049 4 ---  059 4 --- }
58B1: 0025 { 01B 4 ---  02B 4 ---  019 4 ---  029 4 --- }
58B2: 0025 { 01A 4 ---  02A 4 ---  01A 4 x--  02A 4 x-- }
58B3: 0025 { 019 4 x--  029 4 x--  01B 4 x--  02B 4 x-- }
58B4: 0025 { 049 4 x--  059 4 x--  003 4 x--  06E 4 x-- }
58B5: 0025 { 1FC 7 x--  1EA 7 x--  0F8 0 x--  0F8 0 x-- }
58B6: 0025 { 0F8 0 x--  0F8 0 x--  1FB 7 x--  0F8 0 --- }
58B7: 0025 { 060 4 x--  070 4 x--  060 4 ---  070 4 --- }
58B8: 0130 { 1BC 1 x--  1BE 1 x--  1BA 1 ---  1BE 1 --- }
58B9: 0130 { 0F8 0 x--  0F8 0 x--  08B 4 ---  09B 4 --- }
58BA: 0130 { 08C 4 ---  09C 4 ---  08D 4 ---  09D 4 --- }
58BB: 0130 { 08E 4 ---  09E 4 ---  08F 4 ---  09F 4 --- }
58BC: 0130 { 260 4 ---  270 4 ---  261 4 ---  271 4 --- }
58BD: 0130 { 262 4 ---  272 4 ---  263 4 ---  273 4 --- }
58BE: 0130 { 264 4 ---  274 4 ---  265 4 ---  275 4 --- }
58BF: 0130 { 266 4 ---  276 4 ---  267 4 ---  277 4 --- }
58C0: 0025 { 1F1 3 --p  1CB 7 --p  1F0 3 --p  1CC 7 --p }
58C1: 0025 { 0F8 0 x-p  1CD 7 --p  0F8 0 x-p  0F8 0 x-p }
58C2: 0025 { 0F8 0 x-p  1E1 3 --p  0F8 0 x-p  1E0 3 --p }
58C3: 0025 { 1E1 3 ---  1F1 3 ---  1E0 3 ---  1F0 3 --- }
58C4: 0025 { 049 4 x--  059 4 x--  049 4 ---  059 4 --- }
58C5: 0025 { 0F8 0 x--  0F8 0 x--  1E0 3 x--  1F0 3 x-- }
58C6: 0025 { 1E1 3 x--  1F1 3 x--  0F8 0 x--  0F8 0 x-- }
58C7: 0130 { 0F8 0 x--  0F8 0 x--  08A 4 ---  09A 4 --- }
58C8: 0130 { 088 4 ---  098 4 ---  089 4 ---  099 4 --- }
58C9: 0130 { 082 4 ---  092 4 ---  083 4 ---  093 4 --- }
58CA: 0130 { 084 4 ---  094 4 ---  085 4 ---  095 4 --- }
58CB: 0130 { 086 4 ---  096 4 ---  087 4 ---  097 4 --- }
58CC: 0130 { 208 4 ---  218 4 ---  209 4 ---  219 4 --- }
58CD: 0130 { 20A 4 ---  21A 4 ---  20B 4 ---  21B 4 --- }
58CE: 0130 { 20C 4 ---  21C 4 ---  20D 4 ---  21D 4 --- }
58CF: 0130 { 20E 4 ---  21E 4 ---  20F 4 ---  21F 4 --- }
58D0: 0106 { 1EE 2 --p  1FE 2 --p  1CE 2 --p  1DE 2 --p }
58D1: 0106 { 1CF 2 --p  1DF 2 --p  181 2 --p  191 2 --p }
58D2: 001F { 1C2 1 ---  1D2 1 ---  1C3 1 ---  1D3 1 --- }
58D3: 0025 { 1CB 7 ---  1DB 7 ---  1CC 7 ---  1DC 7 --- }
58D4: 0025 { 1CD 7 ---  1DD 7 ---  0F8 0 x--  0F8 0 x-- }
58D5: 0025 { 1CD 7 x--  1DD 7 x--  1CC 7 x--  1DC 7 x-- }
58D6: 0025 { 1CB 7 x--  1EB 7 x--  0F8 0 x--  0F8 0 x-- }
58D7: 0130 { 0F8 0 x--  0F8 0 x--  0AA 4 ---  0BA 4 --- }
58D8: 0130 { 0A0 4 ---  0B0 4 ---  0A1 4 ---  0B1 4 --- }
58D9: 0130 { 0A2 4 ---  0B2 4 ---  0A3 4 ---  0B3 4 --- }
58DA: 0130 { 0A4 4 ---  0B4 4 ---  0A5 4 ---  0B5 4 --- }
58DB: 0130 { 0A6 4 ---  0B6 4 ---  0A7 4 ---  0B7 4 --- }
58DC: 0130 { 228 4 ---  238 4 ---  229 4 ---  239 4 --- }
58DD: 0130 { 22A 4 ---  23A 4 ---  22B 4 ---  23B 4 --- }
58DE: 0130 { 22C 4 ---  23C 4 ---  22D 4 ---  23D 4 --- }
58DF: 0130 { 22E 4 ---  23E 4 ---  22F 4 ---  23F 4 --- }
58E0: 0025 { 1FB 7 ---  0F8 0 x--  1FC 7 ---  1EA 7 --- }
58E1: 0130 { 1CD 7 ---  1DD 7 ---  0F8 0 x--  0F8 0 x-- }
58E2: 0020 { 1E2 1 ---  1F2 1 ---  1E3 1 ---  1F3 1 --- }
58E3: 0025 { 1EB 7 ---  1FB 7 ---  1EC 7 ---  1FC 7 --- }
58E4: 0025 { 1ED 7 ---  0F8 0 x--  0F8 0 x--  0F8 0 x-- }
58E5: 0025 { 1ED 7 x--  0F8 0 x--  1FC 7 x--  1EA 7 x-- }
58E6: 0025 { 1FB 7 x--  0F8 0 ---  0F8 0 x--  0F8 0 x-- }
58E7: 0130 { 0F8 0 x--  0F8 0 x--  0CA 4 ---  0A8 4 --- }
58E8: 0130 { 0C0 4 ---  0D0 4 ---  0C1 4 ---  0D1 4 --- }
58E9: 0130 { 0C2 4 ---  0D2 4 ---  0C3 4 ---  0D3 4 --- }
58EA: 0130 { 0C4 4 ---  0D4 4 ---  0C5 4 ---  0D5 4 --- }
58EB: 0130 { 0C6 4 ---  0D6 4 ---  0C7 4 ---  0D7 4 --- }
58EC: 0130 { 248 4 ---  258 4 ---  249 4 ---  259 4 --- }
58ED: 0130 { 24A 4 ---  25A 4 ---  24B 4 ---  25B 4 --- }
58EE: 0130 { 24C 4 ---  25C 4 ---  24D 4 ---  25D 4 --- }
58EF: 0130 { 24E 4 ---  25E 4 ---  24F 4 ---  25F 4 --- }
58F0: 0132 { 180 2 ---  190 2 ---  181 2 ---  191 2 --- }
58F1: 0132 { 182 2 ---  192 2 ---  181 2 ---  191 2 --- }
58F2: 0132 { 182 2 ---  192 2 ---  183 2 ---  193 2 --- }
58F3: 0025 { 0F8 0 x--  0F8 0 x--  1EA 7 ---  0F8 0 x-- }
58F4: 0025 { 1C0 1 ---  1D0 1 ---  1C1 1 ---  1D1 1 --- }
58F5: 0025 { 1E4 1 ---  1F4 1 ---  1E5 1 ---  1F5 1 --- }
58F6: 0130 { 1BC 1 x--  1AC 1 x--  1AA 1 x--  1BA 1 x-- }
58F7: 0130 { 0F8 0 x--  0F8 0 x--  0A9 4 ---  0F8 0 x-- }
58F8: 0130 { 0E0 4 ---  0F0 4 ---  0E1 4 ---  0F1 4 --- }
58F9: 0130 { 0E2 4 ---  0F2 4 ---  0E3 4 ---  0F3 4 --- }
58FA: 0130 { 0E4 4 ---  0F4 4 ---  0E5 4 ---  0F5 4 --- }
58FB: 0130 { 0E6 4 ---  0F6 4 ---  0E7 4 ---  0F7 4 --- }
58FC: 0130 { 268 4 ---  278 4 ---  269 4 ---  279 4 --- }
58FD: 0130 { 26A 4 ---  27A 4 ---  26B 4 ---  27B 4 --- }
58FE: 0130 { 26C 4 ---  27C 4 ---  26D 4 ---  27D 4 --- }
58FF: 0130 { 26E 4 ---  27E 4 ---  26F 4 ---  27F 4 --- }
