6000: 0130 { 1F8 7 ---  1F8 7 ---  1F9 7 ---  1F9 7 --- }
6001: 0130 { 07F 3 ---  1E1 3 ---  07F 3 ---  07F 3 --- }
6002: 0130 { 07F 3 ---  07F 3 ---  07F 3 ---  07F 3 --- }
6003: 0130 { 228 6 ---  26F 6 ---  229 6 ---  27F 6 --- }
6004: 0130 { 238 6 ---  248 6 ---  239 6 ---  249 6 --- }
6005: 0130 { 26D 6 ---  07F 3 ---  26E 6 ---  07F 3 --- }
6006: 0130 { 07F 3 ---  27D 6 ---  07F 3 ---  27E 6 --- }
6007: 0130 { 07F 5 ---  1E4 5 ---  07F 5 ---  1E5 5 --- }
6008: 0130 { 2EF 3 ---  07F 3 ---  2EF 3 ---  07F 3 --- }
6009: 0130 { 1FA 7 ---  1FD 7 ---  1FB 7 ---  1FE 7 --- }
600A: 0130 { 1FC 7 ---  1FF 7 ---  1FC 7 ---  1FF 7 --- }
600B: 0130 { 05E 6 -y-  05C 6 -y-  05F 6 -y-  05D 6 -y- }
600C: 0130 { 190 3 -y-  191 3 -y-  193 3 -y-  183 3 -y- }
600D: 0130 { 192 3 -y-  182 3 -y-  190 3 xy-  191 3 xy- }
600E: 0130 { 28C 3 ---  29C 3 ---  28D 3 ---  29D 3 --- }
600F: 0130 { 060 6 ---  062 6 ---  061 6 ---  063 6 --- }
6010: 0130 { 07F 3 ---  07F 3 ---  1CC 3 ---  1DC 3 --- }
6011: 0130 { 1CD 3 ---  1DD 3 ---  1CE 3 ---  1DE 3 --- }
6012: 0130 { 1CF 3 ---  1DF 3 ---  1E0 3 ---  1F0 3 --- }
6013: 0130 { 07F 3 ---  1F1 3 ---  07F 3 ---  07F 3 --- }
6014: 0130 { 21B 6 --p  208 6 --p  21C 6 --p  209 6 --p }
6015: 0130 { 21D 6 --p  218 6 --p  21E 6 --p  219 6 --p }
6016: 0130 { 21B 6 --p  258 6 --p  21C 6 --p  259 6 --p }
6017: 0130 { 1EA 3 ---  1EA 3 ---  1EA 3 ---  1EA 3 --- }
6018: 0130 { 07F 3 x--  1EA 3 ---  1EA 3 ---  1EA 3 --- }
6019: 0130 { 1EA 3 ---  1EA 3 ---  07F 3 ---  1EA 3 --- }
601A: 0130 { 07F 3 ---  07F 3 ---  07F 3 ---  07F 3 --- }
601B: 0130 { 191 3 ---  190 3 ---  180 3 x--  190 3 x-- }
601C: 0130 { 191 3 ---  190 3 ---  183 3 ---  193 3 --- }
601D: 0130 { 182 3 ---  192 3 ---  191 3 x--  190 3 x-- }
601E: 0130 { 184 3 ---  190 3 ---  195 3 ---  193 3 --- }
601F: 0130 { 194 3 ---  192 3 ---  184 3 x--  190 3 x-- }
6020: 0130 { 07F 3 ---  1D5 3 ---  1C6 3 ---  1D6 3 --- }
6021: 0130 { 1C7 3 ---  1D7 3 ---  1C8 3 ---  1D8 3 --- }
6022: 0130 { 1C9 3 ---  1D9 3 ---  1CA 3 ---  1DA 3 --- }
6023: 0130 { 1CB 3 ---  1DB 3 ---  07F 3 ---  07F 3 --- }
6024: 0130 { 224 6 --p  234 6 --p  225 6 --p  235 6 --p }
6025: 0130 { 226 6 --p  236 6 --p  227 6 --p  237 6 --p }
6026: 0130 { 268 6 --p  278 6 --p  269 6 --p  279 6 --p }
6027: 0130 { 1EA 3 ---  07F 5 x--  1EA 3 ---  1EA 3 --- }
6028: 0130 { 1EA 3 ---  1EA 3 ---  1EA 3 ---  07F 5 --- }
6029: 0130 { 1EA 3 ---  07F 5 ---  07F 5 -y-  1EA 3 --- }
602A: 0130 { 07F 5 xy-  1EA 3 ---  1EA 3 ---  07F 5 x-- }
602B: 0130 { 180 3 ---  190 3 ---  183 3 ---  193 3 --- }
602C: 0130 { 182 3 ---  192 3 ---  183 3 ---  193 3 --- }
602D: 0130 { 182 3 ---  192 3 ---  180 3 x--  190 3 x-- }
602E: 0130 { 18D 3 ---  1D0 3 ---  183 3 ---  193 3 --- }
602F: 0130 { 182 3 ---  192 3 ---  18D 3 x--  1D0 3 x-- }
6030: 0130 { 200 2 ---  210 2 ---  201 2 ---  211 2 --- }
6031: 0130 { 202 2 ---  212 2 ---  203 2 ---  213 2 --- }
6032: 0130 { 26A 6 ---  27A 6 ---  26B 6 ---  27B 6 --- }
6033: 0130 { 26C 6 ---  27C 6 ---  26C 6 x--  27C 6 x-- }
6034: 0130 { 21C 6 x-p  259 6 x-p  21B 6 x-p  258 6 x-p }
6035: 0130 { 21E 6 x-p  219 6 x-p  21D 6 x-p  218 6 x-p }
6036: 0130 { 21C 6 x-p  209 6 x-p  21B 6 x-p  208 6 x-p }
6037: 0130 { 1EA 3 ---  07F 5 ---  07F 5 ---  07F 5 --- }
6038: 0130 { 07F 5 xy-  07F 5 xy-  1EA 3 ---  07F 5 xy- }
6039: 0130 { 07F 5 xy-  07F 5 xy-  07F 5 xy-  1EA 3 --- }
603A: 0130 { 07F 5 xy-  1EA 3 ---  07F 5 xy-  07F 5 xy- }
603B: 0130 { 190 3 -y-  184 3 -y-  193 3 -y-  195 3 -y- }
603C: 0130 { 194 3 ---  192 3 ---  195 3 ---  193 3 --- }
603D: 0130 { 192 3 -y-  194 3 -y-  190 3 xy-  184 3 xy- }
603E: 0130 { 181 3 ---  1D0 3 ---  183 3 ---  193 3 --- }
603F: 0130 { 182 3 ---  192 3 ---  181 3 x--  1D0 3 x-- }
6040: 0130 { 220 2 ---  230 2 ---  221 2 ---  231 2 --- }
6041: 0130 { 222 2 ---  232 2 ---  223 2 ---  233 2 --- }
6042: 0130 { 204 6 ---  214 6 ---  205 6 ---  215 6 --- }
6043: 0130 { 206 6 ---  216 6 ---  207 6 ---  217 6 --- }
6044: 0130 { 269 6 x-p  279 6 x-p  268 6 x-p  278 6 x-p }
6045: 0130 { 227 6 x-p  237 6 x-p  226 6 x-p  236 6 x-p }
6046: 0130 { 225 6 x-p  235 6 x-p  224 6 x-p  234 6 x-p }
6047: 0130 { 240 2 ---  250 2 ---  243 2 ---  253 2 --- }
6048: 0130 { 28D 6 x--  29C 6 ---  28D 6 ---  29D 6 --- }
6049: 0130 { 260 2 ---  270 2 ---  263 2 ---  273 2 --- }
604A: 0130 { 29C 6 -y-  28D 6 xy-  29D 6 -y-  28D 6 -y- }
604B: 0130 { 190 3 -y-  180 3 -y-  193 3 ---  183 3 -y- }
604C: 0130 { 192 3 ---  182 3 -y-  193 3 ---  183 3 -y- }
604D: 0130 { 192 3 ---  182 3 -y-  190 3 xy-  180 3 xy- }
604E: 0130 { 192 3 -y-  186 3 -y-  193 3 -y-  186 3 xy- }
604F: 0130 { 186 3 ---  192 3 ---  186 3 x--  193 3 --- }
6050: 0130 { 240 2 ---  250 2 ---  241 2 ---  251 2 --- }
6051: 0130 { 242 2 ---  252 2 ---  243 2 ---  253 2 --- }
6052: 0130 { 244 2 ---  254 2 ---  245 2 ---  255 2 --- }
6053: 0130 { 246 2 ---  256 2 ---  247 2 ---  257 2 --- }
6054: 0130 { 07F 2 ---  2C3 2 ---  07F 2 ---  2C4 2 --- }
6055: 0130 { 2D3 2 ---  2C5 2 ---  2D4 2 ---  2C6 2 --- }
6056: 0130 { 07F 2 ---  2C7 2 ---  07F 2 ---  2C3 2 x-- }
6057: 0130 { 07F 2 ---  2C2 2 x--  07F 2 ---  2C1 2 x-- }
6058: 0130 { 07F 2 ---  2C0 2 x--  07F 2 ---  2D1 2 x-- }
6059: 0130 { 07F 2 ---  2D0 2 x--  07F 2 ---  2D0 2 x-- }
605A: 0130 { 07F 3 ---  07F 3 ---  07F 3 ---  07F 3 --- }
605B: 0130 { 20A 6 --p  21A 6 --p  20B 6 --p  21B 6 --p }
605C: 0130 { 20C 6 --p  21C 6 --p  20D 6 --p  21D 6 --p }
605D: 0130 { 20E 6 --p  21E 6 --p  20F 6 --p  21F 6 --p }
605E: 0130 { 194 3 ---  192 3 ---  186 3 x--  193 3 --- }
605F: 0130 { 186 3 ---  192 3 ---  195 3 ---  193 3 --- }
6060: 0130 { 260 2 ---  270 2 ---  261 2 ---  271 2 --- }
6061: 0130 { 262 2 ---  272 2 ---  263 2 ---  273 2 --- }
6062: 0130 { 264 2 ---  274 2 ---  265 2 ---  275 2 --- }
6063: 0130 { 266 2 ---  276 2 ---  267 2 ---  277 2 --- }
6064: 0130 { 07F 2 ---  2C3 2 ---  07F 2 ---  2C4 2 --- }
6065: 0130 { 2D5 2 ---  2C5 2 ---  2D6 2 ---  2C6 2 --- }
6066: 0130 { 07F 2 ---  2C7 2 ---  07F 2 ---  2C3 2 x-- }
6067: 0130 { 07F 2 x--  2D0 2 ---  07F 2 x--  2D0 2 --- }
6068: 0130 { 07F 2 x--  2D1 2 ---  07F 2 x--  2C0 2 --- }
6069: 0130 { 07F 2 x--  2C1 2 ---  07F 2 x--  2C2 2 --- }
606A: 0130 { 07F 3 ---  07F 3 ---  07F 3 ---  07F 3 --- }
606B: 0130 { 22A 6 --p  23A 6 --p  22B 6 --p  23B 6 --p }
606C: 0130 { 22C 6 --p  23C 6 --p  22D 6 --p  23D 6 --p }
606D: 0130 { 22E 6 --p  23E 6 --p  22F 6 --p  23F 6 --p }
606E: 0130 { 193 3 xy-  195 3 xy-  192 3 xy-  186 3 xy- }
606F: 0130 { 193 3 xy-  186 3 -y-  192 3 xy-  194 3 xy- }
6070: 0130 { 1E3 3 ---  192 3 ---  195 3 ---  193 3 --- }
6071: 0130 { 194 3 ---  192 3 ---  1E3 3 ---  193 3 --- }
6072: 0130 { 194 3 ---  192 3 ---  195 3 ---  1E3 3 --- }
6073: 0130 { 194 3 ---  1E3 3 ---  195 3 ---  193 3 --- }
6074: 0130 { 1E3 3 ---  192 3 ---  195 3 ---  1C5 3 --- }
6075: 0130 { 2D5 2 ---  2D5 2 ---  2D6 2 ---  2D6 2 --- }
6076: 0130 { 07F 2 ---  2C7 2 ---  07F 2 ---  07F 2 --- }
6077: 0130 { 07F 2 x--  07F 2 x--  07F 2 x--  2C7 2 x-- }
6078: 0130 { 07F 3 ---  07F 3 ---  07F 3 ---  07F 3 --- }
6079: 0130 { 07F 3 ---  07F 3 ---  07F 3 ---  07F 3 --- }
607A: 0130 { 07F 3 ---  07F 3 ---  07F 3 ---  07F 3 --- }
607B: 0130 { 24A 6 --p  25A 6 --p  24B 6 --p  25B 6 --p }
607C: 0130 { 24C 6 --p  25C 6 --p  24D 6 --p  25D 6 --p }
607D: 0130 { 24E 6 --p  25E 6 --p  24F 6 --p  25F 6 --p }
607E: 0130 { 182 3 ---  182 3 -y-  183 3 ---  183 3 -y- }
607F: 0130 { 182 3 ---  186 3 -y-  180 3 x--  190 3 x-- }
6080: 0130 { 1E2 3 ---  192 3 ---  195 3 ---  193 3 --- }
6081: 0130 { 194 3 ---  192 3 ---  1E2 3 ---  193 3 --- }
6082: 0130 { 194 3 ---  192 3 ---  195 3 ---  1E2 3 --- }
6083: 0130 { 194 3 ---  1E2 3 ---  195 3 ---  193 3 --- }
6084: 0130 { 194 3 ---  1E2 3 ---  1E3 3 ---  193 3 --- }
6085: 0130 { 1C4 3 x--  1D4 3 x--  1C3 3 x--  1D3 3 x-- }
6086: 0130 { 19B 7 ---  19B 7 ---  19C 7 ---  19C 7 --- }
6087: 0130 { 1F4 7 ---  1F6 7 ---  1F5 7 ---  1F7 7 --- }
6088: 0130 { 2E0 5 ---  2F0 5 ---  2E1 5 ---  2F1 5 --- }
6089: 0130 { 2E2 5 ---  2F2 5 ---  2E3 5 ---  2F3 5 --- }
608A: 0130 { 284 5 ---  294 5 ---  285 5 ---  295 5 --- }
608B: 0130 { 286 5 ---  296 5 ---  287 5 ---  297 5 --- }
608C: 0130 { 280 5 ---  290 5 ---  281 5 ---  291 5 --- }
608D: 0130 { 282 5 ---  292 5 ---  283 5 ---  293 5 --- }
608E: 0130 { 194 3 ---  182 3 -y-  186 3 x--  183 3 -y- }
608F: 0130 { 190 3 -y-  184 3 -y-  190 3 xy-  184 3 xy- }
6090: 0130 { 1C5 3 ---  192 3 ---  195 3 ---  193 3 --- }
6091: 0130 { 194 3 ---  192 3 ---  1C5 3 ---  193 3 --- }
6092: 0130 { 194 3 ---  192 3 ---  195 3 ---  1C5 3 --- }
6093: 0130 { 194 3 ---  1C5 3 ---  195 3 ---  193 3 --- }
6094: 0130 { 194 3 ---  1C5 3 ---  1E3 3 ---  193 3 --- }
6095: 0130 { 1C3 3 ---  1D3 3 ---  1C4 3 ---  1D4 3 --- }
6096: 0130 { 19B 7 ---  1AB 7 ---  19C 7 ---  1AC 7 --- }
6097: 0130 { 1E9 7 xy-  19B 7 ---  1E9 7 -y-  19C 7 --- }
6098: 0130 { 2E4 5 ---  2F4 5 ---  2E5 5 ---  2F5 5 --- }
6099: 0130 { 2E6 5 ---  2F6 5 ---  2E7 5 ---  2F7 5 --- }
609A: 0130 { 2A4 5 ---  2B4 5 ---  2A5 5 ---  2B5 5 --- }
609B: 0130 { 2A6 5 ---  2B6 5 ---  2A7 5 ---  2B7 5 --- }
609C: 0130 { 2A0 5 ---  2B0 5 ---  2A1 5 ---  2B1 5 --- }
609D: 0130 { 2A2 5 ---  2B2 5 ---  2A3 5 ---  2B3 5 --- }
609E: 0130 { 190 3 -y-  180 3 -y-  186 3 x--  182 3 xy- }
609F: 0130 { 186 3 ---  182 3 -y-  190 3 xy-  180 3 xy- }
60A0: 0130 { 2A8 3 ---  2B8 3 ---  2A9 3 ---  2B9 3 --- }
60A1: 0130 { 2AA 3 ---  2BA 3 ---  2AB 3 ---  2BB 3 --- }
60A2: 0130 { 2AC 3 ---  2BC 3 ---  2AD 3 ---  2BD 3 --- }
60A3: 0130 { 1E8 7 -y-  1E7 7 ---  1E9 7 -y-  188 7 --- }
60A4: 0130 { 1E9 7 xy-  189 7 ---  1E9 7 -y-  189 7 --- }
60A5: 0130 { 1E9 7 xy-  18A 7 ---  1E8 7 xy-  1E7 7 x-- }
60A6: 0130 { 1A9 7 ---  18B 7 ---  199 7 ---  198 7 --- }
60A7: 0130 { 199 7 ---  19A 7 ---  1A9 7 ---  18B 7 --- }
60A8: 0130 { 2EE 5 ---  2FE 5 ---  2EF 2 ---  2FF 6 --- }
60A9: 0130 { 07F 3 ---  07F 3 ---  07F 3 ---  07F 3 --- }
60AA: 0130 { 2CE 5 ---  2DE 5 ---  2CF 5 ---  2DF 5 --- }
60AB: 0130 { 2AE 5 ---  2BE 5 ---  2AF 5 ---  2BF 5 --- }
60AC: 0130 { 28E 5 ---  29E 5 ---  28F 5 ---  29F 5 --- }
60AD: 0130 { 28A 5 ---  29A 5 ---  28B 5 ---  29B 5 --- }
60AE: 0130 { 184 3 ---  190 3 ---  192 3 xy-  186 3 xy- }
60AF: 0130 { 186 3 ---  192 3 ---  190 3 xy-  184 3 xy- }
60B0: 0130 { 2C8 3 ---  2D8 3 ---  2C9 3 ---  2D9 3 --- }
60B1: 0130 { 2CA 3 ---  2DA 3 ---  2CB 3 ---  2DB 3 --- }
60B2: 0130 { 2CC 3 ---  2DC 3 ---  2CD 3 ---  2DD 3 --- }
60B3: 0130 { 1E6 7 ---  1E7 7 ---  198 7 ---  198 7 --- }
60B4: 0130 { 199 7 ---  199 7 ---  199 7 ---  199 7 --- }
60B5: 0130 { 19A 7 ---  19A 7 ---  1E6 7 x--  1E7 7 x-- }
60B6: 0130 { 2EE 5 ---  2FE 5 ---  2C9 2 ---  2D9 2 --- }
60B7: 0130 { 2CC 2 ---  2DC 2 ---  2EE 5 ---  2FE 5 --- }
60B8: 0130 { 2CC 2 ---  2DC 2 ---  2FE 5 ---  2FE 5 --- }
60B9: 0130 { 180 3 ---  191 3 -y-  183 3 ---  183 3 -y- }
60BA: 0130 { 180 3 ---  180 3 -y-  183 3 ---  183 3 -y- }
60BB: 0130 { 182 3 ---  186 3 -y-  183 3 ---  194 3 xy- }
60BC: 0130 { 192 3 -y-  186 3 -y-  193 3 -y-  186 3 xy- }
60BD: 0130 { 192 3 -y-  186 3 -y-  184 3 x--  190 3 x-- }
60BE: 0130 { 180 3 ---  190 3 ---  180 3 x--  190 3 x-- }
60BF: 0130 { 180 3 ---  180 3 -y-  183 3 ---  183 3 -y- }
60C0: 0130 { 2E8 3 ---  2F8 3 ---  2E9 3 ---  2F9 3 --- }
60C1: 0130 { 2EA 3 ---  2FA 3 ---  2EB 3 ---  2FB 3 --- }
60C2: 0130 { 2EC 3 ---  2FC 3 ---  2ED 3 ---  2FD 3 --- }
60C3: 0130 { 1E6 7 ---  1E8 7 ---  1A8 7 ---  1E9 7 --- }
60C4: 0130 { 1A9 7 ---  1E9 7 x--  1A9 7 ---  1E9 7 --- }
60C5: 0130 { 1AA 7 ---  1E9 7 x--  1E6 7 x--  1E8 7 x-- }
60C6: 0130 { 2CA 2 ---  2DA 2 ---  2CB 2 ---  2DB 2 --- }
60C7: 0130 { 2BA 2 ---  2DA 2 ---  2BB 2 ---  2DB 2 --- }
60C8: 0130 { 2FE 5 ---  2FE 5 ---  2C9 2 ---  2D9 2 --- }
60C9: 0130 { 182 3 ---  192 3 ---  183 3 ---  186 3 xy- }
60CA: 0130 { 190 3 -y-  180 3 -y-  186 3 x--  183 3 -y- }
60CB: 0130 { 186 3 ---  186 3 -y-  190 3 xy-  184 3 xy- }
60CC: 0130 { 186 3 ---  192 3 ---  186 3 x--  193 3 --- }
60CD: 0130 { 192 3 -y-  186 3 -y-  184 3 x--  190 3 x-- }
60CE: 0130 { 190 3 -y-  180 3 -y-  190 3 xy-  180 3 xy- }
60CF: 0130 { 183 3 x--  183 3 xy-  180 3 x--  180 3 xy- }
60D0: 0130 { 194 3 ---  194 3 ---  195 3 ---  1E3 3 --- }
60D1: 0130 { 194 3 ---  1C5 3 ---  195 3 ---  195 3 --- }
60D2: 0130 { 194 3 ---  194 3 ---  195 3 ---  1E2 3 --- }
60D3: 0130 { 194 3 ---  1E3 3 ---  195 3 ---  195 3 --- }
60D4: 0130 { 194 3 ---  1E3 3 ---  195 3 ---  1C5 3 --- }
60D5: 0130 { 194 3 ---  1E2 3 ---  195 3 ---  1E3 3 --- }
60D6: 0130 { 2CB 2 ---  2DB 2 ---  288 6 ---  298 6 --- }
60D7: 0130 { 289 6 ---  252 2 ---  289 6 x--  252 2 --- }
60D8: 0130 { 288 6 x--  298 6 ---  2CA 2 ---  2DA 2 --- }
60D9: 0130 { 186 3 ---  186 3 -y-  193 3 -y-  195 3 -y- }
60DA: 0130 { 193 3 xy-  195 3 xy-  186 3 x--  186 3 xy- }
60DB: 0130 { 182 3 ---  186 3 -y-  191 3 x--  190 3 xy- }
60DC: 0130 { 190 3 -y-  184 3 -y-  186 3 x--  192 3 x-- }
60DD: 0130 { 20A 6 --p  21A 6 --p  20B 6 --p  21B 6 --p }
60DE: 0130 { 20C 6 --p  21C 6 --p  20D 6 --p  21D 6 --p }
60DF: 0130 { 20E 6 --p  21E 6 --p  20F 6 --p  21F 6 --p }
60E0: 0130 { 1E3 3 ---  1E2 3 ---  193 3 ---  1C5 3 --- }
60E1: 0130 { 192 3 ---  1E2 3 ---  1E2 3 ---  1C5 3 --- }
60E2: 0130 { 1C5 3 ---  1E3 3 ---  193 3 ---  1E2 3 --- }
60E3: 0130 { 192 3 ---  1C5 3 ---  1C5 3 ---  1E2 3 --- }
60E4: 0130 { 192 3 ---  192 3 ---  1E3 3 ---  1E2 3 --- }
60E5: 0130 { 1C5 3 ---  1E3 3 ---  193 3 ---  193 3 --- }
60E6: 0130 { 2CB 2 ---  2DB 2 ---  2FF 6 ---  2FF 6 --- }
60E7: 0130 { 252 2 ---  252 2 ---  252 2 ---  252 2 --- }
60E8: 0130 { 2FF 6 ---  2FF 6 ---  2CA 2 ---  2DA 2 --- }
60E9: 0130 { 288 6 ---  298 6 ---  289 6 ---  299 6 --- }
60EA: 0130 { 289 6 x--  299 6 x--  288 6 x--  298 6 x-- }
60EB: 0130 { 252 2 ---  252 2 ---  252 2 ---  252 2 --- }
60EC: 0130 { 186 3 ---  182 3 -y-  195 3 ---  183 3 -y- }
60ED: 0130 { 22A 6 --p  23A 6 --p  22B 6 --p  23B 6 --p }
60EE: 0130 { 22C 6 --p  23C 6 --p  22D 6 --p  23D 6 --p }
60EF: 0130 { 22E 6 --p  23E 6 --p  22F 6 --p  23F 6 --p }
60F0: 0130 { 1C5 3 ---  1E3 3 ---  195 3 ---  193 3 --- }
60F1: 0130 { 194 3 ---  192 3 ---  1E3 3 ---  1E2 3 --- }
60F2: 0130 { 1E2 3 ---  1C5 3 ---  195 3 ---  193 3 --- }
60F3: 0130 { 194 3 ---  192 3 ---  1E3 3 ---  1E2 3 --- }
60F4: 0130 { 194 3 ---  192 3 ---  1C5 3 ---  1E2 3 --- }
60F5: 0130 { 1E3 3 ---  1C5 3 ---  195 3 ---  193 3 --- }
60F6: 0130 { 2CB 2 ---  2DB 2 ---  2FF 6 ---  298 6 -y- }
60F7: 0130 { 252 2 ---  252 2 ---  252 2 ---  252 2 --- }
60F8: 0130 { 2FF 6 ---  298 6 -y-  2CA 2 ---  2DA 2 --- }
60F9: 0130 { 2FF 6 ---  2FF 6 ---  299 6 ---  299 6 --- }
60FA: 0130 { 299 6 x--  299 6 x--  2FF 6 x--  2FF 6 x-- }
60FB: 0130 { 2FF 6 ---  288 6 -y-  299 6 -y-  289 6 -y- }
60FC: 0130 { 299 6 xy-  289 6 xy-  2FF 6 x--  288 6 xy- }
60FD: 0130 { 24A 6 --p  25A 6 --p  24B 6 --p  25B 6 --p }
60FE: 0130 { 24C 6 --p  25C 6 --p  24D 6 --p  25D 6 --p }
60FF: 0130 { 24E 6 --p  25E 6 --p  24F 6 --p  25F 6 --p }
