2700: 0025 { 0F8 1 ---  0F8 1 ---  0F8 1 ---  0F8 1 --- }
2701: 0025 { 0F8 1 ---  0F8 1 ---  0F8 1 ---  0F8 1 --- }
2702: 0025 { 0F8 1 ---  0F8 1 ---  0F8 1 ---  0F8 1 --- }
2703: 0025 { 0F8 1 ---  0F8 1 ---  0F8 1 ---  0F8 1 --- }
2704: 0025 { 0F8 1 ---  0F8 1 ---  0F8 1 ---  0F8 1 --- }
2705: 0025 { 0F8 1 ---  0F8 1 ---  0F8 1 ---  0F8 1 --- }
2706: 0025 { 0F8 1 ---  0F8 1 ---  0F8 1 ---  0F8 1 --- }
2707: 0025 { 0F8 1 ---  0F8 1 ---  0F8 1 ---  0F8 1 --- }
2708: 0025 { 0F8 1 ---  0F8 1 ---  0F8 1 ---  0F8 1 --- }
2709: 0025 { 0F8 1 ---  0F8 1 ---  0F8 1 ---  0F8 1 --- }
270A: 0025 { 0F8 1 ---  0F8 1 ---  0F8 1 ---  0F8 1 --- }
270B: 0025 { 0F8 1 ---  0F8 1 ---  0F8 1 ---  0F8 1 --- }
270C: 0025 { 0F8 1 ---  2B3 1 ---  0F8 1 ---  2B4 1 --- }
270D: 0025 { 0F8 1 ---  2B5 1 ---  0F8 1 ---  2B6 1 --- }
270E: ~
270F: ~
2710: 0025 { 0F8 1 ---  0F8 1 ---  0F8 1 ---  0F8 1 --- }
2711: 0025 { 0F8 1 ---  0F8 1 ---  0F8 1 ---  0F8 1 --- }
2712: 0025 { 0F8 1 ---  0F8 1 ---  0F8 1 ---  0F8 1 --- }
2713: 0025 { 0F8 1 ---  0F8 1 ---  0F8 1 ---  0F8 1 --- }
2714: 0025 { 0F8 1 ---  0F8 1 ---  0F8 1 ---  0F8 1 --- }
2715: 0025 { 0F8 1 ---  0F8 1 ---  0F8 1 ---  0F8 1 --- }
2716: 0025 { 0F8 1 ---  0F8 1 ---  0F8 1 ---  0F8 1 --- }
2717: 0025 { 0F8 1 ---  0F8 1 ---  0F8 1 ---  0F8 1 --- }
2718: 0025 { 0F8 1 ---  0F8 1 ---  0F8 1 ---  0F8 1 --- }
2719: 0025 { 0F8 1 ---  0F8 1 ---  0F8 1 ---  0F8 1 --- }
271A: 0025 { 0F8 1 ---  0F8 1 ---  0F8 1 ---  0F8 1 --- }
271B: 0025 { 0F8 1 ---  2BC 1 ---  2B7 1 ---  2BD 1 --- }
271C: 0025 { 2B8 1 ---  2BE 1 ---  2B9 1 ---  2BF 1 --- }
271D: 0025 { 2BA 1 ---  2C0 1 ---  2BB 1 ---  2C1 1 --- }
271E: ~
271F: ~
2720: 0025 { 0F8 1 ---  0F8 1 ---  0F8 1 ---  0F8 1 --- }
2721: 0025 { 0F8 1 ---  0F8 1 ---  0F8 1 ---  0F8 1 --- }
2722: 0025 { 0F8 1 ---  281 1 ---  0F8 1 ---  282 1 --- }
2723: 0025 { 0F8 1 ---  283 1 ---  0F8 1 ---  283 1 --- }
2724: 0025 { 0F8 1 ---  284 1 ---  0F8 1 ---  283 1 --- }
2725: 0025 { 0F8 1 ---  283 1 ---  0F8 1 ---  283 1 --- }
2726: 0025 { 0F8 1 ---  283 1 ---  0F8 1 ---  283 1 --- }
2727: 0025 { 0F8 1 ---  283 1 ---  0F8 1 ---  283 1 --- }
2728: 0025 { 0F8 1 ---  2C9 1 ---  0F8 1 ---  2CA 1 --- }
2729: 0025 { 0F8 1 ---  2CB 1 ---  0F8 1 ---  2CC 1 --- }
272A: 0025 { 2C2 1 ---  2CD 1 ---  2C3 1 ---  2CE 1 --- }
272B: 0025 { 2C4 1 ---  2CF 1 ---  2C5 1 ---  2D0 1 --- }
272C: 0025 { 2C5 1 ---  2D0 1 ---  2C6 1 ---  2D1 1 --- }
272D: 0025 { 2C7 1 ---  2D2 1 ---  2C8 1 ---  2D3 1 --- }
272E: ~
272F: ~
2730: 0025 { 0F8 1 ---  28E 1 ---  0F8 1 ---  28F 1 --- }
2731: 0025 { 285 1 ---  290 1 ---  286 1 ---  291 1 --- }
2732: 0025 { 287 1 ---  292 1 ---  288 1 ---  293 1 --- }
2733: 0020 { 289 1 ---  294 1 ---  28A 1 ---  294 1 x-- }
2734: 0025 { 28B 1 ---  295 1 ---  28C 1 ---  296 1 --- }
2735: 0025 { 28D 1 ---  297 1 ---  28B 1 ---  298 1 --- }
2736: 0025 { 28C 1 ---  299 1 ---  28D 1 ---  29A 1 --- }
2737: 0025 { 28B 1 ---  29B 1 ---  28C 1 ---  299 1 --- }
2738: 0025 { 2D4 1 ---  2DF 1 ---  2D5 1 ---  2E0 1 --- }
2739: 0025 { 2D5 1 ---  2E1 1 ---  2D6 1 ---  2E2 1 --- }
273A: 0025 { 2D7 1 ---  2E3 1 ---  2D8 1 ---  2E4 1 --- }
273B: 0025 { 2D9 1 ---  2E5 1 ---  2DA 1 ---  2E6 1 --- }
273C: 0025 { 2DB 1 ---  2E7 1 ---  2DC 1 ---  2E8 1 --- }
273D: 0025 { 2DD 1 ---  2E9 1 ---  2DE 1 ---  0F8 1 --- }
273E: 0025 { 2C3 4 x--  2CE 4 x--  2C2 4 x--  2CD 4 x-- }
273F: ~
2740: 0025 { 29C 1 ---  2A5 1 ---  29D 1 ---  2A6 1 --- }
2741: 0025 { 29E 1 ---  2A7 1 ---  29F 1 ---  2A8 1 --- }
2742: 0025 { 29F 1 ---  2A9 1 ---  29F 1 ---  2A9 1 --- }
2743: 0020 { 2A0 1 ---  2AA 1 ---  2A0 1 x--  2AA 1 x-- }
2744: 0025 { 2A1 1 ---  2AB 1 ---  2A2 1 ---  2AC 1 --- }
2745: 0025 { 2A3 1 ---  2AD 1 ---  2A4 1 ---  2AE 1 --- }
2746: 0025 { 2A4 1 ---  2AF 1 ---  2A4 1 ---  2AF 1 --- }
2747: 0025 { 2A4 1 ---  2AF 1 ---  2A4 1 ---  2AF 1 --- }
2748: 0025 { 2A4 1 ---  2F3 1 ---  2EA 1 ---  2F4 1 --- }
2749: 0025 { 2EB 1 ---  2F5 1 ---  2EC 1 ---  2F6 1 --- }
274A: 0025 { 2ED 1 ---  2F7 1 ---  2EE 1 ---  2F8 1 --- }
274B: 0025 { 2EF 1 ---  0F8 1 ---  2F0 1 ---  0F8 1 --- }
274C: 0025 { 2F1 1 ---  0F8 1 ---  2F2 1 ---  0F8 1 --- }
274D: 0025 { 0F8 1 ---  0F8 1 ---  0F8 1 ---  0F8 1 --- }
274E: 0025 { 2D8 4 x--  2E4 4 x--  2D7 4 x--  2E3 4 x-- }
274F: ~
2750: 0025 { 0F8 1 ---  0F8 1 ---  0F8 1 ---  0F8 1 --- }
2751: 0025 { 0F8 1 ---  0F8 1 ---  0F8 1 ---  0F8 1 --- }
2752: 0025 { 2F9 5 ---  2FB 5 ---  2FA 5 ---  2FC 5 --- }
2753: 0025 { 0F8 1 ---  0F8 1 ---  0F8 1 ---  0F8 1 --- }
2754: 0025 { 2B0 1 ---  0F8 1 ---  0F8 1 ---  0F8 1 --- }
2755: 0025 { 0F8 1 ---  0F8 1 ---  0F8 1 ---  0F8 1 --- }
2756: 0025 { 2B1 1 ---  0F8 1 ---  2B2 1 ---  0F8 1 --- }
2757: 0025 { 2F9 5 ---  2FB 5 ---  2FA 5 ---  2FC 5 --- }
2758: 0025 { 0F8 1 ---  0F8 1 ---  0F8 1 ---  0F8 1 --- }
2759: 0025 { 0F8 1 ---  0F8 1 ---  0F8 1 ---  0F8 1 --- }
275A: 0025 { 0F8 1 ---  0F8 1 ---  0F8 1 ---  0F8 1 --- }
275B: 0025 { 0F8 1 ---  0F8 1 ---  0F8 1 ---  0F8 1 --- }
275C: 0025 { 0F8 1 ---  0F8 1 ---  0F8 1 ---  0F8 1 --- }
275D: 0025 { 0F8 1 ---  0F8 1 ---  0F8 1 ---  0F8 1 --- }
275E: 0025 { 2EE 4 x--  2F8 4 x--  2ED 4 x--  2F7 4 x-- }
275F: ~
2760: 0105 { 1A4 4 ---  1B4 4 ---  1A5 4 ---  053 5 --- }
2761: 0105 { 1A5 4 ---  053 5 x--  1A6 4 ---  1B6 4 --- }
2762: 0025 { 0F8 4 x--  0F8 4 x--  0F8 4 x--  0F8 4 x-- }
2763: 01C4 { 0F8 5 ---  218 5 ---  216 5 ---  219 5 --- }
2764: 01C5 { 217 5 ---  21A 5 ---  0F8 5 ---  21B 5 --- }
2765: 0025 { 0F8 4 x--  0F8 4 x--  0F8 4 x--  0F8 4 x-- }
2766: 0025 { 0F8 4 x--  2CC 4 x--  0F8 4 x--  2CB 4 x-- }
2767: 0025 { 0F8 4 x--  2CA 4 x--  0F8 4 x--  2C9 4 x-- }
2768: 0025 { 0F8 4 x--  283 4 x--  0F8 4 x--  283 4 x-- }
2769: 0025 { 0F8 4 x--  283 4 x--  0F8 4 x--  283 4 x-- }
276A: 0025 { 0F8 4 x--  283 4 x--  0F8 4 x--  283 4 x-- }
276B: 0025 { 0F8 4 x--  283 4 x--  0F8 4 x--  284 4 x-- }
276C: 0025 { 0F8 4 x--  283 4 x--  0F8 4 x--  283 4 x-- }
276D: 0025 { 0F8 4 x--  282 4 x--  0F8 4 x--  281 4 x-- }
276E: 0025 { 0F8 4 x--  0F8 4 x--  0F8 4 x--  0F8 4 x-- }
276F: 0025 { 0F8 4 x--  0F8 4 x--  0F8 4 x--  0F8 4 x-- }
2770: 0025 { 1B4 4 ---  1C4 4 ---  053 5 -y-  1C5 4 --- }
2771: 0025 { 053 5 xy-  1C5 4 ---  1B6 4 ---  1C6 4 --- }
2772: 01C7 { 0F8 5 ---  21C 5 ---  21C 5 ---  21D 5 --- }
2773: 01EC { 21D 5 ---  27A 5 ---  26A 5 ---  26D 5 --- }
2774: 01ED { 26B 5 ---  27B 5 ---  261 5 ---  27C 5 --- }
2775: 01C6 { 26C 5 ---  27D 5 ---  0F8 5 ---  27E 5 --- }
2776: 0025 { 2D6 4 x--  2E2 4 x--  2D5 4 x--  2E1 4 x-- }
2777: 0025 { 2D5 4 x--  2E0 4 x--  2D4 4 x--  2DF 4 x-- }
2778: 0025 { 28C 4 x--  299 4 x--  28B 4 x--  29B 4 x-- }
2779: 0025 { 28D 4 x--  29A 4 x--  28C 4 x--  299 4 x-- }
277A: 0025 { 28B 4 x--  298 4 x--  28D 4 x--  297 4 x-- }
277B: 0025 { 28C 4 x--  296 4 x--  28B 4 x--  295 4 x-- }
277C: 0025 { 28A 4 x--  294 4 ---  289 4 x--  294 4 x-- }
277D: 0025 { 288 4 x--  293 4 x--  287 4 x--  292 4 x-- }
277E: 0025 { 286 4 x--  291 4 x--  285 4 x--  290 4 x-- }
277F: 0025 { 0F8 4 x--  28F 4 x--  0F8 4 x--  28E 4 x-- }
2780: ~
2781: 01C7 { 0F8 5 ---  21C 5 ---  21C 5 ---  21D 5 --- }
2782: 01EE { 21D 5 ---  27A 5 ---  27A 5 ---  26D 5 --- }
2783: 0159 { 26D 5 ---  261 5 ---  261 5 ---  262 5 --- }
2784: 015A { 262 5 ---  26E 5 ---  263 5 ---  26F 5 --- }
2785: 01EF { 271 5 ---  27F 5 ---  272 5 ---  0F8 5 --- }
2786: 0025 { 2EC 4 x--  2F6 4 x--  2EB 4 x--  2F5 4 x-- }
2787: 0025 { 2EA 4 x--  2F4 4 x--  2A4 4 x--  2F3 4 x-- }
2788: 0025 { 2A4 4 x--  2AF 4 x--  2A4 4 x--  2AF 4 x-- }
2789: 0025 { 2A4 4 x--  2AF 4 x--  2A4 4 x--  2AF 4 x-- }
278A: 0025 { 2A4 4 x--  2AE 4 x--  2A3 4 x--  2AD 4 x-- }
278B: 0025 { 2A2 4 x--  2AC 4 x--  2A1 4 x--  2AB 4 x-- }
278C: 0025 { 2A0 4 ---  2AA 4 ---  2A0 4 x--  2AA 4 x-- }
278D: 0025 { 29F 4 x--  2A9 4 x--  29F 4 x--  2A9 4 x-- }
278E: 0025 { 29F 4 x--  2A8 4 x--  29E 4 x--  2A7 4 x-- }
278F: 0025 { 29D 4 x--  2A6 4 x--  29C 4 x--  2A5 4 x-- }
2790: 01C7 { 0F8 5 ---  21C 5 ---  21C 5 ---  21D 5 --- }
2791: 01EE { 21D 5 ---  27A 5 ---  27A 5 ---  26D 5 --- }
2792: 0159 { 26D 5 ---  261 5 ---  261 5 ---  262 5 --- }
2793: 015B { 262 5 ---  26E 5 ---  26E 5 ---  26F 5 --- }
2794: 015C { 26F 5 ---  273 5 ---  273 5 ---  0F8 5 --- }
2795: ~
2796: 0025 { 0F8 4 x--  0F8 4 x--  0F8 4 x--  0F8 4 x-- }
2797: 0025 { 0F8 4 x--  0F8 4 x--  0F8 4 x--  0F8 4 x-- }
2798: 0025 { 2FA 7 x--  2FC 7 x--  2F9 7 x--  2FB 7 x-- }
2799: 0025 { 2B2 4 x--  0F8 4 x--  2B1 4 x--  0F8 4 x-- }
279A: 0025 { 0F8 4 x--  0F8 4 x--  0F8 4 x--  0F8 4 x-- }
279B: 0025 { 0F8 4 x--  0F8 4 x--  2B0 4 x--  0F8 4 x-- }
279C: 0025 { 0F8 4 x--  0F8 4 x--  0F8 4 x--  0F8 4 x-- }
279D: 0025 { 2FA 7 x--  2FC 7 x--  2F9 7 x--  2FB 7 x-- }
279E: 0025 { 0F8 4 x--  0F8 4 x--  0F8 4 x--  0F8 4 x-- }
279F: 0025 { 0F8 4 x--  0F8 4 x--  0F8 4 x--  0F8 4 x-- }
27A0: 0105 { 2FF 6 ---  2FF 6 ---  2FF 6 x--  2FF 6 x-- }
27A1: ~
27A2: ~
27A3: ~
27A4: ~
27A5: 0025 { 0F8 2 ---  0F8 2 ---  0F8 2 ---  081 2 --- }
27A6: 0025 { 0F8 2 ---  081 2 x--  0F8 2 ---  0F8 2 --- }
27A7: 0105 { 0AE 5 ---  0BE 5 ---  0AF 5 ---  0BF 5 --- }
27A8: 0105 { 2FF 6 ---  2FF 6 ---  2FF 6 x--  2FF 6 x-- }
27A9: 0025 { 0F8 0 ---  0F8 0 ---  0F8 0 ---  266 0 --- }
27AA: 0025 { 0F8 0 ---  265 0 ---  0F8 0 ---  0F8 0 --- }
27AB: ~
27AC: 0025 { 2FD 3 ---  2FE 3 ---  2FD 3 x--  2FE 3 x-- }
27AD: 0025 { 0F8 0 ---  266 0 ---  0F8 0 ---  265 0 --- }
27AE: 0025 { 1BE 2 ---  1CE 2 ---  1BF 2 ---  095 3 --- }
27AF: 0025 { 1BF 2 ---  096 3 ---  1CF 2 ---  1CE 2 --- }
27B0: ~
27B1: ~
27B2: ~
27B3: 0025 { 220 4 ---  230 4 ---  24F 4 ---  25F 4 --- }
27B4: 0196 { 0F8 2 ---  082 2 ---  081 2 ---  083 2 --- }
27B5: 019B { 082 2 ---  086 2 ---  083 2 ---  087 2 --- }
27B6: 01A0 { 084 2 ---  088 2 ---  085 2 ---  089 2 --- }
27B7: 01A5 { 081 2 x--  084 2 ---  0F8 2 ---  085 2 --- }
27B8: 0025 { 0F8 0 ---  0F8 0 ---  0F8 0 ---  267 0 --- }
27B9: 0130 { 221 0 ---  270 0 ---  223 0 ---  233 0 --- }
27BA: 0130 { 222 0 ---  232 0 ---  221 0 x--  270 0 x-- }
27BB: 0025 { 0F8 0 ---  267 0 x--  0F8 0 ---  0F8 0 --- }
27BC: 0025 { 2FE 3 ---  2FE 3 ---  2FE 3 x--  2FE 3 x-- }
27BD: 0100 { 222 0 ---  232 0 ---  223 0 ---  233 0 --- }
27BE: 0025 { 1CE 2 ---  1CE 2 ---  095 3 ---  095 3 --- }
27BF: 0025 { 096 3 ---  096 3 ---  1CE 2 ---  1CE 2 --- }
27C0: ~
27C1: ~
27C2: ~
27C3: ~
27C4: 0025 { 08D 2 ---  091 2 ---  08E 2 ---  087 2 --- }
27C5: 0025 { 08F 2 ---  086 2 ---  08E 2 ---  087 2 --- }
27C6: 0025 { 08A 2 ---  088 2 ---  08B 2 ---  089 2 --- }
27C7: 0025 { 08A 2 ---  088 2 ---  08C 2 ---  090 2 --- }
27C8: 0025 { 0F8 0 ---  0F8 0 ---  277 0 ---  267 0 --- }
27C9: 0130 { 260 0 ---  270 0 ---  235 0 ---  233 0 --- }
27CA: 0130 { 234 0 ---  232 0 ---  260 0 x--  270 0 x-- }
27CB: 0025 { 277 0 x--  267 0 x--  0F8 0 ---  0F8 0 --- }
27CC: 0196 { 0F8 0 ---  23B 0 ---  0F8 0 ---  23C 0 --- }
27CD: 019B { 23B 0 ---  23D 0 ---  22E 0 ---  23E 0 --- }
27CE: 01A0 { 22E 0 x--  23E 0 x--  23B 0 x--  23D 0 x-- }
27CF: 01A5 { 0F8 0 ---  23C 0 x--  0F8 0 ---  23B 0 x-- }
27D0: 0039 { 0A0 0 ---  0A2 0 ---  0A1 0 ---  0A3 0 --- }
27D1: 003A { 0A2 0 ---  0A2 0 ---  0A3 0 ---  0A3 0 --- }
27D2: 003C { 0A0 2 --p  0A2 2 --p  0A1 2 --p  0A3 2 --p }
27D3: 003D { 0A2 2 --p  0A2 2 --p  0A3 2 --p  0A3 2 --p }
27D4: ~
27D5: 0025 { 092 2 ---  094 2 ---  08E 2 ---  087 2 --- }
27D6: 0025 { 08A 2 ---  088 2 ---  08B 2 ---  089 2 --- }
27D7: 0025 { 08A 2 ---  088 2 ---  08C 2 ---  090 2 --- }
27D8: 0025 { 0F8 0 ---  0F8 0 ---  277 0 ---  0F8 0 --- }
27D9: 0130 { 260 0 ---  221 0 -y-  235 0 ---  222 0 xy- }
27DA: 0130 { 234 0 ---  223 0 xy-  260 0 x--  221 0 xy- }
27DB: 0025 { 277 0 x--  0F8 0 ---  0F8 0 ---  0F8 0 --- }
27DC: 01DE { 22C 0 ---  232 0 ---  253 0 ---  233 0 --- }
27DD: 01E6 { 234 0 ---  232 0 ---  235 0 ---  233 0 --- }
27DE: 01E6 { 234 0 ---  232 0 ---  235 0 ---  233 0 --- }
27DF: 01E0 { 253 0 x--  232 0 ---  22C 0 x--  233 0 --- }
27E0: ~
27E1: ~
27E2: ~
27E3: ~
27E4: ~
27E5: 0025 { 08D 2 ---  091 2 ---  08E 2 ---  087 2 --- }
27E6: 0025 { 08A 2 ---  088 2 ---  08B 2 ---  089 2 --- }
27E7: 0025 { 08A 2 ---  088 2 ---  093 2 ---  095 2 --- }
27E8: ~
27E9: 0025 { 0F8 0 ---  0F8 0 ---  265 0 xy-  0F8 0 --- }
27EA: 0025 { 266 0 xy-  0F8 0 ---  0F8 0 ---  0F8 0 --- }
27EB: ~
27EC: ~
27ED: ~
27EE: ~
27EF: ~
27F0: ~
27F1: ~
27F2: ~
27F3: ~
27F4: ~
27F5: ~
27F6: ~
27F7: ~
27F8: ~
27F9: ~
27FA: ~
27FB: ~
27FC: ~
27FD: ~
27FE: ~
27FF: ~
