0073:      { 1F0 5 -yp  1F0 5 --p  1F1 5 -yp  1F1 5 --p }
0074:      { 1F1 5 -yp  1F1 5 --p  1F1 5 -yp  1F1 5 --p }
0075:      { 1F1 5 -yp  1F1 5 --p  1F2 5 -yp  1F2 5 --p }
0076:      { 1CF 7 --p  0F8 7 ---  1CF 7 --p  0F8 7 --- }
0077:      { 1CB 5 --p  1D7 5 --p  1CC 5 --p  1D8 5 --p }
0078:      { 1CD 5 --p  1D9 5 --p  1CC 5 --p  1D8 5 --p }
0079:      { 1CD 5 --p  1D9 5 --p  1CE 5 --p  1DA 5 --p }
007A:      { 1D7 5 -yp  1CB 5 -yp  1D8 5 -yp  1CC 5 -yp }
007B:      { 1D9 5 -yp  1CD 5 -yp  1D8 5 -yp  1CC 5 -yp }
007C:      { 1D9 5 -yp  1CD 5 -yp  1DA 5 -yp  1CE 5 -yp }
007D:      { 1E3 5 -yp  1E3 5 --p  1F1 5 -yp  1F1 5 --p }
007E:      { 1F1 5 -yp  1F1 5 --p  1E3 5 -yp  1E3 5 --p }
007F:      { 1F0 5 -yp  1F0 5 --p  1E3 5 -yp  1E3 5 --p }
0080:      { 1E3 5 -yp  1E3 5 --p  1F2 5 -yp  1F2 5 --p }
0081:      { 1E6 6 --p  1E8 6 --p  1D2 5 -yp  1C2 5 -yp }
0082:      { 1D1 5 -yp  1C1 5 -yp  1D2 5 -yp  1C2 5 -yp }
0083:      { 1D1 5 -yp  1C1 5 -yp  1E7 6 --p  1E9 6 --p }
0084:      { 1E8 6 -yp  1E6 6 -yp  1C2 5 --p  1D2 5 --p }
0085:      { 1C1 5 --p  1D1 5 --p  1C2 5 --p  1D2 5 --p }
0086:      { 1C1 5 --p  1D1 5 --p  1E9 6 -yp  1E7 6 -yp }
0087:      { 000 0 ---  000 0 ---  000 0 ---  000 0 --- }
0088:      { 000 0 ---  000 0 ---  000 0 ---  000 0 --- }
0089:      { 000 0 ---  000 0 ---  000 0 ---  000 0 --- }
008A:      { 000 0 ---  000 0 ---  000 0 ---  000 0 --- }
008B:      { 000 0 ---  000 0 ---  000 0 ---  000 0 --- }
008C:      { 000 0 ---  000 0 ---  000 0 ---  000 0 --- }
008D:      { 000 0 ---  000 0 ---  000 0 ---  000 0 --- }
008E:      { 000 0 ---  000 0 ---  000 0 ---  000 0 --- }
008F:      { 000 0 ---  000 0 ---  000 0 ---  000 0 --- }
0090:      { 000 0 ---  000 0 ---  000 0 ---  000 0 --- }
0091:      { 000 0 ---  000 0 ---  000 0 ---  000 0 --- }
0092:      { 000 0 ---  000 0 ---  000 0 ---  000 0 --- }
0093:      { 000 0 ---  000 0 ---  000 0 ---  000 0 --- }
0094:      { 000 0 ---  000 0 ---  000 0 ---  000 0 --- }
0095:      { 000 0 ---  000 0 ---  000 0 ---  000 0 --- }
0096:      { 000 0 ---  000 0 ---  000 0 ---  000 0 --- }
0097:      { 000 0 ---  000 0 ---  000 0 ---  000 0 --- }
0098:      { 000 0 ---  000 0 ---  000 0 ---  000 0 --- }
0099:      { 000 0 ---  000 0 ---  000 0 ---  000 0 --- }
009A:      { 000 0 ---  000 0 ---  000 0 ---  000 0 --- }
009B:      { 000 0 ---  000 0 ---  000 0 ---  000 0 --- }
009C:      { 000 0 ---  000 0 ---  000 0 ---  000 0 --- }
009D:      { 000 0 ---  000 0 ---  000 0 ---  000 0 --- }
009E:      { 000 0 ---  000 0 ---  000 0 ---  000 0 --- }
009F:      { 000 0 ---  000 0 ---  000 0 ---  000 0 --- }
00A0:      { 000 0 ---  000 0 ---  000 0 ---  000 0 --- }
00A1:      { 000 0 ---  000 0 ---  000 0 ---  000 0 --- }
00A2:      { 000 0 ---  000 0 ---  000 0 ---  000 0 --- }
00A3:      { 000 0 ---  000 0 ---  000 0 ---  000 0 --- }
00A4:      { 000 0 ---  000 0 ---  000 0 ---  000 0 --- }
00A5:      { 000 0 ---  000 0 ---  000 0 ---  000 0 --- }
00A6:      { 000 0 ---  000 0 ---  000 0 ---  000 0 --- }
00A7:      { 000 0 ---  000 0 ---  000 0 ---  000 0 --- }
00A8:      { 000 0 ---  000 0 ---  000 0 ---  000 0 --- }
00A9:      { 000 0 ---  000 0 ---  000 0 ---  000 0 --- }
00AA:      { 000 0 ---  000 0 ---  000 0 ---  000 0 --- }
00AB:      { 000 0 ---  000 0 ---  000 0 ---  000 0 --- }
00AC:      { 000 0 ---  000 0 ---  000 0 ---  000 0 --- }
00AD:      { 000 0 ---  000 0 ---  000 0 ---  000 0 --- }
00AE:      { 000 0 ---  000 0 ---  000 0 ---  000 0 --- }
00AF:      { 000 0 ---  000 0 ---  000 0 ---  000 0 --- }
00B0:      { 000 0 ---  000 0 ---  000 0 ---  000 0 --- }
00B1:      { 000 0 ---  000 0 ---  000 0 ---  000 0 --- }
00B2:      { 000 0 ---  000 0 ---  000 0 ---  000 0 --- }
00B3:      { 000 0 ---  000 0 ---  000 0 ---  000 0 --- }
00B4:      { 000 0 ---  000 0 ---  000 0 ---  000 0 --- }
00B5:      { 000 0 ---  000 0 ---  000 0 ---  000 0 --- }
00B6:      { 000 0 ---  000 0 ---  000 0 ---  000 0 --- }
00B7:      { 000 0 ---  000 0 ---  000 0 ---  000 0 --- }
00B8:      { 000 0 ---  000 0 ---  000 0 ---  000 0 --- }
00B9:      { 000 0 ---  000 0 ---  000 0 ---  000 0 --- }
00BA:      { 000 0 ---  000 0 ---  000 0 ---  000 0 --- }
00BB:      { 000 0 ---  000 0 ---  000 0 ---  000 0 --- }
00BC:      { 000 0 ---  000 0 ---  000 0 ---  000 0 --- }
00BD:      { 000 0 ---  000 0 ---  000 0 ---  000 0 --- }
00BE:      { 000 0 ---  000 0 ---  000 0 ---  000 0 --- }
00BF:      { 000 0 ---  000 0 ---  000 0 ---  000 0 --- }
00C0:      { 000 0 ---  000 0 ---  000 0 ---  000 0 --- }
00C1:      { 000 0 ---  000 0 ---  000 0 ---  000 0 --- }
00C2:      { 000 0 ---  000 0 ---  000 0 ---  000 0 --- }
00C3:      { 000 0 ---  000 0 ---  000 0 ---  000 0 --- }
00C4:      { 000 0 ---  000 0 ---  000 0 ---  000 0 --- }
00C5:      { 000 0 ---  000 0 ---  000 0 ---  000 0 --- }
00C6:      { 000 0 ---  000 0 ---  000 0 ---  000 0 --- }
00C7:      { 000 0 ---  000 0 ---  000 0 ---  000 0 --- }
00C8:      { 000 0 ---  000 0 ---  000 0 ---  000 0 --- }
00C9:      { 000 0 ---  000 0 ---  000 0 ---  000 0 --- }
00CA:      { 000 0 ---  000 0 ---  000 0 ---  000 0 --- }
00CB:      { 000 0 ---  000 0 ---  000 0 ---  000 0 --- }
00CC:      { 000 0 ---  000 0 ---  000 0 ---  000 0 --- }
00CD:      { 000 0 ---  000 0 ---  000 0 ---  000 0 --- }
00CE:      { 000 0 ---  000 0 ---  000 0 ---  000 0 --- }
00CF:      { 000 0 ---  000 0 ---  000 0 ---  000 0 --- }
00D0:      { 000 0 ---  000 0 ---  000 0 ---  000 0 --- }
00D1:      { 000 0 ---  000 0 ---  000 0 ---  000 0 --- }
00D2:      { 000 0 ---  000 0 ---  000 0 ---  000 0 --- }
00D3:      { 000 0 ---  000 0 ---  000 0 ---  000 0 --- }
00D4:      { 000 0 ---  000 0 ---  000 0 ---  000 0 --- }
00D5:      { 000 0 ---  000 0 ---  000 0 ---  000 0 --- }
00D6:      { 000 0 ---  000 0 ---  000 0 ---  000 0 --- }
00D7:      { 000 0 ---  000 0 ---  000 0 ---  000 0 --- }
00D8:      { 000 0 ---  000 0 ---  000 0 ---  000 0 --- }
00D9:      { 000 0 ---  000 0 ---  000 0 ---  000 0 --- }
00DA:      { 000 0 ---  000 0 ---  000 0 ---  000 0 --- }
00DB:      { 000 0 ---  000 0 ---  000 0 ---  000 0 --- }
00DC:      { 000 0 ---  000 0 ---  000 0 ---  000 0 --- }
00DD:      { 000 0 ---  000 0 ---  000 0 ---  000 0 --- }
00DE:      { 000 0 ---  000 0 ---  000 0 ---  000 0 --- }
00DF:      { 000 0 ---  000 0 ---  000 0 ---  000 0 --- }
00E0:      { 000 0 ---  000 0 ---  000 0 ---  000 0 --- }
00E1:      { 000 0 ---  000 0 ---  000 0 ---  000 0 --- }
00E2:      { 000 0 ---  000 0 ---  000 0 ---  000 0 --- }
00E3:      { 000 0 ---  000 0 ---  000 0 ---  000 0 --- }
00E4:      { 000 0 ---  000 0 ---  000 0 ---  000 0 --- }
00E5:      { 000 0 ---  000 0 ---  000 0 ---  000 0 --- }
00E6:      { 000 0 ---  000 0 ---  000 0 ---  000 0 --- }
00E7:      { 000 0 ---  000 0 ---  000 0 ---  000 0 --- }
00E8:      { 000 0 ---  000 0 ---  000 0 ---  000 0 --- }
00E9:      { 000 0 ---  000 0 ---  000 0 ---  000 0 --- }
00EA:      { 000 0 ---  000 0 ---  000 0 ---  000 0 --- }
00EB:      { 000 0 ---  000 0 ---  000 0 ---  000 0 --- }
00EC:      { 000 0 ---  000 0 ---  000 0 ---  000 0 --- }
00ED:      { 000 0 ---  000 0 ---  000 0 ---  000 0 --- }
00EE:      { 000 0 ---  000 0 ---  000 0 ---  000 0 --- }
00EF:      { 000 0 ---  000 0 ---  000 0 ---  000 0 --- }
00F0:      { 000 0 ---  000 0 ---  000 0 ---  000 0 --- }
00F1:      { 000 0 ---  000 0 ---  000 0 ---  000 0 --- }
00F2:      { 000 0 ---  000 0 ---  000 0 ---  000 0 --- }
00F3:      { 000 0 ---  000 0 ---  000 0 ---  000 0 --- }
00F4:      { 000 0 ---  000 0 ---  000 0 ---  000 0 --- }
00F5:      { 000 0 ---  000 0 ---  000 0 ---  000 0 --- }
00F6:      { 000 0 ---  000 0 ---  000 0 ---  000 0 --- }
00F7:      { 000 0 ---  000 0 ---  000 0 ---  000 0 --- }
00F8:      { 000 0 ---  000 0 ---  000 0 ---  000 0 --- }
00F9:      { 000 0 ---  000 0 ---  000 0 ---  000 0 --- }
00FA:      { 000 0 ---  000 0 ---  000 0 ---  000 0 --- }
00FB:      { 000 0 ---  000 0 ---  000 0 ---  000 0 --- }
00FC:      { 000 0 ---  000 0 ---  000 0 ---  000 0 --- }
00FD:      { 000 0 ---  000 0 ---  000 0 ---  000 0 --- }
00FE:      { 000 0 ---  000 0 ---  000 0 ---  000 0 --- }
00FF:      { 000 0 ---  000 0 ---  000 0 ---  000 0 --- }
0107:      { 000 0 ---  000 0 ---  000 0 ---  000 0 --- }
0108:      { 000 0 ---  000 0 ---  000 0 ---  000 0 --- }
0109:      { 000 0 ---  000 0 ---  000 0 ---  000 0 --- }
010A:      { 000 0 ---  000 0 ---  000 0 ---  000 0 --- }
010B:      { 000 0 ---  000 0 ---  000 0 ---  000 0 --- }
010C:      { 000 0 ---  000 0 ---  000 0 ---  000 0 --- }
010D:      { 000 0 ---  000 0 ---  000 0 ---  000 0 --- }
010E:      { 000 0 ---  000 0 ---  000 0 ---  000 0 --- }
010F:      { 000 0 ---  000 0 ---  000 0 ---  000 0 --- }
0110:      { 000 0 ---  000 0 ---  000 0 ---  000 0 --- }
0153:      { 1F4 4 ---  1F6 4 ---  1F5 4 ---  1F7 4 --- }
0154:      { 1F8 4 ---  1F8 4 ---  1F9 4 ---  1F9 4 --- }
0155:      { 1F6 4 -y-  1F4 4 -y-  1F7 4 -y-  1F5 4 -y- }
0156:      { 1FA 4 ---  1FD 4 ---  1FB 4 ---  1FE 4 --- }
0157:      { 1FC 4 ---  1FF 4 ---  1FC 4 ---  1FF 4 --- }
0158:      { 1FB 4 x--  1FE 4 x--  1FA 4 x--  1FD 4 x-- }
0159:      { 04A 3 --p  0FB 3 --p  04B 3 --p  0FB 3 --p }
015A:      { 04A 3 --p  0FB 3 --p  048 3 --p  049 3 --p }
015B:      { 0FB 3 --p  0FB 3 --p  049 3 --p  049 3 --p }
015C:      { 1C7 2 --p  1DB 6 --p  1C8 2 --p  1DC 6 --p }
015D:      { 1C7 2 --p  1DC 6 --p  1C8 2 --p  1DC 6 --p }
015E:      { 1C7 2 --p  1DC 6 --p  1C8 2 --p  1DF 6 --p }
015F:      { 1DE 2 ---  1B0 2 ---  1C8 2 ---  1CA 2 --- }
0160:      { 1C7 2 ---  1B0 2 ---  1C8 2 ---  1CA 2 --- }
0161:      { 1C8 2 ---  1CA 2 ---  1C8 2 ---  1CA 2 --- }
0162:      { 1F0 5 -yp  1F0 5 --p  1F1 5 -yp  1F1 5 --p }
0163:      { 1F1 5 -yp  1F1 5 --p  1F1 5 -yp  1F1 5 --p }
0164:      { 1F1 5 -yp  1F1 5 --p  1F2 5 -yp  1F2 5 --p }
0165:      { 192 2 -y-  194 2 -y-  193 2 -y-  195 2 -y- }
0166:      { 1E0 4 ---  1E3 4 ---  1E1 4 ---  1C3 4 --- }
0167:      { 1E4 4 ---  1C4 4 ---  1E2 4 ---  0FA 7 --- }
0168:      { 0FA 7 ---  1E2 4 xy-  1D3 4 ---  0FA 7 --- }
0169:      { 1D4 4 ---  0FA 7 ---  0FA 7 ---  1E2 4 -y- }
016A:      { 026 5 ---  036 5 ---  026 5 x--  036 5 x-- }
016B:      { 026 6 ---  036 6 ---  026 6 x--  036 6 x-- }
016C:      { 026 7 ---  036 7 ---  026 7 x--  036 7 x-- }
016D:      { 027 7 ---  037 7 ---  027 7 x--  037 7 x-- }
