8700:      { 278 3 ---  284 3 ---  244 3 x--  21C 3 x-- }
8701:      { 291 3 ---  299 3 ---  258 3 ---  264 3 --- }
8702:      { 293 3 ---  295 3 ---  285 3 ---  29A 3 --- }
8703:      { 297 3 ---  29B 3 ---  298 3 ---  29C 3 --- }
8704:      { 14A 3 x--  154 3 ---  28A 3 ---  25B 3 --- }
8705:      { 28B 3 ---  25C 3 ---  28C 3 ---  25D 3 --- }
8706:      { 28D 3 ---  25E 3 ---  25A 3 ---  22A 3 --- }
8707:      { 28E 3 ---  25F 3 ---  28F 3 ---  260 3 --- }
8708:      { 222 3 x--  229 3 x--  26D 3 ---  26D 3 --- }
8709:      { 258 3 ---  258 3 ---  259 3 ---  294 3 --- }
870A:      { 259 3 x--  294 3 x--  258 3 x--  258 3 x-- }
870B:      { 28A 3 ---  25B 3 ---  28B 3 ---  25C 3 --- }
870C:      { 28C 3 ---  25D 3 ---  28D 3 ---  25E 3 --- }
870D:      { 25A 3 ---  2A6 3 ---  28E 3 ---  2A7 3 --- }
870E:      { 28F 3 ---  2A8 3 ---  222 3 x--  224 3 --- }
870F:      { 204 3 x--  225 3 ---  204 3 ---  226 3 --- }
8710:      { 29D 3 ---  227 3 ---  29E 3 ---  228 3 --- }
8711:      { 29F 3 ---  209 3 ---  290 3 ---  286 3 --- }
8712:      { 296 3 ---  295 3 ---  2A0 3 ---  2A9 3 --- }
8713:      { 2A1 3 ---  234 3 ---  2A2 3 ---  22B 3 --- }
8714:      { 224 3 ---  22C 3 ---  225 3 ---  2AA 3 --- }
8715:      { 268 3 ---  100 3 ---  269 3 ---  271 3 --- }
8716:      { 2A3 3 ---  271 3 ---  2A4 3 ---  272 3 --- }
8717:      { 2A5 3 ---  261 3 ---  284 3 ---  262 3 --- }
8718:      { 21C 3 x--  263 3 ---  279 3 ---  285 3 --- }
8719:      { 258 3 ---  24D 3 ---  259 3 ---  24E 3 --- }
871A:      { 259 3 x--  24E 3 x--  258 3 x--  24D 3 x-- }
871B:      { 2A3 3 ---  239 3 ---  22B 3 ---  23A 3 --- }
871C:      { 22C 3 ---  23B 3 ---  0F8 3 ---  241 3 --- }
871D:      { 22B 3 ---  22B 3 ---  22C 3 ---  22C 3 --- }
871E:      { 22D 3 ---  23C 3 ---  22E 3 ---  23D 3 --- }
871F:      { 22F 3 ---  22F 3 ---  230 3 ---  230 3 --- }
8720:      { 231 3 ---  231 3 ---  292 3 ---  292 3 --- }
8721:      { 263 3 x--  26F 3 x--  262 3 x--  26E 3 x-- }
8722:      { 261 3 x--  26D 3 x--  272 3 x--  27E 3 x-- }
8723:      { 271 3 x--  27D 3 x--  271 3 ---  27D 3 --- }
8724:      { 272 3 ---  27E 3 ---  27D 3 ---  288 3 --- }
8725:      { 27D 3 ---  288 3 ---  27E 3 ---  289 3 --- }
8726:      { 26D 3 ---  279 3 ---  26E 3 ---  27A 3 --- }
8727:      { 26F 3 ---  27B 3 ---  26D 3 ---  26D 3 --- }
8728:      { 258 3 ---  258 3 ---  259 3 ---  259 3 --- }
8729:      { 259 3 x--  259 3 x--  258 3 x--  258 3 x-- }
872A:      { 246 3 ---  250 3 ---  247 3 ---  251 3 --- }
872B:      { 248 3 ---  252 3 ---  249 3 ---  251 3 --- }
872C:      { 23C 3 ---  249 3 ---  23C 3 ---  21D 3 --- }
872D:      { 240 3 ---  24C 3 ---  292 3 ---  292 3 --- }
872E:      { 27B 3 x--  27B 3 x--  27A 3 x--  286 3 x-- }
872F:      { 279 3 x--  285 3 x--  289 3 x--  293 3 x-- }
8730:      { 288 3 x--  292 3 x--  288 3 ---  292 3 --- }
8731:      { 289 3 ---  293 3 ---  292 3 ---  286 3 --- }
8732:      { 292 3 ---  286 3 ---  293 3 ---  295 3 --- }
8733:      { 285 3 ---  26D 3 ---  286 3 ---  290 3 --- }
8734:      { 27B 3 ---  27B 3 ---  29D 3 ---  29E 3 --- }
8735:      { 28A 3 ---  273 3 ---  29A 3 x--  29A 3 x-- }
8736:      { 25E 3 xy-  28D 3 xy-  25D 3 xy-  28C 3 xy- }
8737:      { 25C 3 xy-  28B 3 xy-  25B 3 xy-  28A 3 xy- }
8738:      { 256 3 ---  229 3 x--  258 3 x--  264 3 x-- }
8739:      { 27B 3 x--  27B 3 x--  26E 3 x--  27A 3 x-- }
873A:      { 26D 3 x--  279 3 x--  27E 3 x--  289 3 x-- }
873B:      { 27D 3 x--  288 3 x--  27D 3 ---  288 3 --- }
873C:      { 27E 3 ---  289 3 ---  288 3 ---  292 3 --- }
873D:      { 288 3 ---  292 3 ---  289 3 ---  293 3 --- }
873E:      { 279 3 ---  285 3 ---  27A 3 ---  286 3 --- }
873F:      { 27B 3 ---  27B 3 ---  29D 3 ---  0F8 3 --- }
8740:      { 258 3 ---  264 3 ---  259 3 ---  294 3 --- }
8741:      { 259 3 x--  294 3 x--  258 3 x--  264 3 x-- }
8742:      { 273 3 ---  262 3 ---  2A0 3 x--  263 3 --- }
8743:      { 282 3 xy-  276 3 xy-  281 3 xy-  275 3 xy- }
8744:      { 280 3 xy-  274 3 xy-  27F 3 xy-  273 3 xy- }
8745:      { 237 3 x--  244 3 x--  13C 3 x--  144 3 x-- }
8746:      { 27B 3 x--  27B 3 x--  286 3 x--  26E 3 x-- }
8747:      { 285 3 x--  26D 3 x--  293 3 x--  27E 3 x-- }
8748:      { 292 3 x--  27D 3 x--  292 3 ---  27D 3 --- }
8749:      { 293 3 ---  27E 3 ---  286 3 ---  288 3 --- }
874A:      { 286 3 ---  288 3 ---  295 3 ---  289 3 --- }
874B:      { 26D 3 ---  279 3 ---  290 3 ---  27A 3 --- }
874C:      { 27B 3 ---  27B 3 ---  0F8 3 ---  270 3 --- }
874D:      { 29E 3 ---  234 3 ---  29F 3 ---  235 3 --- }
874E:      { 29F 3 x--  271 3 ---  29E 3 x--  272 3 --- }
874F:      { 26A 3 xy-  25E 3 xy-  269 3 xy-  25D 3 xy- }
8750:      { 268 3 xy-  25C 3 xy-  267 3 xy-  25B 3 xy- }
8751:      { 21C 3 x--  222 3 x--  14E 3 x--  166 3 --- }
8752:      { 27B 3 ---  27B 3 ---  27C 3 ---  287 3 --- }
8753:      { 28D 3 xy-  282 3 xy-  28C 3 xy-  281 3 xy- }
8754:      { 28B 3 xy-  280 3 xy-  28A 3 xy-  27F 3 xy- }
8755:      { 229 3 x--  237 3 x--  170 3 ---  178 3 x-- }
8756:      { 27B 3 ---  27B 3 ---  291 3 ---  291 3 --- }
8757:      { 276 3 xy-  26A 3 xy-  275 3 xy-  269 3 xy- }
8758:      { 274 3 xy-  268 3 xy-  273 3 xy-  267 3 xy- }
8759:      { 244 3 x--  21C 3 x--  17E 3 x--  204 3 x-- }
875A:      { 27B 3 ---  27B 3 ---  291 3 ---  287 3 --- }
875B:      { 290 3 ---  288 3 ---  296 3 ---  289 3 --- }
875C:      { 28E 3 ---  24A 3 ---  28F 3 ---  24B 3 --- }
875D:      { 222 3 x--  24C 3 ---  168 3 x--  204 3 x-- }
875E:      { 27B 3 ---  27B 3 ---  291 3 ---  299 3 --- }
875F:      { 256 3 ---  229 3 x--  168 3 x--  14A 3 x-- }
8760:      { 27B 3 ---  27B 3 ---  29D 3 ---  227 3 --- }
8761:      { 29E 3 ---  228 3 ---  29F 3 ---  209 3 --- }
8762:      { 290 3 ---  286 3 ---  296 3 ---  295 3 --- }
8763: ~
8764: ~
8765: ~
8766: ~
8767: ~
8768: ~
8769: ~
876A: ~
876B: ~
876C: ~
876D: ~
876E: ~
876F: ~
8770:      { 04F 0 ---  0F8 0 ---  0F8 0 ---  0F8 0 --- }
8771:      { 0F8 0 ---  0F8 0 ---  04F 0 ---  0F8 0 --- }
8772:      { 04F 0 ---  04F 0 ---  0F8 0 ---  0F8 0 --- }
8773:      { 0F8 0 ---  0F8 0 ---  04F 0 ---  04F 0 --- }
8774:      { 04F 0 ---  04F 0 ---  04F 0 ---  0F8 0 --- }
8775:      { 04F 0 ---  0F8 0 ---  04F 0 ---  04F 0 --- }
8776:      { 04F 0 ---  0F8 0 ---  0F8 0 ---  04F 0 --- }
8777:      { 0F8 0 ---  04F 0 ---  04F 0 ---  0F8 0 --- }
8778: ~
8779: ~
877A: ~
877B: ~
877C: ~
877D: ~
877E: ~
877F: ~
8780:      { 0F8 0 ---  04F 0 ---  0F8 0 ---  0F8 0 --- }
8781:      { 0F8 0 ---  0F8 0 ---  0F8 0 ---  04F 0 --- }
8782:      { 04F 0 ---  0F8 0 ---  04F 0 ---  0F8 0 --- }
8783:      { 0F8 0 ---  04F 0 ---  0F8 0 ---  04F 0 --- }
8784:      { 04F 0 ---  04F 0 ---  0F8 0 ---  04F 0 --- }
8785:      { 0F8 0 ---  04F 0 ---  04F 0 ---  04F 0 --- }
8786:      { 04F 0 ---  04F 0 ---  04F 0 ---  04F 0 --- }
8787: ~
8788: ~
8789: ~
878A: ~
878B: ~
878C: ~
878D: ~
878E: ~
878F: ~
8790: ~
8791: ~
8792: ~
8793: ~
8794: ~
8795: ~
8796: ~
8797: ~
8798: ~
8799: ~
879A: ~
879B: ~
879C: ~
879D:      { 103 3 ---  107 3 ---  104 3 ---  108 3 --- }
879E:      { 101 3 ---  105 3 ---  102 3 ---  106 3 --- }
879F:      { 100 3 ---  100 3 ---  101 3 ---  105 3 --- }
87A0:      { 102 3 ---  106 3 ---  100 3 ---  100 3 --- }
87A1:      { 100 3 ---  100 3 ---  103 3 ---  107 3 --- }
87A2:      { 104 3 ---  108 3 ---  100 3 ---  100 3 --- }
87A3:      { 109 3 ---  10E 3 ---  109 3 ---  10E 3 --- }
87A4:      { 10A 3 ---  10F 3 ---  10B 3 ---  110 3 --- }
87A5:      { 10C 3 ---  111 3 ---  10D 3 ---  112 3 --- }
87A6:      { 113 3 ---  11B 3 ---  113 3 ---  11B 3 --- }
87A7:      { 113 3 ---  11B 3 ---  114 3 ---  11C 3 --- }
87A8:      { 0F8 3 ---  0F8 3 ---  116 3 ---  11E 3 --- }
87A9:      { 117 3 ---  117 3 ---  118 3 ---  11F 3 --- }
87AA:      { 118 3 x--  120 3 ---  117 3 x--  121 3 --- }
87AB:      { 116 3 x--  11E 3 x--  0F8 3 ---  0F8 3 --- }
87AC:      { 11A 3 ---  123 3 ---  113 3 ---  11B 3 --- }
87AD:      { 124 3 ---  124 3 ---  124 3 ---  124 3 --- }
87AE:      { 125 3 ---  138 3 ---  126 3 ---  139 3 --- }
87AF:      { 127 3 ---  13A 3 ---  128 3 ---  13B 3 --- }
87B0:      { 124 3 ---  13C 3 ---  124 3 ---  124 3 --- }
87B1:      { 129 3 ---  124 3 ---  12A 3 ---  13D 3 --- }
87B2:      { 12B 3 ---  13E 3 ---  12C 3 ---  13F 3 --- }
87B3:      { 124 3 ---  140 3 ---  12D 3 ---  141 3 --- }
87B4:      { 12E 3 ---  142 3 ---  12F 3 ---  143 3 --- }
87B5:      { 130 3 ---  144 3 ---  11E 3 ---  145 3 --- }
87B6:      { 117 3 ---  121 3 x--  131 3 ---  131 3 --- }
87B7:      { 132 3 ---  132 3 ---  121 3 ---  121 3 --- }
87B8:      { 11E 3 x--  145 3 x--  0F8 3 ---  0F8 3 --- }
87B9:      { 134 3 ---  147 3 ---  135 3 ---  148 3 --- }
87BA:      { 136 3 ---  148 3 x--  137 3 ---  149 3 --- }
87BB:      { 14A 3 ---  162 3 ---  14B 3 ---  163 3 --- }
87BC:      { 142 3 x--  142 3 x--  14C 3 ---  14C 3 --- }
87BD:      { 14D 3 ---  164 3 ---  14E 3 ---  165 3 --- }
87BE:      { 14F 3 ---  165 3 x--  150 3 ---  164 3 x-- }
87BF:      { 124 3 ---  124 3 ---  151 3 ---  166 3 --- }
87C0:      { 152 3 ---  167 3 ---  124 3 ---  124 3 --- }
87C1:      { 153 3 ---  168 3 ---  154 3 ---  14C 3 x-- }
87C2:      { 142 3 ---  142 3 ---  143 3 ---  143 3 --- }
87C3:      { 155 3 ---  169 3 ---  156 3 ---  16A 3 --- }
87C4:      { 156 3 x--  16A 3 ---  157 3 ---  169 3 x-- }
87C5:      { 158 3 ---  16B 3 ---  159 3 ---  16C 3 --- }
87C6:      { 145 3 x--  16D 3 ---  124 3 ---  16E 3 --- }
87C7:      { 152 3 ---  167 3 ---  124 3 ---  16F 3 --- }
87C8:      { 124 3 ---  170 3 ---  15A 3 ---  171 3 --- }
87C9:      { 15B 3 ---  172 3 ---  124 3 ---  124 3 --- }
87CA:      { 15C 3 ---  173 3 ---  15D 3 ---  16A 3 --- }
87CB:      { 15E 3 ---  174 3 ---  15F 3 ---  175 3 --- }
87CC:      { 160 3 ---  176 3 ---  161 3 ---  177 3 --- }
87CD:      { 162 3 ---  162 3 ---  163 3 ---  163 3 --- }
87CE:      { 178 3 ---  203 3 ---  179 3 ---  204 3 --- }
87CF:      { 179 3 ---  204 3 ---  179 3 ---  204 3 --- }
87D0:      { 178 3 x--  205 3 ---  14C 3 ---  206 3 --- }
87D1:      { 167 3 ---  167 3 ---  16F 3 ---  17D 3 --- }
87D2:      { 17A 3 ---  16A 3 ---  169 3 x--  169 3 x-- }
87D3:      { 168 3 ---  168 3 ---  14C 3 x--  14C 3 x-- }
87D4:      { 142 3 ---  142 3 ---  143 3 ---  207 3 --- }
87D5:      { 169 3 ---  208 3 ---  16A 3 ---  209 3 --- }
87D6:      { 16A 3 ---  20A 3 ---  169 3 x--  20B 3 --- }
87D7:      { 17B 3 ---  20C 3 ---  16A 3 x--  20D 3 --- }
87D8:      { 17C 3 ---  16A 3 x--  17C 3 ---  16A 3 x-- }
87D9:      { 167 3 ---  167 3 ---  17D 3 ---  17D 3 --- }
87DA:      { 17E 3 ---  17B 3 ---  17C 3 ---  16A 3 x-- }
87DB:      { 170 3 ---  17D 3 ---  17E 3 ---  17B 3 --- }
87DC:      { 17F 3 ---  164 3 ---  200 3 ---  165 3 --- }
87DD:      { 201 3 ---  165 3 x--  202 3 ---  164 3 x-- }
87DE:      { 178 3 x--  205 3 ---  163 3 ---  206 3 --- }
87DF:      { 203 3 ---  203 3 ---  204 3 ---  204 3 --- }
87E0:      { 204 3 ---  20E 3 ---  204 3 ---  20E 3 --- }
87E1:      { 20E 3 ---  204 3 ---  204 3 ---  204 3 --- }
87E2:      { 205 3 ---  205 3 ---  20F 3 ---  21F 3 --- }
87E3:      { 210 3 ---  164 3 ---  211 3 ---  165 3 --- }
87E4:      { 212 3 ---  165 3 x--  213 3 ---  164 3 x-- }
87E5:      { 214 3 ---  206 3 ---  215 3 ---  206 3 --- }
87E6:      { 216 3 ---  206 3 ---  217 3 ---  206 3 --- }
87E7:      { 178 3 ---  220 3 ---  179 3 ---  221 3 --- }
87E8:      { 179 3 ---  222 3 ---  179 3 ---  204 3 --- }
87E9:      { 218 3 ---  204 3 ---  219 3 ---  204 3 --- }
87EA:      { 21A 3 ---  204 3 ---  21B 3 ---  204 3 --- }
87EB:      { 21C 3 ---  206 3 ---  21D 3 ---  206 3 --- }
87EC:      { 178 3 x--  205 3 ---  16A 3 x--  206 3 --- }
87ED:      { 21E 3 ---  204 3 ---  21E 3 x--  204 3 --- }
87EE:      { 179 3 ---  204 3 ---  178 3 x--  205 3 --- }
87EF:      { 20F 3 ---  21F 3 ---  20F 3 ---  21F 3 --- }
87F0:      { 223 3 ---  203 3 ---  224 3 ---  204 3 --- }
87F1:      { 225 3 ---  204 3 ---  204 3 ---  204 3 --- }
87F2:      { 204 3 ---  204 3 ---  204 3 ---  204 3 --- }
87F3:      { 226 3 ---  229 3 ---  227 3 ---  22A 3 --- }
87F4:      { 227 3 ---  22B 3 ---  228 3 ---  22C 3 --- }
87F5:      { 22D 3 ---  231 3 ---  22E 3 ---  232 3 --- }
87F6:      { 22F 3 ---  233 3 ---  230 3 ---  234 3 --- }
87F7:      { 235 3 ---  23B 3 ---  236 3 ---  23C 3 --- }
87F8:      { 237 3 ---  23D 3 ---  238 3 ---  23E 3 --- }
87F9:      { 239 3 ---  23D 3 ---  23A 3 ---  23E 3 --- }
87FA:      { 23F 3 ---  23F 3 ---  240 3 ---  240 3 --- }
87FB:      { 23F 3 ---  23F 3 ---  23F 3 ---  23F 3 --- }
87FC:      { 241 3 ---  243 3 ---  242 3 ---  243 3 --- }
87FD:      { 241 3 ---  243 3 ---  241 3 ---  243 3 --- }
87FE:      { 244 3 ---  11B 3 -y-  244 3 ---  11B 3 -y- }
87FF:      { 245 3 ---  245 3 ---  245 3 ---  245 3 --- }
