8800:      { 100 2 ---  101 2 ---  100 2 ---  101 2 --- }
8801:      { 102 2 ---  103 2 ---  102 2 ---  103 2 --- }
8802:      { 104 2 ---  105 2 ---  104 2 ---  105 2 --- }
8803:      { 106 2 ---  107 2 ---  106 2 ---  107 2 --- }
8804:      { 108 2 ---  109 2 ---  108 2 ---  109 2 --- }
8805:      { 10A 2 ---  112 2 ---  10B 2 ---  113 2 --- }
8806:      { 10C 2 ---  114 2 ---  10D 2 ---  115 2 --- }
8807:      { 10E 2 ---  116 2 ---  10F 2 ---  117 2 --- }
8808:      { 110 2 ---  118 2 ---  111 2 ---  119 2 --- }
8809:      { 11A 2 ---  122 2 ---  11B 2 ---  123 2 --- }
880A:      { 11C 2 ---  124 2 ---  11D 2 ---  125 2 --- }
880B:      { 11E 2 ---  126 2 ---  11F 2 ---  127 2 --- }
880C:      { 120 2 ---  128 2 ---  121 2 ---  129 2 --- }
880D:      { 11A 2 ---  12A 2 ---  11B 2 ---  12B 2 --- }
880E:      { 11C 2 ---  12C 2 ---  11D 2 ---  12D 2 --- }
880F:      { 11E 2 ---  12E 2 ---  11F 2 ---  12F 2 --- }
8810:      { 120 2 ---  130 2 ---  121 2 ---  131 2 --- }
8811:      { 132 2 ---  142 2 ---  133 2 ---  142 2 --- }
8812:      { 134 2 ---  143 2 ---  135 2 ---  144 2 --- }
8813:      { 136 2 ---  145 2 ---  137 2 ---  146 2 x-- }
8814:      { 138 2 ---  147 2 ---  139 2 ---  148 2 --- }
8815:      { 13A 2 ---  149 2 ---  13B 2 ---  14A 2 --- }
8816:      { 13C 2 ---  144 2 ---  13D 2 ---  145 2 --- }
8817:      { 13E 2 ---  146 2 x--  13F 2 ---  14B 2 --- }
8818:      { 140 2 ---  146 2 ---  141 2 ---  14C 2 --- }
8819:      { 132 2 ---  14D 2 ---  133 2 ---  142 2 --- }
881A:      { 134 2 ---  14A 2 ---  135 2 ---  144 2 --- }
881B:      { 138 2 ---  147 2 ---  139 2 ---  14E 2 --- }
881C:      { 13A 2 ---  14D 2 ---  13B 2 ---  142 2 --- }
881D:      { 13C 2 ---  142 2 ---  13D 2 ---  142 2 --- }
881E:      { 13E 2 ---  142 2 ---  13F 2 ---  142 2 --- }
881F:      { 140 2 ---  142 2 ---  141 2 ---  142 2 --- }
8820:      { 14F 2 ---  15F 2 ---  150 2 ---  152 2 --- }
8821:      { 151 2 ---  160 2 ---  152 2 ---  161 2 --- }
8822:      { 152 2 ---  162 2 ---  152 2 ---  163 2 --- }
8823:      { 152 2 ---  164 2 ---  152 2 ---  165 2 --- }
8824:      { 153 2 ---  152 2 ---  154 2 ---  166 2 --- }
8825:      { 155 2 ---  152 2 ---  156 2 ---  157 2 xy- }
8826:      { 157 2 ---  167 2 ---  152 2 ---  168 2 --- }
8827:      { 158 2 ---  169 2 ---  157 2 x--  16A 2 --- }
8828:      { 159 2 ---  16B 2 ---  15A 2 ---  16C 2 --- }
8829:      { 15B 2 ---  16D 2 ---  152 2 ---  16E 2 --- }
882A:      { 152 2 ---  16F 2 ---  152 2 ---  170 2 --- }
882B:      { 152 2 ---  171 2 ---  152 2 ---  172 2 --- }
882C:      { 159 2 ---  173 2 ---  15A 2 ---  174 2 --- }
882D:      { 15A 2 ---  175 2 ---  15A 2 ---  176 2 x-- }
882E:      { 15A 2 ---  177 2 ---  15C 2 ---  178 2 --- }
882F:      { 15D 2 ---  179 2 ---  15E 2 ---  17A 2 --- }
8830:      { 17B 2 ---  20A 2 ---  17C 2 ---  20B 2 --- }
8831:      { 17D 2 ---  20C 2 ---  17E 2 ---  20D 2 --- }
8832:      { 155 2 ---  152 2 ---  152 2 ---  17D 2 --- }
8833:      { 152 2 ---  20E 2 ---  152 2 ---  20F 2 --- }
8834:      { 152 2 ---  210 2 ---  152 2 ---  211 2 --- }
8835:      { 152 2 ---  212 2 ---  152 2 ---  17D 2 --- }
8836:      { 17F 2 ---  20A 2 ---  200 2 ---  213 2 --- }
8837:      { 201 2 ---  214 2 ---  16C 2 ---  175 2 --- }
8838:      { 16C 2 ---  215 2 ---  16C 2 ---  216 2 --- }
8839:      { 202 2 ---  217 2 ---  174 2 ---  211 2 --- }
883A:      { 203 2 ---  17C 2 ---  204 2 ---  17D 2 --- }
883B:      { 205 2 ---  20E 2 ---  206 2 ---  20F 2 --- }
883C:      { 207 2 ---  210 2 ---  152 2 ---  211 2 --- }
883D:      { 152 2 ---  211 2 ---  152 2 ---  20F 2 --- }
883E:      { 208 2 ---  20A 2 ---  17C 2 ---  20B 2 --- }
883F:      { 17D 2 ---  20C 2 ---  209 2 ---  20D 2 --- }
8840:      { 218 2 ---  21C 2 ---  219 2 ---  21C 2 --- }
8841:      { 157 2 -y-  21C 2 ---  152 2 ---  21C 2 --- }
8842:      { 152 2 ---  21C 2 ---  21A 2 ---  21C 2 --- }
8843:      { 21B 2 ---  21C 2 ---  20B 2 ---  21C 2 --- }
8844:      { 21C 2 ---  21C 2 ---  21C 2 ---  21C 2 --- }
8845:      { 21D 2 ---  21C 2 ---  21E 2 ---  21C 2 --- }
8846:      { 152 2 ---  21C 2 ---  21F 2 ---  21C 2 --- }
8847:      { 20A 2 ---  21C 2 ---  15F 2 ---  21C 2 --- }
8848:      { 20C 2 ---  21C 2 ---  20D 2 ---  21C 2 --- }
8849:      { 100 2 ---  100 2 ---  100 2 ---  100 2 --- }
884A:      { 004 2 ---  004 2 ---  004 2 ---  004 2 --- }
884B:      { 004 2 ---  004 2 ---  004 2 ---  004 2 --- }
884C:      { 004 2 ---  004 2 ---  004 2 ---  004 2 --- }
884D:      { 004 2 ---  004 2 ---  004 2 ---  004 2 --- }
884E:      { 004 2 ---  004 2 ---  004 2 ---  004 2 --- }
884F:      { 004 2 ---  004 2 ---  004 2 ---  004 2 --- }
8850: ~
8851: ~
8852: ~
8853: ~
8854: ~
8855: ~
8856: ~
8857: ~
8858: ~
8859: ~
885A: ~
885B: ~
885C: ~
885D: ~
885E: ~
885F: ~
8860: ~
8861: ~
8862: ~
8863: ~
8864: ~
8865: ~
8866: ~
8867: ~
8868: ~
8869: ~
886A: ~
886B: ~
886C: ~
886D: ~
886E: ~
886F: ~
8870: ~
8871: ~
8872: ~
8873: ~
8874: ~
8875: ~
8876: ~
8877: ~
8878: ~
8879: ~
887A: ~
887B: ~
887C: ~
887D: ~
887E: ~
887F: ~
8880: ~
8881: ~
8882: ~
8883: ~
8884: ~
8885: ~
8886: ~
8887: ~
8888: ~
8889: ~
888A: ~
888B: ~
888C: ~
888D: ~
888E: ~
888F: ~
8890: ~
8891: ~
8892: ~
8893: ~
8894: ~
8895: ~
8896: ~
8897: ~
8898: ~
8899: ~
889A: ~
889B: ~
889C: ~
889D: ~
889E: ~
889F: ~
88A0: ~
88A1: ~
88A2: ~
88A3: ~
88A4: ~
88A5: ~
88A6: ~
88A7: ~
88A8: ~
88A9: ~
88AA: ~
88AB: ~
88AC: ~
88AD: ~
88AE: ~
88AF: ~
88B0: ~
88B1: ~
88B2: ~
88B3: ~
88B4: ~
88B5: ~
88B6: ~
88B7: ~
88B8: ~
88B9: ~
88BA: ~
88BB: ~
88BC: ~
88BD: ~
88BE: ~
88BF: ~
88C0: ~
88C1: ~
88C2: ~
88C3: ~
88C4: ~
88C5: ~
88C6: ~
88C7: ~
88C8: ~
88C9: ~
88CA: ~
88CB: ~
88CC: ~
88CD: ~
88CE: ~
88CF: ~
88D0: ~
88D1: ~
88D2: ~
88D3: ~
88D4: ~
88D5: ~
88D6: ~
88D7: ~
88D8: ~
88D9: ~
88DA: ~
88DB: ~
88DC: ~
88DD: ~
88DE: ~
88DF: ~
88E0: ~
88E1: ~
88E2: ~
88E3: ~
88E4: ~
88E5: ~
88E6: ~
88E7: ~
88E8: ~
88E9: ~
88EA: ~
88EB: ~
88EC: ~
88ED: ~
88EE: ~
88EF: ~
88F0: ~
88F1: ~
88F2: ~
88F3: ~
88F4: ~
88F5: ~
88F6: ~
88F7: ~
88F8: ~
88F9: ~
88FA: ~
88FB: ~
88FC: ~
88FD: ~
88FE: ~
88FF: ~
