FB00:      { 0F8 0 ---  0F8 0 ---  0F8 0 ---  0F8 0 --- }
FB01:      { 0F8 0 ---  0F8 0 ---  0F8 0 ---  0F8 0 --- }
FB02:      { 0F8 0 ---  0F8 0 ---  0F8 0 ---  0F8 0 --- }
FB03:      { 0F8 0 ---  0F8 0 ---  0F8 0 ---  0F8 0 --- }
FB04:      { 0F8 0 ---  0F8 0 ---  0F8 0 ---  0F8 0 --- }
FB05:      { 0F8 0 ---  0F8 0 ---  0F8 0 ---  0F8 0 --- }
FB06:      { 0F8 0 ---  0F8 0 ---  0F8 0 ---  0F8 0 --- }
FB07:      { 0F8 0 ---  0F8 0 ---  0F8 0 ---  0F8 0 --- }
FB08:      { 0F8 0 ---  0F8 0 ---  0F8 0 ---  0F8 0 --- }
FB09:      { 0F8 0 ---  0F8 0 ---  0F8 0 ---  0F8 0 --- }
FB0A:      { 0F8 0 ---  0F8 0 ---  0F8 0 ---  0F8 0 --- }
FB0B:      { 0F8 0 ---  0F8 0 ---  0F8 0 ---  0F8 0 --- }
FB0C:      { 0F8 0 ---  0F8 0 ---  0F8 0 ---  0F8 0 --- }
FB0D:      { 0F8 0 ---  0F8 0 ---  0F8 0 ---  0F8 0 --- }
FB0E:      { 0F8 0 ---  0F8 0 ---  0F8 0 ---  0F8 0 --- }
FB0F:      { 0F8 0 ---  0F8 0 ---  0F8 0 ---  0F8 0 --- }
FB10:      { 0F8 0 ---  0F8 0 ---  0F8 0 ---  0F8 0 --- }
FB11:      { 0F8 0 ---  0F8 0 ---  0F8 0 ---  0F8 0 --- }
FB12:      { 0F8 0 ---  0F8 0 ---  0F8 0 ---  0F8 0 --- }
FB13:      { 0F8 0 ---  0F8 0 ---  0F8 0 ---  0F8 0 --- }
FB14:      { 0F8 0 ---  0F8 0 ---  0F8 0 ---  0F8 0 --- }
FB15:      { 0F8 0 ---  0F8 0 ---  0F8 0 ---  0F8 0 --- }
FB16:      { 0F8 0 ---  0F8 0 ---  0F8 0 ---  0F8 0 --- }
FB17:      { 0F8 0 ---  0F8 0 ---  0F8 0 ---  0F8 0 --- }
FB18:      { 0F8 0 ---  0F8 0 ---  0F8 0 ---  0F8 0 --- }
FB19:      { 0F8 0 ---  0F8 0 ---  0F8 0 ---  0F8 0 --- }
FB1A:      { 0F8 0 ---  0F8 0 ---  0F8 0 ---  0F8 0 --- }
FB1B:      { 0F8 0 ---  0F8 0 ---  0F8 0 ---  0F8 0 --- }
FB1C:      { 0F8 0 ---  0F8 0 ---  0F8 0 ---  0F8 0 --- }
FB1D:      { 0F8 0 ---  0F8 0 ---  0F8 0 ---  0F8 0 --- }
FB1E:      { 0F8 0 ---  0F8 0 ---  0F8 0 ---  0F8 0 --- }
FB1F:      { 0F8 0 ---  0F8 0 ---  0F8 0 ---  0F8 0 --- }
FB20:      { 0F8 0 ---  0F8 0 ---  0F8 0 ---  0F8 0 --- }
FB21:      { 0F8 0 ---  0F8 0 ---  0F8 0 ---  0F8 0 --- }
FB22:      { 0F8 0 ---  0F8 0 ---  0F8 0 ---  0F8 0 --- }
FB23:      { 0F8 0 ---  0F8 0 ---  0F8 0 ---  0F8 0 --- }
FB24:      { 0F8 0 ---  0F8 0 ---  0F8 0 ---  0F8 0 --- }
FB25:      { 0F8 0 ---  0F8 0 ---  0F8 0 ---  0F8 0 --- }
FB26:      { 0F8 0 ---  0F8 0 ---  0F8 0 ---  0F8 0 --- }
FB27:      { 0F8 0 ---  0F8 0 ---  0F8 0 ---  0F8 0 --- }
FB28:      { 0F8 0 ---  0F8 0 ---  0F8 0 ---  0F8 0 --- }
FB29:      { 0F8 0 ---  0F8 0 ---  0F8 0 ---  0F8 0 --- }
FB2A:      { 0F8 0 ---  0F8 0 ---  0F8 0 ---  0F8 0 --- }
FB2B:      { 0F8 0 ---  0F8 0 ---  0F8 0 ---  0F8 0 --- }
FB2C:      { 0F8 0 ---  0F8 0 ---  0F8 0 ---  0F8 0 --- }
FB2D:      { 0F8 0 ---  0F8 0 ---  0F8 0 ---  0F8 0 --- }
FB2E:      { 0F8 0 ---  0F8 0 ---  0F8 0 ---  0F8 0 --- }
FB2F:      { 0F8 0 ---  0F8 0 ---  0F8 0 ---  0F8 0 --- }
FB30:      { 0F8 0 ---  0F8 0 ---  0F8 0 ---  0F8 0 --- }
FB31:      { 0F8 0 ---  0F8 0 ---  0F8 0 ---  0F8 0 --- }
FB32:      { 0F8 0 ---  0F8 0 ---  0F8 0 ---  0F8 0 --- }
FB33:      { 0F8 0 ---  0F8 0 ---  0F8 0 ---  0F8 0 --- }
FB34:      { 0F8 0 ---  0F8 0 ---  0F8 0 ---  0F8 0 --- }
FB35:      { 0F8 0 ---  0F8 0 ---  0F8 0 ---  0F8 0 --- }
FB36:      { 0F8 0 ---  0F8 0 ---  0F8 0 ---  0F8 0 --- }
FB37:      { 0F8 0 ---  0F8 0 ---  0F8 0 ---  0F8 0 --- }
FB38:      { 0F8 0 ---  0F8 0 ---  0F8 0 ---  0F8 0 --- }
FB39:      { 0F8 0 ---  0F8 0 ---  0F8 0 ---  0F8 0 --- }
FB3A:      { 0F8 0 ---  0F8 0 ---  0F8 0 ---  0F8 0 --- }
FB3B:      { 0F8 0 ---  0F8 0 ---  0F8 0 ---  0F8 0 --- }
FB3C:      { 0F8 0 ---  0F8 0 ---  0F8 0 ---  0F8 0 --- }
FB3D:      { 0F8 0 ---  0F8 0 ---  0F8 0 ---  0F8 0 --- }
FB3E:      { 0F8 0 ---  0F8 0 ---  0F8 0 ---  0F8 0 --- }
FB3F:      { 0F8 0 ---  0F8 0 ---  0F8 0 ---  0F8 0 --- }
FB40:      { 0F8 0 ---  0F8 0 ---  0F8 0 ---  0F8 0 --- }
FB41:      { 0F8 0 ---  0F8 0 ---  0F8 0 ---  0F8 0 --- }
FB42:      { 0F8 0 ---  0F8 0 ---  0F8 0 ---  0F8 0 --- }
FB43:      { 0F8 0 ---  0F8 0 ---  0F8 0 ---  0F8 0 --- }
FB44:      { 0F8 0 ---  0F8 0 ---  0F8 0 ---  0F8 0 --- }
FB45:      { 0F8 0 ---  0F8 0 ---  0F8 0 ---  0F8 0 --- }
FB46:      { 0F8 0 ---  0F8 0 ---  0F8 0 ---  0F8 0 --- }
FB47:      { 0F8 0 ---  0F8 0 ---  0F8 0 ---  0F8 0 --- }
FB48:      { 0F8 0 ---  0F8 0 ---  0F8 0 ---  0F8 0 --- }
FB49:      { 0F8 0 ---  0F8 0 ---  0F8 0 ---  0F8 0 --- }
FB4A:      { 0F8 0 ---  0F8 0 ---  0F8 0 ---  0F8 0 --- }
FB4B:      { 0F8 0 ---  0F8 0 ---  0F8 0 ---  0F8 0 --- }
FB4C:      { 0F8 0 ---  0F8 0 ---  0F8 0 ---  0F8 0 --- }
FB4D:      { 0F8 0 ---  0F8 0 ---  0F8 0 ---  0F8 0 --- }
FB4E:      { 0F8 0 ---  0F8 0 ---  0F8 0 ---  0F8 0 --- }
FB4F:      { 0F8 0 ---  0F8 0 ---  0F8 0 ---  0F8 0 --- }
FB50:      { 0F8 0 ---  0F8 0 ---  0F8 0 ---  0F8 0 --- }
FB51:      { 0F8 0 ---  0F8 0 ---  0F8 0 ---  0F8 0 --- }
FB52:      { 0F8 0 ---  0F8 0 ---  0F8 0 ---  0F8 0 --- }
FB53:      { 0F8 0 ---  0F8 0 ---  0F8 0 ---  0F8 0 --- }
FB54:      { 0F8 0 ---  0F8 0 ---  0F8 0 ---  0F8 0 --- }
FB55:      { 0F8 0 ---  0F8 0 ---  0F8 0 ---  0F8 0 --- }
FB56:      { 0F8 0 ---  0F8 0 ---  0F8 0 ---  180 1 --- }
FB57:      { 0F8 0 ---  181 1 ---  0F8 0 ---  182 1 --- }
FB58:      { 0F8 0 ---  183 1 ---  0F8 0 ---  184 1 --- }
FB59:      { 0F8 0 ---  185 1 ---  0F8 0 ---  186 1 --- }
FB5A:      { 0F8 0 ---  0F8 0 ---  0F8 0 ---  0F8 0 --- }
FB5B:      { 0F8 0 ---  0F8 0 ---  0F8 0 ---  0F8 0 --- }
FB5C:      { 0F8 0 ---  0F8 0 ---  0F8 0 ---  0F8 0 --- }
FB5D:      { 0F8 0 ---  0F8 0 ---  0F8 0 ---  0F8 0 --- }
FB5E:      { 0F8 0 ---  0F8 0 ---  0F8 0 ---  0F8 0 --- }
FB5F:      { 0F8 0 ---  0F8 0 ---  0F8 0 ---  0F8 0 --- }
FB60:      { 0F8 0 ---  0F8 0 ---  0F8 0 ---  0F8 0 --- }
FB61:      { 0F8 0 ---  0F8 0 ---  0F8 0 ---  0F8 0 --- }
FB62:      { 0F8 0 ---  0F8 0 ---  0F8 0 ---  0F8 0 --- }
FB63:      { 0F8 0 ---  0F8 0 ---  0F8 0 ---  0F8 0 --- }
FB64:      { 0F8 0 ---  194 1 ---  0F8 0 ---  195 1 --- }
FB65:      { 187 1 ---  196 1 ---  188 1 ---  197 1 --- }
FB66:      { 189 1 ---  198 1 ---  18A 1 ---  199 1 --- }
FB67:      { 18B 1 ---  19A 1 ---  18C 1 ---  19B 1 --- }
FB68:      { 18D 1 ---  19C 1 ---  18E 1 ---  19D 1 --- }
FB69:      { 18F 1 ---  19E 1 ---  190 1 ---  19F 1 --- }
FB6A:      { 191 1 ---  1A0 1 ---  192 1 ---  1A1 1 --- }
FB6B:      { 193 1 ---  1A2 1 ---  0F8 0 ---  1A3 1 --- }
FB6C:      { 0F8 0 ---  0F8 0 ---  0F8 0 ---  0F8 0 --- }
FB6D:      { 0F8 0 ---  0F8 0 ---  0F8 0 ---  0F8 0 --- }
FB6E:      { 0F8 0 ---  0F8 0 ---  0F8 0 ---  0F8 0 --- }
FB6F:      { 0F8 0 ---  0F8 0 ---  0F8 0 ---  0F8 0 --- }
FB70:      { 0F8 0 ---  0F8 0 ---  0F8 0 ---  0F8 0 --- }
FB71:      { 0F8 0 ---  0F8 0 ---  0F8 0 ---  0F8 0 --- }
FB72:      { 0F8 0 ---  0F8 0 ---  0F8 0 ---  0F8 0 --- }
FB73:      { 0F8 0 ---  1B6 1 ---  1A4 1 ---  1B7 1 --- }
FB74:      { 1A5 1 ---  1B8 1 ---  1A6 1 ---  1B9 1 --- }
FB75:      { 1A7 1 ---  1BA 1 ---  1A8 1 ---  1BB 1 --- }
FB76:      { 1A9 1 ---  1BC 1 ---  1AA 1 ---  1BD 1 --- }
FB77:      { 1AB 1 ---  1BE 1 ---  1AC 1 ---  1BF 1 --- }
FB78:      { 1AD 1 ---  1C0 1 ---  1AE 1 ---  1C1 1 --- }
FB79:      { 1AF 1 ---  1C2 1 ---  1B0 1 ---  1C3 1 --- }
FB7A:      { 1B1 1 ---  1C4 1 ---  1B2 1 ---  1C5 1 --- }
FB7B:      { 1B3 1 ---  1C6 1 ---  1B4 1 ---  1C7 1 --- }
FB7C:      { 1B5 1 ---  1C8 1 ---  0F8 0 ---  1C9 1 --- }
FB7D:      { 0F8 0 ---  0F8 0 ---  0F8 0 ---  0F8 0 --- }
FB7E:      { 0F8 0 ---  0F8 0 ---  0F8 0 ---  0F8 0 --- }
FB7F:      { 0F8 0 ---  0F8 0 ---  0F8 0 ---  0F8 0 --- }
FB80:      { 0F8 0 ---  0F8 0 ---  0F8 0 ---  0F8 0 --- }
FB81:      { 0F8 0 ---  0F8 0 ---  0F8 0 ---  0F8 0 --- }
FB82:      { 0F8 0 ---  0F8 0 ---  0F8 0 ---  1DF 1 --- }
FB83:      { 1CA 1 ---  1E0 1 ---  1CB 1 ---  1E1 1 --- }
FB84:      { 1CC 1 ---  1E2 1 ---  1CD 1 ---  1E3 1 --- }
FB85:      { 1CE 1 ---  1E4 1 ---  1CF 1 ---  1E5 1 --- }
FB86:      { 1D0 1 ---  1E6 1 ---  1D1 1 ---  1E7 1 --- }
FB87:      { 1D2 1 ---  1E8 1 ---  1D3 1 ---  1E9 1 --- }
FB88:      { 1D4 1 ---  1EA 1 ---  1D5 1 ---  1EB 1 --- }
FB89:      { 1D6 1 ---  1EC 1 ---  1D7 1 ---  1ED 1 --- }
FB8A:      { 1D8 1 ---  1EE 1 ---  1D9 1 ---  1EF 1 --- }
FB8B:      { 1DA 1 ---  1F0 1 ---  1DB 1 ---  1F1 1 --- }
FB8C:      { 1DC 1 ---  1F2 1 ---  1DD 1 ---  1F3 1 --- }
FB8D:      { 1DE 1 ---  1F4 1 ---  0F8 0 ---  0F8 0 --- }
FB8E:      { 0F8 0 ---  0F8 0 ---  0F8 0 ---  0F8 0 --- }
FB8F:      { 0F8 0 ---  0F8 0 ---  0F8 0 ---  0F8 0 --- }
FB90:      { 0F8 0 ---  0F8 0 ---  0F8 0 ---  0F8 0 --- }
FB91:      { 0F8 0 ---  0F8 0 ---  0F8 0 ---  0F8 0 --- }
FB92:      { 0F8 0 ---  0F8 0 ---  1F5 1 ---  20B 1 --- }
FB93:      { 1F6 1 ---  20C 1 ---  1F7 1 ---  20D 1 --- }
FB94:      { 1F8 1 ---  20E 1 ---  1F9 1 ---  20F 1 --- }
FB95:      { 1FA 1 ---  210 1 ---  1FB 1 ---  211 1 --- }
FB96:      { 1FC 1 ---  212 1 ---  1FD 1 ---  213 1 --- }
FB97:      { 1FE 1 ---  214 1 ---  1FF 1 ---  215 1 --- }
FB98:      { 200 1 ---  216 1 ---  201 1 ---  217 1 --- }
FB99:      { 202 1 ---  218 1 ---  203 1 ---  219 1 --- }
FB9A:      { 204 1 ---  21A 1 ---  205 1 ---  21B 1 --- }
FB9B:      { 206 1 ---  21C 1 ---  207 1 ---  21D 1 --- }
FB9C:      { 208 1 ---  21E 1 ---  209 1 ---  21F 1 --- }
FB9D:      { 20A 1 ---  220 1 ---  0F8 0 ---  221 1 --- }
FB9E:      { 0F8 0 ---  0F8 0 ---  0F8 0 ---  0F8 0 --- }
FB9F:      { 0F8 0 ---  0F8 0 ---  0F8 0 ---  0F8 0 --- }
FBA0:      { 0F8 0 ---  0F8 0 ---  0F8 0 ---  0F8 0 --- }
FBA1:      { 0F8 0 ---  0F8 0 ---  0F8 0 ---  0F8 0 --- }
FBA2:      { 0F8 0 ---  0F8 0 ---  222 1 ---  239 1 --- }
FBA3:      { 223 1 ---  23A 1 ---  224 1 ---  23B 1 --- }
FBA4:      { 225 1 ---  23C 1 ---  226 1 ---  23D 1 --- }
FBA5:      { 227 1 ---  23E 1 ---  228 1 ---  23F 1 --- }
FBA6:      { 229 1 ---  240 1 ---  22A 1 ---  241 1 --- }
FBA7:      { 22B 1 ---  242 1 ---  22C 1 ---  243 1 --- }
FBA8:      { 22D 1 ---  244 1 ---  22E 1 ---  245 1 --- }
FBA9:      { 22F 1 ---  246 1 ---  230 1 ---  247 1 --- }
FBAA:      { 231 1 ---  248 1 ---  232 1 ---  249 1 --- }
FBAB:      { 233 1 ---  24A 1 ---  234 1 ---  24B 1 --- }
FBAC:      { 235 1 ---  24C 1 ---  236 1 ---  24D 1 --- }
FBAD:      { 237 1 ---  24E 1 ---  238 1 ---  24F 1 --- }
FBAE:      { 0F8 0 ---  0F8 0 ---  0F8 0 ---  0F8 0 --- }
FBAF:      { 0F8 0 ---  0F8 0 ---  0F8 0 ---  0F8 0 --- }
FBB0:      { 0F8 0 ---  0F8 0 ---  0F8 0 ---  0F8 0 --- }
FBB1:      { 0F8 0 ---  0F8 0 ---  0F8 0 ---  0F8 0 --- }
FBB2:      { 0F8 0 ---  0F8 0 ---  250 1 ---  267 1 --- }
FBB3:      { 251 1 ---  268 1 ---  252 1 ---  269 1 --- }
FBB4:      { 253 1 ---  26A 1 ---  254 1 ---  26B 1 --- }
FBB5:      { 255 1 ---  26C 1 ---  256 1 ---  26D 1 --- }
FBB6:      { 257 1 ---  26E 1 ---  258 1 ---  26F 1 --- }
FBB7:      { 259 1 ---  270 1 ---  25A 1 ---  271 1 --- }
FBB8:      { 25B 1 ---  272 1 ---  25C 1 ---  273 1 --- }
FBB9:      { 25D 1 ---  274 1 ---  25E 1 ---  275 1 --- }
FBBA:      { 25F 1 ---  276 1 ---  260 1 ---  277 1 --- }
FBBB:      { 261 1 ---  278 1 ---  262 1 ---  279 1 --- }
FBBC:      { 263 1 ---  27A 1 ---  264 1 ---  27B 1 --- }
FBBD:      { 265 1 ---  0F8 0 ---  266 1 ---  0F8 0 --- }
FBBE:      { 0F8 0 ---  0F8 0 ---  0F8 0 ---  0F8 0 --- }
FBBF:      { 0F8 0 ---  0F8 0 ---  0F8 0 ---  0F8 0 --- }
FBC0:      { 0F8 0 ---  0F8 0 ---  0F8 0 ---  0F8 0 --- }
FBC1:      { 0F8 0 ---  0F8 0 ---  0F8 0 ---  0F8 0 --- }
FBC2:      { 0F8 0 ---  0F8 0 ---  27C 1 ---  0F8 0 --- }
FBC3:      { 27D 1 ---  0F8 0 ---  27E 1 ---  0F8 0 --- }
FBC4:      { 27F 1 ---  291 1 ---  280 1 ---  292 1 --- }
FBC5:      { 281 1 ---  293 1 ---  282 1 ---  294 1 --- }
FBC6:      { 283 1 ---  295 1 ---  284 1 ---  296 1 --- }
FBC7:      { 285 1 ---  297 1 ---  286 1 ---  298 1 --- }
FBC8:      { 287 1 ---  299 1 ---  288 1 ---  29A 1 --- }
FBC9:      { 289 1 ---  29B 1 ---  28A 1 ---  29C 1 --- }
FBCA:      { 28B 1 ---  29D 1 ---  28C 1 ---  29E 1 --- }
FBCB:      { 28D 1 ---  29F 1 ---  28E 1 ---  2A0 1 --- }
FBCC:      { 28F 1 ---  2A1 1 ---  290 1 ---  2A2 1 --- }
FBCD:      { 0F8 0 ---  0F8 0 ---  0F8 0 ---  0F8 0 --- }
FBCE:      { 0F8 0 ---  0F8 0 ---  0F8 0 ---  0F8 0 --- }
FBCF:      { 0F8 0 ---  0F8 0 ---  0F8 0 ---  0F8 0 --- }
FBD0:      { 0F8 0 ---  0F8 0 ---  0F8 0 ---  0F8 0 --- }
FBD1:      { 0F8 0 ---  0F8 0 ---  0F8 0 ---  0F8 0 --- }
FBD2:      { 0F8 0 ---  0F8 0 ---  0F8 0 ---  0F8 0 --- }
FBD3:      { 0F8 0 ---  0F8 0 ---  0F8 0 ---  0F8 0 --- }
FBD4:      { 2A3 1 ---  0F8 0 ---  2A4 1 ---  0F8 0 --- }
FBD5:      { 2A5 1 ---  2B3 1 ---  2A6 1 ---  2B4 1 --- }
FBD6:      { 2A7 1 ---  2B5 1 ---  2A8 1 ---  2B6 1 --- }
FBD7:      { 2A9 1 ---  2B7 1 ---  2AA 1 ---  2B8 1 --- }
FBD8:      { 2AB 1 ---  2B9 1 ---  2AC 1 ---  2BA 1 --- }
FBD9:      { 2AD 1 ---  2BB 1 ---  2AE 1 ---  2BC 1 --- }
FBDA:      { 2AF 1 ---  2BD 1 ---  2B0 1 ---  2BE 1 --- }
FBDB:      { 0F8 0 ---  2BF 1 ---  0F8 0 ---  0F8 0 --- }
FBDC:      { 2B1 1 ---  0F8 0 ---  2B2 1 ---  0F8 0 --- }
FBDD:      { 0F8 0 ---  0F8 0 ---  0F8 0 ---  0F8 0 --- }
FBDE:      { 0F8 0 ---  0F8 0 ---  0F8 0 ---  0F8 0 --- }
FBDF:      { 0F8 0 ---  0F8 0 ---  0F8 0 ---  0F8 0 --- }
FBE0: ~
FBE1: ~
FBE2: ~
FBE3: ~
FBE4: ~
FBE5: ~
FBE6: ~
FBE7: ~
FBE8: ~
FBE9: ~
FBEA: ~
FBEB: ~
FBEC: ~
FBED: ~
FBEE: ~
FBEF: ~
FBF0: ~
FBF1: ~
FBF2: ~
FBF3: ~
FBF4: ~
FBF5: ~
FBF6: ~
FBF7: ~
FBF8: ~
FBF9: ~
FBFA: ~
FBFB: ~
FBFC: ~
FBFD: ~
FBFE: ~
FBFF: ~
