9100:      { 100 2 x--  108 2 x--  101 2 x--  109 2 x-- }
9101:      { 102 2 ---  107 2 ---  103 2 ---  106 2 --- }
9102:      { 104 2 ---  107 2 ---  105 2 ---  106 2 --- }
9103:      { 106 2 ---  107 2 ---  107 2 ---  106 2 --- }
9104:      { 106 2 ---  107 2 ---  107 2 ---  104 2 --- }
9105:      { 106 2 ---  105 2 ---  107 2 ---  106 2 --- }
9106:      { 101 2 ---  109 2 ---  100 2 ---  108 2 --- }
9107: ~
9108: ~
9109: ~
910A: ~
910B: ~
910C: ~
910D: ~
910E: ~
910F: ~
9110:      { 106 2 ---  103 2 ---  107 2 ---  106 2 --- }
9111:      { 104 2 ---  107 2 ---  105 2 ---  102 2 --- }
9112:      { 102 2 ---  103 2 ---  103 2 ---  106 2 --- }
9113:      { 106 2 ---  107 2 ---  107 2 ---  102 2 --- }
9114:      { 106 2 ---  103 2 ---  107 2 ---  102 2 --- }
9115:      { 104 2 ---  103 2 ---  105 2 ---  106 2 --- }
9116:      { 106 2 ---  103 2 ---  107 2 ---  104 2 --- }
9117: ~
9118: ~
9119: ~
911A: ~
911B: ~
911C: ~
911D: ~
911E: ~
911F: ~
9120:      { 104 2 ---  105 2 ---  105 2 ---  104 2 --- }
9121:      { 102 2 ---  105 2 ---  103 2 ---  106 2 --- }
9122:      { 104 2 ---  107 2 ---  105 2 ---  104 2 --- }
9123:      { 10A 2 ---  10C 2 ---  10B 2 ---  10D 2 --- }
9124:      { 102 2 ---  105 2 ---  103 2 ---  104 2 --- }
9125:      { 102 2 ---  107 2 ---  103 2 ---  102 2 --- }
9126:      { 104 2 ---  105 2 ---  105 2 ---  106 2 --- }
9127: ~
9128: ~
9129: ~
912A: ~
912B: ~
912C: ~
912D: ~
912E: ~
912F: ~
9130: ~
9131: ~
9132: ~
9133: ~
9134: ~
9135: ~
9136: ~
9137: ~
9138: ~
9139: ~
913A: ~
913B: ~
913C: ~
913D: ~
913E: ~
913F: ~
9140: ~
9141: ~
9142: ~
9143: ~
9144: ~
9145: ~
9146: ~
9147: ~
9148: ~
9149: ~
914A: ~
914B: ~
914C: ~
914D: ~
914E: ~
914F: ~
9150: ~
9151: ~
9152: ~
9153: ~
9154: ~
9155: ~
9156:      { 10B 2 ---  10D 2 ---  10A 2 ---  10C 2 --- }
9157: ~
9158: ~
9159: ~
915A: ~
915B: ~
915C: ~
915D: ~
915E: ~
915F: ~
9160:      { 102 2 ---  15B 2 ---  103 2 ---  15C 2 --- }
9161:      { 155 2 ---  15D 2 ---  156 2 ---  15E 2 --- }
9162:      { 157 2 ---  15F 2 ---  158 2 ---  160 2 --- }
9163:      { 159 2 ---  161 2 ---  15A 2 ---  162 2 --- }
9164:      { 15A 2 x--  162 2 x--  159 2 x--  161 2 x-- }
9165:      { 158 2 x--  160 2 x--  157 2 x--  15F 2 x-- }
9166:      { 156 2 x--  15E 2 x--  155 2 x--  15D 2 x-- }
9167: ~
9168: ~
9169: ~
916A: ~
916B: ~
916C: ~
916D: ~
916E: ~
916F: ~
9170:      { 103 2 x--  15C 2 x--  102 2 x--  15B 2 x-- }
9171:      { 163 2 ---  16B 2 ---  164 2 ---  16C 2 --- }
9172:      { 165 2 ---  16D 2 ---  166 2 ---  16E 2 --- }
9173:      { 167 2 ---  16F 2 ---  168 2 ---  0F8 2 --- }
9174:      { 169 2 ---  0F8 2 ---  0F8 2 ---  0F8 2 --- }
9175:      { 0F8 2 ---  0F8 2 ---  169 2 x--  0F8 2 --- }
9176:      { 168 2 x--  0F8 2 ---  167 2 x--  16F 2 x-- }
9177: ~
9178: ~
9179: ~
917A: ~
917B: ~
917C: ~
917D: ~
917E: ~
917F: ~
9180:      { 166 2 x--  16E 2 x--  165 2 x--  16D 2 x-- }
9181:      { 164 2 x--  16C 2 x--  163 2 x--  16B 2 x-- }
9182:      { 170 2 ---  175 2 ---  171 2 ---  176 2 --- }
9183:      { 172 2 ---  177 2 ---  173 2 ---  178 2 --- }
9184:      { 174 2 ---  0F8 2 ---  0F8 2 ---  0F8 2 --- }
9185:      { 0F8 2 ---  0F8 2 ---  0F8 2 ---  0F8 2 --- }
9186:      { 0F8 2 ---  0F8 2 ---  174 2 x--  0F8 2 --- }
9187: ~
9188: ~
9189: ~
918A: ~
918B: ~
918C: ~
918D: ~
918E: ~
918F: ~
9190:      { 173 2 x--  178 2 x--  172 2 x--  177 2 x-- }
9191:      { 171 2 x--  176 2 x--  170 2 x--  175 2 x-- }
9192:      { 179 2 ---  17D 2 ---  17A 2 ---  17E 2 --- }
9193:      { 17B 2 ---  17F 2 ---  17C 2 ---  16A 2 --- }
9194:      { 17C 2 x--  16A 2 x--  17B 2 x--  17F 2 x-- }
9195:      { 17A 2 x--  17E 2 x--  179 2 x--  17D 2 x-- }
9196: ~
9197: ~
9198: ~
9199: ~
919A: ~
919B: ~
919C: ~
919D: ~
919E: ~
919F: ~
91A0: ~
91A1: ~
91A2: ~
91A3: ~
91A4: ~
91A5: ~
91A6: ~
91A7: ~
91A8: ~
91A9: ~
91AA: ~
91AB: ~
91AC: ~
91AD: ~
91AE: ~
91AF: ~
91B0: ~
91B1: ~
91B2: ~
91B3: ~
91B4: ~
91B5: ~
91B6: ~
91B7: ~
91B8: ~
91B9: ~
91BA: ~
91BB: ~
91BC: ~
91BD: ~
91BE: ~
91BF: ~
91C0: ~
91C1: ~
91C2: ~
91C3: ~
91C4: ~
91C5: ~
91C6: ~
91C7: ~
91C8: ~
91C9: ~
91CA: ~
91CB: ~
91CC: ~
91CD: ~
91CE: ~
91CF: ~
91D0: ~
91D1: ~
91D2: ~
91D3: ~
91D4: ~
91D5: ~
91D6: ~
91D7: ~
91D8: ~
91D9: ~
91DA: ~
91DB: ~
91DC: ~
91DD: ~
91DE: ~
91DF: ~
91E0: ~
91E1: ~
91E2: ~
91E3: ~
91E4: ~
91E5: ~
91E6: ~
91E7: ~
91E8: ~
91E9: ~
91EA: ~
91EB: ~
91EC: ~
91ED: ~
91EE: ~
91EF: ~
91F0: ~
91F1: ~
91F2: ~
91F3: ~
91F4: ~
91F5: ~
91F6: ~
91F7: ~
91F8: ~
91F9: ~
91FA: ~
91FB: ~
91FC: ~
91FD: ~
91FE: ~
91FF: ~
