F700:      { 0F8 0 ---  0F8 0 ---  0F8 0 ---  0F8 0 --- }
F701:      { 0F8 0 ---  0F8 0 ---  0F8 0 ---  0F8 0 --- }
F702:      { 0F8 0 ---  0F8 0 ---  0F8 0 ---  0F8 0 --- }
F703:      { 0F8 0 ---  0F8 0 ---  0F8 0 ---  0F8 0 --- }
F704:      { 0F8 0 ---  0F8 0 ---  0F8 0 ---  0F8 0 --- }
F705:      { 0F8 0 ---  0F8 0 ---  0F8 0 ---  0F8 0 --- }
F706:      { 0F8 0 ---  0F8 0 ---  0F8 0 ---  0F8 0 --- }
F707:      { 0F8 0 ---  0F8 0 ---  0F8 0 ---  0F8 0 --- }
F708:      { 0F8 0 ---  0F8 0 ---  0F8 0 ---  0F8 0 --- }
F709:      { 0F8 0 ---  0F8 0 ---  0F8 0 ---  0F8 0 --- }
F70A:      { 0F8 0 ---  0F8 0 ---  0F8 0 ---  0F8 0 --- }
F70B:      { 0F8 0 ---  0F8 0 ---  0F8 0 ---  0F8 0 --- }
F70C:      { 0F8 0 ---  0F8 0 ---  0F8 0 ---  0F8 0 --- }
F70D:      { 0F8 0 ---  0F8 0 ---  0F8 0 ---  0F8 0 --- }
F70E:      { 0F8 0 ---  0F8 0 ---  0F8 0 ---  0F8 0 --- }
F70F:      { 0F8 0 ---  0F8 0 ---  0F8 0 ---  0F8 0 --- }
F710:      { 0F8 0 ---  0F8 0 ---  0F8 0 ---  0F8 0 --- }
F711:      { 0F8 0 ---  0F8 0 ---  0F8 0 ---  0F8 0 --- }
F712:      { 0F8 0 ---  0F8 0 ---  0F8 0 ---  0F8 0 --- }
F713:      { 0F8 0 ---  0F8 0 ---  0F8 0 ---  0F8 0 --- }
F714:      { 0F8 0 ---  0F8 0 ---  0F8 0 ---  0F8 0 --- }
F715:      { 0F8 0 ---  0F8 0 ---  0F8 0 ---  0F8 0 --- }
F716:      { 0F8 0 ---  0F8 0 ---  0F8 0 ---  0F8 0 --- }
F717:      { 0F8 0 ---  0F8 0 ---  0F8 0 ---  0F8 0 --- }
F718:      { 0F8 0 ---  0F8 0 ---  0F8 0 ---  0F8 0 --- }
F719:      { 0F8 0 ---  0F8 0 ---  0F8 0 ---  0F8 0 --- }
F71A:      { 0F8 0 ---  0F8 0 ---  0F8 0 ---  0F8 0 --- }
F71B:      { 0F8 0 ---  0F8 0 ---  0F8 0 ---  0F8 0 --- }
F71C:      { 0F8 0 ---  0F8 0 ---  0F8 0 ---  0F8 0 --- }
F71D:      { 0F8 0 ---  0F8 0 ---  0F8 0 ---  0F8 0 --- }
F71E:      { 0F8 0 ---  0F8 0 ---  0F8 0 ---  0F8 0 --- }
F71F:      { 0F8 0 ---  0F8 0 ---  0F8 0 ---  0F8 0 --- }
F720:      { 0F8 0 ---  0F8 0 ---  0F8 0 ---  0F8 0 --- }
F721:      { 0F8 0 ---  0F8 0 ---  0F8 0 ---  0F8 0 --- }
F722:      { 0F8 0 ---  0F8 0 ---  0F8 0 ---  0F8 0 --- }
F723:      { 0F8 0 ---  0F8 0 ---  0F8 0 ---  0F8 0 --- }
F724:      { 0F8 0 ---  0F8 0 ---  0F8 0 ---  0F8 0 --- }
F725:      { 0F8 0 ---  0F8 0 ---  0F8 0 ---  0F8 0 --- }
F726:      { 0F8 0 ---  0F8 0 ---  0F8 0 ---  0F8 0 --- }
F727:      { 0F8 0 ---  0F8 0 ---  0F8 0 ---  0F8 0 --- }
F728:      { 0F8 0 ---  0F8 0 ---  0F8 0 ---  0F8 0 --- }
F729:      { 0F8 0 ---  0F8 0 ---  0F8 0 ---  0F8 0 --- }
F72A:      { 0F8 0 ---  0F8 0 ---  0F8 0 ---  0F8 0 --- }
F72B:      { 0F8 0 ---  0F8 0 ---  0F8 0 ---  0F8 0 --- }
F72C:      { 0F8 0 ---  0F8 0 ---  0F8 0 ---  0F8 0 --- }
F72D:      { 0F8 0 ---  0F8 0 ---  0F8 0 ---  0F8 0 --- }
F72E:      { 0F8 0 ---  0F8 0 ---  0F8 0 ---  0F8 0 --- }
F72F:      { 0F8 0 ---  0F8 0 ---  0F8 0 ---  0F8 0 --- }
F730:      { 0F8 0 ---  0F8 0 ---  0F8 0 ---  0F8 0 --- }
F731:      { 0F8 0 ---  0F8 0 ---  0F8 0 ---  0F8 0 --- }
F732:      { 0F8 0 ---  0F8 0 ---  0F8 0 ---  0F8 0 --- }
F733:      { 0F8 0 ---  0F8 0 ---  0F8 0 ---  0F8 0 --- }
F734:      { 0F8 0 ---  0F8 0 ---  0F8 0 ---  0F8 0 --- }
F735:      { 0F8 0 ---  0F8 0 ---  0F8 0 ---  0F8 0 --- }
F736:      { 0F8 0 ---  0F8 0 ---  0F8 0 ---  0F8 0 --- }
F737:      { 0F8 0 ---  0F8 0 ---  0F8 0 ---  0F8 0 --- }
F738:      { 0F8 0 ---  0F8 0 ---  0F8 0 ---  0F8 0 --- }
F739:      { 0F8 0 ---  0F8 0 ---  0F8 0 ---  0F8 0 --- }
F73A:      { 0F8 0 ---  0F8 0 ---  0F8 0 ---  0F8 0 --- }
F73B:      { 0F8 0 ---  0F8 0 ---  0F8 0 ---  0F8 0 --- }
F73C:      { 0F8 0 ---  0F8 0 ---  0F8 0 ---  0F8 0 --- }
F73D:      { 0F8 0 ---  0F8 0 ---  0F8 0 ---  0F8 0 --- }
F73E:      { 0F8 0 ---  0F8 0 ---  0F8 0 ---  0F8 0 --- }
F73F:      { 0F8 0 ---  0F8 0 ---  0F8 0 ---  0F8 0 --- }
F740:      { 0F8 0 ---  0F8 0 ---  0F8 0 ---  0F8 0 --- }
F741:      { 0F8 0 ---  0F8 0 ---  0F8 0 ---  0F8 0 --- }
F742:      { 0F8 0 ---  0F8 0 ---  0F8 0 ---  0F8 0 --- }
F743:      { 0F8 0 ---  0F8 0 ---  0F8 0 ---  0F8 0 --- }
F744:      { 0F8 0 ---  0F8 0 ---  0F8 0 ---  0F8 0 --- }
F745:      { 0F8 0 ---  0F8 0 ---  0F8 0 ---  0F8 0 --- }
F746:      { 0F8 0 ---  0F8 0 ---  0F8 0 ---  0F8 0 --- }
F747:      { 0F8 0 ---  0F8 0 ---  0F8 0 ---  0F8 0 --- }
F748:      { 0F8 0 ---  0F8 0 ---  0F8 0 ---  0F8 0 --- }
F749:      { 0F8 0 ---  0F8 0 ---  0F8 0 ---  0F8 0 --- }
F74A:      { 0F8 0 ---  0F8 0 ---  0F8 0 ---  0F8 0 --- }
F74B:      { 0F8 0 ---  0F8 0 ---  0F8 0 ---  0F8 0 --- }
F74C:      { 0F8 0 ---  0F8 0 ---  0F8 0 ---  0F8 0 --- }
F74D:      { 0F8 0 ---  0F8 0 ---  0F8 0 ---  0F8 0 --- }
F74E:      { 0F8 0 ---  0F8 0 ---  0F8 0 ---  0F8 0 --- }
F74F:      { 0F8 0 ---  0F8 0 ---  0F8 0 ---  0F8 0 --- }
F750:      { 0F8 0 ---  0F8 0 ---  0F8 0 ---  0F8 0 --- }
F751:      { 0F8 0 ---  0F8 0 ---  0F8 0 ---  0F8 0 --- }
F752:      { 0F8 0 ---  0F8 0 ---  0F8 0 ---  0F8 0 --- }
F753:      { 0F8 0 ---  0F8 0 ---  0F8 0 ---  0F8 0 --- }
F754:      { 0F8 0 ---  0F8 0 ---  0F8 0 ---  0F8 0 --- }
F755:      { 0F8 0 ---  0F8 0 ---  0F8 0 ---  0F8 0 --- }
F756:      { 0F8 0 ---  0F8 0 ---  0F8 0 ---  0F8 0 --- }
F757:      { 0F8 0 ---  0F8 0 ---  0F8 0 ---  0F8 0 --- }
F758:      { 0F8 0 ---  0F8 0 ---  0F8 0 ---  0F8 0 --- }
F759:      { 0F8 0 ---  0F8 0 ---  0F8 0 ---  0F8 0 --- }
F75A:      { 0F8 0 ---  0F8 0 ---  0F8 0 ---  0F8 0 --- }
F75B:      { 0F8 0 ---  0F8 0 ---  0F8 0 ---  0F8 0 --- }
F75C:      { 0F8 0 ---  0F8 0 ---  0F8 0 ---  0F8 0 --- }
F75D:      { 0F8 0 ---  0F8 0 ---  0F8 0 ---  0F8 0 --- }
F75E:      { 0F8 0 ---  0F8 0 ---  0F8 0 ---  0F8 0 --- }
F75F:      { 0F8 0 ---  0F8 0 ---  0F8 0 ---  0F8 0 --- }
F760:      { 0F8 0 ---  0F8 0 ---  0F8 0 ---  0F8 0 --- }
F761:      { 0F8 0 ---  0F8 0 ---  0F8 0 ---  0F8 0 --- }
F762:      { 0F8 0 ---  0F8 0 ---  180 1 ---  184 1 --- }
F763:      { 181 1 ---  185 1 ---  182 1 ---  186 1 --- }
F764:      { 183 1 ---  187 1 ---  0F8 0 ---  188 1 --- }
F765:      { 0F8 0 ---  0F8 0 ---  0F8 0 ---  0F8 0 --- }
F766:      { 0F8 0 ---  0F8 0 ---  0F8 0 ---  0F8 0 --- }
F767:      { 0F8 0 ---  0F8 0 ---  0F8 0 ---  0F8 0 --- }
F768:      { 0F8 0 ---  0F8 0 ---  0F8 0 ---  0F8 0 --- }
F769:      { 0F8 0 ---  0F8 0 ---  0F8 0 ---  0F8 0 --- }
F76A:      { 0F8 0 ---  0F8 0 ---  0F8 0 ---  0F8 0 --- }
F76B:      { 0F8 0 ---  0F8 0 ---  0F8 0 ---  0F8 0 --- }
F76C:      { 0F8 0 ---  0F8 0 ---  0F8 0 ---  0F8 0 --- }
F76D:      { 0F8 0 ---  0F8 0 ---  0F8 0 ---  0F8 0 --- }
F76E:      { 0F8 0 ---  0F8 0 ---  0F8 0 ---  0F8 0 --- }
F76F:      { 0F8 0 ---  0F8 0 ---  0F8 0 ---  0F8 0 --- }
F770:      { 189 1 ---  194 1 ---  18A 1 ---  195 1 --- }
F771:      { 18B 1 ---  196 1 ---  18C 1 ---  197 1 --- }
F772:      { 18D 1 ---  198 1 ---  18E 1 ---  199 1 --- }
F773:      { 18F 1 ---  19A 1 ---  190 1 ---  19B 1 --- }
F774:      { 191 1 ---  19C 1 ---  192 1 ---  19D 1 --- }
F775:      { 193 1 ---  19E 1 ---  0F8 0 ---  19F 1 --- }
F776:      { 0F8 0 ---  0F8 0 ---  0F8 0 ---  0F8 0 --- }
F777:      { 0F8 0 ---  0F8 0 ---  0F8 0 ---  0F8 0 --- }
F778:      { 0F8 0 ---  0F8 0 ---  0F8 0 ---  0F8 0 --- }
F779:      { 0F8 0 ---  0F8 0 ---  0F8 0 ---  0F8 0 --- }
F77A:      { 0F8 0 ---  0F8 0 ---  0F8 0 ---  0F8 0 --- }
F77B:      { 0F8 0 ---  0F8 0 ---  0F8 0 ---  0F8 0 --- }
F77C:      { 0F8 0 ---  0F8 0 ---  0F8 0 ---  0F8 0 --- }
F77D:      { 0F8 0 ---  0F8 0 ---  0F8 0 ---  0F8 0 --- }
F77E:      { 0F8 0 ---  0F8 0 ---  0F8 0 ---  0F8 0 --- }
F77F:      { 0F8 0 ---  0F8 0 ---  0F8 0 ---  0F8 0 --- }
F780:      { 1A0 1 ---  1B1 1 ---  1A1 1 ---  1B2 1 --- }
F781:      { 1A2 1 ---  1B3 1 ---  1A3 1 ---  1B4 1 --- }
F782:      { 1A4 1 ---  1B5 1 ---  1A5 1 ---  1B6 1 --- }
F783:      { 1A6 1 ---  1B7 1 ---  1A7 1 ---  1B8 1 --- }
F784:      { 1A8 1 ---  1B9 1 ---  1A9 1 ---  1BA 1 --- }
F785:      { 1AA 1 ---  1BB 1 ---  1AB 1 ---  1BC 1 --- }
F786:      { 0F8 0 ---  1BD 1 ---  1AC 1 ---  1BE 1 --- }
F787:      { 1AD 1 ---  1BF 1 ---  1AE 1 ---  1C0 1 --- }
F788:      { 1AF 1 ---  1C1 1 ---  1B0 1 ---  1C2 1 --- }
F789:      { 0F8 0 ---  0F8 0 ---  0F8 0 ---  0F8 0 --- }
F78A:      { 0F8 0 ---  0F8 0 ---  0F8 0 ---  0F8 0 --- }
F78B:      { 0F8 0 ---  0F8 0 ---  0F8 0 ---  0F8 0 --- }
F78C:      { 0F8 0 ---  0F8 0 ---  0F8 0 ---  0F8 0 --- }
F78D:      { 0F8 0 ---  0F8 0 ---  0F8 0 ---  0F8 0 --- }
F78E:      { 0F8 0 ---  0F8 0 ---  0F8 0 ---  0F8 0 --- }
F78F:      { 0F8 0 ---  0F8 0 ---  0F8 0 ---  0F8 0 --- }
F790:      { 1C3 1 ---  1D4 1 ---  1C4 1 ---  1D5 1 --- }
F791:      { 1C5 1 ---  1D6 1 ---  1C6 1 ---  1D7 1 --- }
F792:      { 1C7 1 ---  1D8 1 ---  1C8 1 ---  1D9 1 --- }
F793:      { 1C9 1 ---  1DA 1 ---  1CA 1 ---  1DB 1 --- }
F794:      { 1CB 1 ---  1DC 1 ---  1CC 1 ---  1DD 1 --- }
F795:      { 0F8 0 ---  1DE 1 ---  1CD 1 ---  1DF 1 --- }
F796:      { 1CE 1 ---  1E0 1 ---  1CF 1 ---  1E1 1 --- }
F797:      { 1D0 1 ---  1E2 1 ---  1D1 1 ---  1E3 1 --- }
F798:      { 1D2 1 ---  1E4 1 ---  1D3 1 ---  1E5 1 --- }
F799:      { 0F8 0 ---  1E6 1 ---  0F8 0 ---  0F8 0 --- }
F79A:      { 0F8 0 ---  1E7 1 ---  0F8 0 ---  1E8 1 --- }
F79B:      { 0F8 0 ---  1E9 1 ---  0F8 0 ---  0F8 0 --- }
F79C:      { 0F8 0 ---  0F8 0 ---  0F8 0 ---  0F8 0 --- }
F79D:      { 0F8 0 ---  0F8 0 ---  0F8 0 ---  0F8 0 --- }
F79E:      { 0F8 0 ---  0F8 0 ---  0F8 0 ---  0F8 0 --- }
F79F:      { 0F8 0 ---  0F8 0 ---  0F8 0 ---  0F8 0 --- }
F7A0:      { 1EA 1 ---  201 1 ---  1EB 1 ---  202 1 --- }
F7A1:      { 1EC 1 ---  203 1 ---  1ED 1 ---  204 1 --- }
F7A2:      { 1EE 1 ---  205 1 ---  1EF 1 ---  206 1 --- }
F7A3:      { 1F0 1 ---  207 1 ---  1F1 1 ---  208 1 --- }
F7A4:      { 1F2 1 ---  209 1 ---  1F3 1 ---  20A 1 --- }
F7A5:      { 1F4 1 ---  20B 1 ---  1F5 1 ---  20C 1 --- }
F7A6:      { 1F6 1 ---  20D 1 ---  1F7 1 ---  20E 1 --- }
F7A7:      { 1F8 1 ---  20F 1 ---  1F9 1 ---  210 1 --- }
F7A8:      { 1FA 1 ---  211 1 ---  1FB 1 ---  212 1 --- }
F7A9:      { 1FC 1 ---  213 1 ---  1FD 1 ---  214 1 --- }
F7AA:      { 1FE 1 ---  215 1 ---  1FF 1 ---  216 1 --- }
F7AB:      { 200 1 ---  217 1 ---  0F8 0 ---  218 1 --- }
F7AC:      { 0F8 0 ---  219 1 ---  0F8 0 ---  0F8 0 --- }
F7AD:      { 0F8 0 ---  0F8 0 ---  0F8 0 ---  0F8 0 --- }
F7AE:      { 0F8 0 ---  0F8 0 ---  0F8 0 ---  0F8 0 --- }
F7AF:      { 0F8 0 ---  0F8 0 ---  0F8 0 ---  0F8 0 --- }
F7B0:      { 21A 1 ---  233 1 ---  21B 1 ---  234 1 --- }
F7B1:      { 21C 1 ---  235 1 ---  21D 1 ---  236 1 --- }
F7B2:      { 21E 1 ---  237 1 ---  21F 1 ---  0F9 1 --- }
F7B3:      { 220 1 ---  238 1 ---  221 1 ---  239 1 --- }
F7B4:      { 222 1 ---  23A 1 ---  223 1 ---  23B 1 --- }
F7B5:      { 224 1 ---  23C 1 ---  225 1 ---  23D 1 --- }
F7B6:      { 226 1 ---  23E 1 ---  227 1 ---  23F 1 --- }
F7B7:      { 228 1 ---  240 1 ---  229 1 ---  0F9 1 --- }
F7B8:      { 22A 1 ---  241 1 ---  22B 1 ---  242 1 --- }
F7B9:      { 22C 1 ---  243 1 ---  22D 1 ---  244 1 --- }
F7BA:      { 22E 1 ---  245 1 ---  22F 1 ---  246 1 --- }
F7BB:      { 230 1 ---  247 1 ---  231 1 ---  248 1 --- }
F7BC:      { 232 1 ---  249 1 ---  0F8 0 ---  0F8 0 --- }
F7BD:      { 0F8 0 ---  0F8 0 ---  0F8 0 ---  0F8 0 --- }
F7BE:      { 0F8 0 ---  0F8 0 ---  0F8 0 ---  0F8 0 --- }
F7BF:      { 0F8 0 ---  0F8 0 ---  0F8 0 ---  0F8 0 --- }
F7C0:      { 24A 1 ---  263 1 ---  24B 1 ---  264 1 --- }
F7C1:      { 24C 1 ---  265 1 ---  24D 1 ---  266 1 --- }
F7C2:      { 24E 1 ---  267 1 ---  24F 1 ---  268 1 --- }
F7C3:      { 250 1 ---  269 1 ---  251 1 ---  26A 1 --- }
F7C4:      { 252 1 ---  26B 1 ---  253 1 ---  26C 1 --- }
F7C5:      { 254 1 ---  26D 1 ---  255 1 ---  26E 1 --- }
F7C6:      { 256 1 ---  26F 1 ---  257 1 ---  0F9 1 --- }
F7C7:      { 258 1 ---  270 1 ---  259 1 ---  271 1 --- }
F7C8:      { 25A 1 ---  272 1 ---  25B 1 ---  273 1 --- }
F7C9:      { 25C 1 ---  274 1 ---  25D 1 ---  275 1 --- }
F7CA:      { 25E 1 ---  276 1 ---  25F 1 ---  277 1 --- }
F7CB:      { 260 1 ---  278 1 ---  261 1 ---  279 1 --- }
F7CC:      { 262 1 ---  27A 1 ---  0F8 0 ---  27B 1 --- }
F7CD:      { 0F8 0 ---  0F8 0 ---  0F8 0 ---  0F8 0 --- }
F7CE:      { 0F8 0 ---  0F8 0 ---  0F8 0 ---  0F8 0 --- }
F7CF:      { 0F8 0 ---  0F8 0 ---  0F8 0 ---  0F8 0 --- }
F7D0:      { 27C 1 ---  297 1 ---  27D 1 ---  298 1 --- }
F7D1:      { 27E 1 ---  299 1 ---  27F 1 ---  29A 1 --- }
F7D2:      { 280 1 ---  29B 1 ---  281 1 ---  0F9 1 --- }
F7D3:      { 282 1 ---  29C 1 ---  283 1 ---  29D 1 --- }
F7D4:      { 284 1 ---  29E 1 ---  285 1 ---  29F 1 --- }
F7D5:      { 286 1 ---  2A0 1 ---  287 1 ---  2A1 1 --- }
F7D6:      { 288 1 ---  2A2 1 ---  289 1 ---  2A3 1 --- }
F7D7:      { 28A 1 ---  0F9 1 ---  28B 1 ---  2A4 1 --- }
F7D8:      { 28C 1 ---  2A5 1 ---  28D 1 ---  2A6 1 --- }
F7D9:      { 28E 1 ---  2A7 1 ---  28F 1 ---  2A8 1 --- }
F7DA:      { 290 1 ---  2A9 1 ---  291 1 ---  2AA 1 --- }
F7DB:      { 292 1 ---  2AB 1 ---  293 1 ---  2AC 1 --- }
F7DC:      { 294 1 ---  2AD 1 ---  295 1 ---  2AE 1 --- }
F7DD:      { 296 1 ---  2AF 1 ---  0F8 0 ---  2B0 1 --- }
F7DE:      { 0F8 0 ---  0F8 0 ---  0F8 0 ---  0F8 0 --- }
F7DF:      { 0F8 0 ---  0F8 0 ---  0F8 0 ---  0F8 0 --- }
F7E0: ~
F7E1: ~
F7E2: ~
F7E3: ~
F7E4: ~
F7E5: ~
F7E6: ~
F7E7: ~
F7E8: ~
F7E9: ~
F7EA: ~
F7EB: ~
F7EC: ~
F7ED: ~
F7EE: ~
F7EF: ~
F7F0: ~
F7F1: ~
F7F2: ~
F7F3: ~
F7F4: ~
F7F5: ~
F7F6: ~
F7F7: ~
F7F8: ~
F7F9: ~
F7FA: ~
F7FB: ~
F7FC: ~
F7FD: ~
F7FE: ~
F7FF: ~
