9700:      { 104 0 ---  114 0 ---  105 0 ---  115 0 --- }
9701:      { 122 0 ---  132 0 ---  123 0 ---  133 0 --- }
9702:      { 104 0 ---  114 0 ---  105 0 ---  115 0 --- }
9703:      { 104 0 ---  114 0 ---  105 0 ---  115 0 --- }
9704:      { 104 0 ---  114 0 ---  105 0 ---  115 0 --- }
9705:      { 104 0 ---  114 0 ---  105 0 ---  115 0 --- }
9706:      { 104 0 ---  114 0 ---  105 0 ---  115 0 --- }
9707:      { 104 0 ---  114 0 ---  105 0 ---  115 0 --- }
9708:      { 104 0 ---  114 0 ---  105 0 ---  115 0 --- }
9709:      { 104 0 ---  114 0 ---  105 0 ---  115 0 --- }
970A: ~
970B: ~
970C: ~
970D: ~
970E: ~
970F: ~
9710:      { 106 0 ---  116 0 ---  107 0 ---  117 0 --- }
9711:      { 106 0 ---  116 0 ---  107 0 ---  117 0 --- }
9712:      { 106 0 ---  116 0 ---  107 0 ---  117 0 --- }
9713:      { 140 0 ---  150 0 ---  141 0 ---  151 0 --- }
9714:      { 106 0 ---  116 0 ---  107 0 ---  117 0 --- }
9715:      { 106 0 ---  116 0 ---  107 0 ---  117 0 --- }
9716:      { 106 0 ---  116 0 ---  107 0 ---  117 0 --- }
9717:      { 106 0 ---  116 0 ---  107 0 ---  117 0 --- }
9718:      { 106 0 ---  116 0 ---  107 0 ---  117 0 --- }
9719:      { 106 0 ---  116 0 ---  107 0 ---  117 0 --- }
971A: ~
971B: ~
971C: ~
971D: ~
971E: ~
971F: ~
9720:      { 10E 0 ---  11E 0 ---  10F 0 ---  11F 0 --- }
9721:      { 108 0 ---  118 0 ---  109 0 ---  119 0 --- }
9722:      { 10E 0 ---  11E 0 ---  10F 0 ---  11F 0 --- }
9723:      { 12C 0 ---  13C 0 ---  12D 0 ---  13D 0 --- }
9724:      { 128 0 ---  138 0 ---  129 0 ---  139 0 --- }
9725:      { 120 0 ---  130 0 ---  121 0 ---  131 0 --- }
9726:      { 10E 0 ---  11E 0 ---  10F 0 ---  11F 0 --- }
9727:      { 108 0 ---  118 0 ---  109 0 ---  119 0 --- }
9728:      { 10E 0 ---  11E 0 ---  10F 0 ---  11F 0 --- }
9729:      { 108 0 ---  118 0 ---  109 0 ---  119 0 --- }
972A: ~
972B: ~
972C: ~
972D: ~
972E: ~
972F: ~
9730:      { 10C 0 ---  11C 0 ---  10D 0 ---  11D 0 --- }
9731:      { 102 0 ---  112 0 ---  103 0 ---  113 0 --- }
9732:      { 10C 0 ---  11C 0 ---  10D 0 ---  11D 0 --- }
9733:      { 12A 0 ---  13A 0 ---  12B 0 ---  13B 0 --- }
9734:      { 121 0 x--  131 0 x--  120 0 x--  130 0 x-- }
9735:      { 120 0 ---  130 0 ---  121 0 ---  131 0 --- }
9736:      { 10C 0 ---  11C 0 ---  10D 0 ---  11D 0 --- }
9737:      { 102 0 ---  112 0 ---  103 0 ---  113 0 --- }
9738:      { 10C 0 ---  11C 0 ---  10D 0 ---  11D 0 --- }
9739:      { 102 0 ---  112 0 ---  103 0 ---  113 0 --- }
973A: ~
973B: ~
973C: ~
973D: ~
973E: ~
973F: ~
9740:      { 142 0 ---  152 0 ---  143 0 ---  153 0 --- }
9741:      { 12E 0 ---  13E 0 ---  12F 0 ---  13F 0 --- }
9742:      { 10C 0 ---  11C 0 ---  10D 0 ---  11D 0 --- }
9743:      { 12A 0 ---  13A 0 ---  12B 0 ---  13B 0 --- }
9744:      { 121 0 x--  131 0 x--  120 0 x--  130 0 x-- }
9745:      { 120 0 ---  130 0 ---  121 0 ---  131 0 --- }
9746:      { 10C 0 ---  11C 0 ---  10D 0 ---  11D 0 --- }
9747:      { 102 0 ---  112 0 ---  103 0 ---  113 0 --- }
9748:      { 10A 0 ---  11A 0 ---  10B 0 ---  11B 0 --- }
9749:      { 100 0 ---  110 0 ---  101 0 ---  111 0 --- }
974A: ~
974B: ~
974C: ~
974D: ~
974E: ~
974F: ~
9750:      { 0F8 0 ---  0F8 0 ---  0F8 0 ---  0F8 0 --- }
9751:      { 0F8 0 ---  0F8 0 ---  0F8 0 ---  0F8 0 --- }
9752:      { 10C 0 ---  11C 0 ---  10D 0 ---  11D 0 --- }
9753:      { 12A 0 ---  13A 0 ---  12B 0 ---  13B 0 --- }
9754:      { 121 0 x--  131 0 x--  120 0 x--  130 0 x-- }
9755:      { 120 0 ---  130 0 ---  121 0 ---  131 0 --- }
9756:      { 142 0 ---  152 0 ---  143 0 ---  153 0 --- }
9757:      { 12E 0 ---  13E 0 ---  12F 0 ---  13F 0 --- }
9758:      { 10C 0 ---  11C 0 ---  10D 0 ---  11D 0 --- }
9759:      { 102 0 ---  112 0 ---  103 0 ---  113 0 --- }
975A: ~
975B: ~
975C: ~
975D: ~
975E: ~
975F: ~
9760:      { 148 0 ---  158 0 ---  149 0 ---  159 0 --- }
9761:      { 0F8 0 ---  0F8 0 ---  0F8 0 ---  0F8 0 --- }
9762:      { 10C 0 ---  11C 0 ---  10D 0 ---  11D 0 --- }
9763:      { 12A 0 ---  13A 0 ---  12B 0 ---  13B 0 --- }
9764:      { 121 0 x--  131 0 x--  120 0 x--  130 0 x-- }
9765:      { 120 0 ---  130 0 ---  121 0 ---  131 0 --- }
9766:      { 0F8 0 ---  0F8 0 ---  0F8 0 ---  0F8 0 --- }
9767:      { 0F8 0 ---  0F8 0 ---  0F8 0 ---  0F8 0 --- }
9768:      { 10C 0 ---  11C 0 ---  10D 0 ---  11D 0 --- }
9769:      { 102 0 ---  112 0 ---  103 0 ---  113 0 --- }
976A: ~
976B: ~
976C: ~
976D: ~
976E: ~
976F: ~
9770:      { 0F8 0 ---  0F8 0 ---  0F8 0 ---  0F8 0 --- }
9771:      { 0F8 0 ---  0F8 0 ---  0F8 0 ---  0F8 0 --- }
9772:      { 10C 0 ---  11C 0 ---  10D 0 ---  11D 0 --- }
9773:      { 12A 0 ---  13A 0 ---  12B 0 ---  13B 0 --- }
9774:      { 121 0 x--  131 0 x--  120 0 x--  130 0 x-- }
9775:      { 124 0 ---  134 0 ---  125 0 ---  135 0 --- }
9776:      { 0F8 0 ---  0F8 0 ---  0F8 0 ---  0F8 0 --- }
9777:      { 149 0 x--  159 0 x--  148 0 x--  158 0 x-- }
9778:      { 14B 0 x--  15B 0 x--  14A 0 x--  15A 0 x-- }
9779:      { 102 0 ---  112 0 ---  103 0 ---  113 0 --- }
977A: ~
977B: ~
977C: ~
977D: ~
977E: ~
977F: ~
9780:      { 146 0 ---  156 0 ---  147 0 ---  157 0 --- }
9781:      { 144 0 ---  154 0 ---  145 0 ---  155 0 --- }
9782:      { 10C 0 ---  11C 0 ---  10D 0 ---  11D 0 --- }
9783:      { 12A 0 ---  13A 0 ---  12B 0 ---  13B 0 --- }
9784:      { 121 0 x--  131 0 x--  120 0 x--  130 0 x-- }
9785:      { 120 0 ---  130 0 ---  121 0 ---  131 0 --- }
9786:      { 0F8 0 ---  0F8 0 ---  0F8 0 ---  0F8 0 --- }
9787:      { 0F8 0 ---  0F8 0 ---  0F8 0 ---  0F8 0 --- }
9788:      { 10C 0 ---  11C 0 ---  10D 0 ---  11D 0 --- }
9789:      { 102 0 ---  112 0 ---  103 0 ---  113 0 --- }
978A: ~
978B: ~
978C: ~
978D: ~
978E: ~
978F: ~
9790:      { 14B 0 x--  15B 0 x--  14A 0 x--  15A 0 x-- }
9791:      { 102 0 ---  112 0 ---  103 0 ---  113 0 --- }
9792:      { 10C 0 ---  11C 0 ---  10D 0 ---  11D 0 --- }
9793:      { 12A 0 ---  13A 0 ---  12B 0 ---  13B 0 --- }
9794:      { 121 0 x--  131 0 x--  120 0 x--  130 0 x-- }
9795:      { 120 0 ---  130 0 ---  121 0 ---  131 0 --- }
9796:      { 14C 0 ---  15C 0 ---  14D 0 ---  15D 0 --- }
9797:      { 0F8 0 ---  0F8 0 ---  0F8 0 ---  0F8 0 --- }
9798:      { 10C 0 ---  11C 0 ---  10D 0 ---  11D 0 --- }
9799:      { 14A 0 ---  15A 0 ---  14B 0 ---  15B 0 --- }
979A: ~
979B: ~
979C: ~
979D: ~
979E: ~
979F: ~
97A0:      { 10A 0 ---  11A 0 ---  10B 0 ---  11B 0 --- }
97A1:      { 100 0 ---  110 0 ---  101 0 ---  111 0 --- }
97A2:      { 10C 0 ---  11C 0 ---  10D 0 ---  11D 0 --- }
97A3:      { 12A 0 ---  13A 0 ---  12B 0 ---  13B 0 --- }
97A4:      { 121 0 x--  131 0 x--  120 0 x--  130 0 x-- }
97A5:      { 120 0 ---  130 0 ---  121 0 ---  131 0 --- }
97A6:      { 0F8 0 ---  0F8 0 ---  0F8 0 ---  0F8 0 --- }
97A7:      { 0F8 0 ---  0F8 0 ---  0F8 0 ---  0F8 0 --- }
97A8:      { 10C 0 ---  11C 0 ---  10D 0 ---  11D 0 --- }
97A9:      { 102 0 ---  112 0 ---  103 0 ---  113 0 --- }
97AA: ~
97AB: ~
97AC: ~
97AD: ~
97AE: ~
97AF: ~
97B0:      { 10C 0 ---  11C 0 ---  10D 0 ---  11D 0 --- }
97B1:      { 102 0 ---  112 0 ---  103 0 ---  113 0 --- }
97B2:      { 10C 0 ---  11C 0 ---  10D 0 ---  11D 0 --- }
97B3:      { 12A 0 ---  13A 0 ---  12B 0 ---  13B 0 --- }
97B4:      { 128 0 ---  138 0 ---  129 0 ---  139 0 --- }
97B5:      { 120 0 ---  130 0 ---  121 0 ---  131 0 --- }
97B6:      { 0F8 0 ---  0F8 0 ---  0F8 0 ---  0F8 0 --- }
97B7:      { 0F8 0 ---  0F8 0 ---  0F8 0 ---  0F8 0 --- }
97B8:      { 10A 0 ---  11A 0 ---  10B 0 ---  11B 0 --- }
97B9:      { 100 0 ---  110 0 ---  101 0 ---  111 0 --- }
97BA: ~
97BB: ~
97BC: ~
97BD: ~
97BE: ~
97BF: ~
97C0:      { 10C 0 ---  11C 0 ---  10D 0 ---  11D 0 --- }
97C1:      { 102 0 ---  112 0 ---  103 0 ---  113 0 --- }
97C2:      { 10C 0 ---  11C 0 ---  10D 0 ---  11D 0 --- }
97C3:      { 12A 0 ---  13A 0 ---  12B 0 ---  13B 0 --- }
97C4:      { 121 0 x--  131 0 x--  120 0 x--  130 0 x-- }
97C5:      { 120 0 ---  130 0 ---  121 0 ---  131 0 --- }
97C6:      { 148 0 ---  158 0 ---  149 0 ---  159 0 --- }
97C7:      { 0F8 0 ---  0F8 0 ---  0F8 0 ---  0F8 0 --- }
97C8:      { 10C 0 ---  11C 0 ---  10D 0 ---  11D 0 --- }
97C9:      { 102 0 ---  112 0 ---  103 0 ---  113 0 --- }
97CA: ~
97CB: ~
97CC: ~
97CD: ~
97CE: ~
97CF: ~
97D0:      { 10A 0 ---  11A 0 ---  10B 0 ---  11B 0 --- }
97D1:      { 100 0 ---  110 0 ---  101 0 ---  111 0 --- }
97D2:      { 10C 0 ---  11C 0 ---  10D 0 ---  11D 0 --- }
97D3:      { 12A 0 ---  13A 0 ---  12B 0 ---  13B 0 --- }
97D4:      { 121 0 x--  131 0 x--  120 0 x--  130 0 x-- }
97D5:      { 120 0 ---  130 0 ---  121 0 ---  131 0 --- }
97D6:      { 0F8 0 ---  0F8 0 ---  0F8 0 ---  0F8 0 --- }
97D7:      { 0F8 0 ---  0F8 0 ---  0F8 0 ---  0F8 0 --- }
97D8:      { 10C 0 ---  11C 0 ---  10D 0 ---  11D 0 --- }
97D9:      { 102 0 ---  112 0 ---  103 0 ---  113 0 --- }
97DA: ~
97DB: ~
97DC: ~
97DD: ~
97DE: ~
97DF: ~
97E0:      { 10C 0 ---  11C 0 ---  10D 0 ---  11D 0 --- }
97E1:      { 102 0 ---  112 0 ---  103 0 ---  113 0 --- }
97E2:      { 10C 0 ---  11C 0 ---  10D 0 ---  11D 0 --- }
97E3:      { 12A 0 ---  13A 0 ---  12B 0 ---  13B 0 --- }
97E4:      { 121 0 x--  131 0 x--  120 0 x--  130 0 x-- }
97E5:      { 120 0 ---  130 0 ---  121 0 ---  131 0 --- }
97E6:      { 146 0 ---  156 0 ---  147 0 ---  157 0 --- }
97E7:      { 144 0 ---  154 0 ---  145 0 ---  155 0 --- }
97E8:      { 10C 0 ---  11C 0 ---  10D 0 ---  11D 0 --- }
97E9:      { 102 0 ---  112 0 ---  103 0 ---  113 0 --- }
97EA: ~
97EB: ~
97EC: ~
97ED: ~
97EE: ~
97EF: ~
97F0:      { 10C 0 ---  11C 0 ---  10D 0 ---  11D 0 --- }
97F1:      { 102 0 ---  112 0 ---  103 0 ---  113 0 --- }
97F2:      { 10C 0 ---  11C 0 ---  10D 0 ---  11D 0 --- }
97F3:      { 12A 0 ---  13A 0 ---  12B 0 ---  13B 0 --- }
97F4:      { 121 0 x--  131 0 x--  120 0 x--  130 0 x-- }
97F5:      { 120 0 ---  130 0 ---  121 0 ---  131 0 --- }
97F6:      { 10C 0 ---  11C 0 ---  10D 0 ---  11D 0 --- }
97F7:      { 102 0 ---  112 0 ---  103 0 ---  113 0 --- }
97F8:      { 10C 0 ---  11C 0 ---  10D 0 ---  11D 0 --- }
97F9:      { 102 0 ---  112 0 ---  103 0 ---  113 0 --- }
97FA: ~
97FB: ~
97FC: ~
97FD: ~
97FE: ~
97FF: ~
