9500: ~
9501: ~
9502: ~
9503: ~
9504: ~
9505: ~
9506: ~
9507:      { 168 1 ---  178 1 ---  169 1 ---  179 1 --- }
9508:      { 16A 1 ---  17A 1 ---  16B 1 x--  17B 1 x-- }
9509:      { 16A 1 x--  17A 1 x--  16B 1 ---  17B 1 --- }
950A:      { 16C 1 ---  17C 1 ---  16D 1 ---  17D 1 --- }
950B:      { 0F8 1 ---  17E 1 ---  0F8 1 ---  17F 1 --- }
950C:      { 100 1 ---  110 1 ---  0F8 1 ---  111 1 --- }
950D:      { 0F8 1 ---  112 1 ---  0F8 1 ---  113 1 --- }
950E:      { 0F8 1 ---  114 1 ---  0F8 1 ---  115 1 --- }
950F:      { 0F8 1 ---  116 1 ---  107 1 ---  117 1 --- }
9510: ~
9511: ~
9512: ~
9513: ~
9514: ~
9515: ~
9516: ~
9517: ~
9518:      { 101 1 ---  104 1 ---  102 1 ---  105 1 --- }
9519:      { 102 1 x--  105 1 x--  102 1 ---  105 1 --- }
951A:      { 102 1 x--  105 1 x--  103 1 ---  106 1 --- }
951B:      { 16E 1 ---  0F8 1 ---  16F 1 ---  0F8 1 --- }
951C:      { 120 1 ---  130 1 ---  121 1 ---  131 1 --- }
951D:      { 122 1 ---  132 1 ---  123 1 ---  133 1 --- }
951E:      { 124 1 ---  134 1 ---  125 1 ---  135 1 --- }
951F:      { 126 1 ---  136 1 ---  127 1 ---  137 1 --- }
9520: ~
9521: ~
9522: ~
9523: ~
9524: ~
9525: ~
9526: ~
9527: ~
9528: ~
9529: ~
952A: ~
952B: ~
952C:      { 140 1 ---  146 1 ---  141 1 ---  147 1 --- }
952D:      { 142 1 ---  143 1 ---  143 1 ---  143 1 x-- }
952E:      { 144 1 ---  147 1 x--  145 1 ---  146 1 x-- }
952F:      { 146 1 ---  147 1 x--  147 1 ---  147 1 x-- }
9530: ~
9531: ~
9532: ~
9533: ~
9534: ~
9535: ~
9536: ~
9537: ~
9538: ~
9539: ~
953A: ~
953B: ~
953C:      { 146 1 ---  150 0 ---  147 1 ---  151 0 --- }
953D:      { 147 1 ---  152 0 ---  147 1 x--  153 0 --- }
953E:      { 147 1 x--  154 0 ---  146 1 x--  155 0 --- }
953F:      { 147 1 x--  156 0 ---  147 1 x--  157 0 --- }
9540: ~
9541: ~
9542: ~
9543: ~
9544: ~
9545: ~
9546: ~
9547: ~
9548: ~
9549: ~
954A:      { 0F8 0 ---  0F8 0 ---  0F8 0 ---  0F8 0 --- }
954B: ~
954C:      { 160 0 ---  170 0 ---  161 0 ---  171 0 --- }
954D:      { 162 0 ---  172 0 ---  163 0 ---  173 0 --- }
954E:      { 164 0 ---  174 0 ---  165 0 ---  175 0 --- }
954F:      { 166 0 ---  176 0 ---  167 0 ---  177 0 --- }
9550: ~
9551: ~
9552: ~
9553: ~
9554: ~
9555: ~
9556: ~
9557: ~
9558: ~
9559: ~
955A: ~
955B: ~
955C:      { 108 0 ---  118 0 ---  109 0 ---  119 0 --- }
955D:      { 10A 0 ---  11A 0 ---  10B 0 ---  11B 0 --- }
955E:      { 10C 0 ---  11C 0 ---  10D 0 ---  11D 0 --- }
955F:      { 10E 0 ---  11E 0 ---  10F 0 ---  11F 0 --- }
9560: ~
9561: ~
9562: ~
9563: ~
9564: ~
9565: ~
9566: ~
9567: ~
9568: ~
9569: ~
956A: ~
956B: ~
956C:      { 128 0 ---  138 0 ---  129 0 ---  139 0 --- }
956D:      { 12A 0 ---  13A 0 ---  12B 0 ---  13B 0 --- }
956E:      { 12C 0 ---  13C 0 ---  12D 0 ---  13D 0 --- }
956F:      { 12E 0 ---  13E 0 ---  12F 0 ---  13F 0 --- }
9570: ~
9571: ~
9572: ~
9573: ~
9574: ~
9575: ~
9576: ~
9577: ~
9578: ~
9579: ~
957A: ~
957B: ~
957C:      { 148 0 ---  158 0 ---  149 0 ---  159 0 --- }
957D:      { 14A 0 ---  15A 0 ---  14B 0 ---  15B 0 --- }
957E:      { 14C 0 ---  15C 0 ---  14D 0 ---  15D 0 --- }
957F:      { 14E 0 ---  15E 0 ---  14F 0 ---  15F 0 --- }
9580: ~
9581: ~
9582: ~
9583: ~
9584: ~
9585: ~
9586: ~
9587: ~
9588: ~
9589: ~
958A: ~
958B: ~
958C:      { 0FA 0 ---  0FA 0 ---  0FA 0 ---  0FA 0 --- }
958D:      { 0FE 0 ---  0FE 0 ---  0FE 0 ---  0FE 0 --- }
958E: ~
958F: ~
9590: ~
9591: ~
9592: ~
9593: ~
9594: ~
9595: ~
9596: ~
9597: ~
9598: ~
9599: ~
959A: ~
959B: ~
959C: ~
959D: ~
959E: ~
959F: ~
95A0: ~
95A1: ~
95A2: ~
95A3: ~
95A4: ~
95A5: ~
95A6: ~
95A7: ~
95A8: ~
95A9: ~
95AA: ~
95AB: ~
95AC: ~
95AD: ~
95AE: ~
95AF: ~
95B0: ~
95B1: ~
95B2: ~
95B3: ~
95B4: ~
95B5: ~
95B6: ~
95B7: ~
95B8: ~
95B9: ~
95BA: ~
95BB: ~
95BC: ~
95BD: ~
95BE: ~
95BF: ~
95C0: ~
95C1: ~
95C2: ~
95C3: ~
95C4: ~
95C5: ~
95C6: ~
95C7: ~
95C8: ~
95C9: ~
95CA: ~
95CB: ~
95CC: ~
95CD: ~
95CE: ~
95CF: ~
95D0: ~
95D1: ~
95D2: ~
95D3: ~
95D4: ~
95D5: ~
95D6: ~
95D7: ~
95D8: ~
95D9: ~
95DA: ~
95DB: ~
95DC: ~
95DD: ~
95DE: ~
95DF: ~
95E0: ~
95E1: ~
95E2: ~
95E3: ~
95E4: ~
95E5: ~
95E6: ~
95E7: ~
95E8: ~
95E9: ~
95EA: ~
95EB: ~
95EC: ~
95ED: ~
95EE: ~
95EF: ~
95F0: ~
95F1: ~
95F2: ~
95F3: ~
95F4: ~
95F5: ~
95F6: ~
95F7: ~
95F8: ~
95F9: ~
95FA: ~
95FB: ~
95FC: ~
95FD: ~
95FE: ~
95FF: ~
