F900:      { 0F8 0 ---  0F8 0 ---  0F8 0 ---  0F8 0 --- }
F901:      { 0F8 0 ---  0F8 0 ---  0F8 0 ---  0F8 0 --- }
F902:      { 0F8 0 ---  0F8 0 ---  0F8 0 ---  0F8 0 --- }
F903:      { 0F8 0 ---  0F8 0 ---  0F8 0 ---  0F8 0 --- }
F904:      { 0F8 0 ---  0F8 0 ---  0F8 0 ---  0F8 0 --- }
F905:      { 0F8 0 ---  0F8 0 ---  0F8 0 ---  0F8 0 --- }
F906:      { 0F8 0 ---  0F8 0 ---  0F8 0 ---  0F8 0 --- }
F907:      { 0F8 0 ---  0F8 0 ---  0F8 0 ---  0F8 0 --- }
F908:      { 0F8 0 ---  0F8 0 ---  0F8 0 ---  0F8 0 --- }
F909:      { 0F8 0 ---  0F8 0 ---  0F8 0 ---  0F8 0 --- }
F90A:      { 0F8 0 ---  0F8 0 ---  0F8 0 ---  0F8 0 --- }
F90B:      { 0F8 0 ---  0F8 0 ---  0F8 0 ---  0F8 0 --- }
F90C:      { 0F8 0 ---  0F8 0 ---  0F8 0 ---  0F8 0 --- }
F90D:      { 0F8 0 ---  0F8 0 ---  0F8 0 ---  0F8 0 --- }
F90E:      { 0F8 0 ---  0F8 0 ---  0F8 0 ---  0F8 0 --- }
F90F:      { 0F8 0 ---  0F8 0 ---  0F8 0 ---  0F8 0 --- }
F910:      { 0F8 0 ---  0F8 0 ---  0F8 0 ---  0F8 0 --- }
F911:      { 0F8 0 ---  0F8 0 ---  0F8 0 ---  0F8 0 --- }
F912:      { 0F8 0 ---  0F8 0 ---  0F8 0 ---  0F8 0 --- }
F913:      { 0F8 0 ---  0F8 0 ---  0F8 0 ---  0F8 0 --- }
F914:      { 0F8 0 ---  0F8 0 ---  0F8 0 ---  0F8 0 --- }
F915:      { 0F8 0 ---  0F8 0 ---  0F8 0 ---  0F8 0 --- }
F916:      { 0F8 0 ---  0F8 0 ---  0F8 0 ---  0F8 0 --- }
F917:      { 0F8 0 ---  0F8 0 ---  0F8 0 ---  0F8 0 --- }
F918:      { 0F8 0 ---  0F8 0 ---  0F8 0 ---  0F8 0 --- }
F919:      { 0F8 0 ---  0F8 0 ---  0F8 0 ---  0F8 0 --- }
F91A:      { 0F8 0 ---  0F8 0 ---  0F8 0 ---  0F8 0 --- }
F91B:      { 0F8 0 ---  0F8 0 ---  0F8 0 ---  0F8 0 --- }
F91C:      { 0F8 0 ---  0F8 0 ---  0F8 0 ---  0F8 0 --- }
F91D:      { 0F8 0 ---  0F8 0 ---  0F8 0 ---  0F8 0 --- }
F91E:      { 0F8 0 ---  0F8 0 ---  0F8 0 ---  0F8 0 --- }
F91F:      { 0F8 0 ---  0F8 0 ---  0F8 0 ---  0F8 0 --- }
F920:      { 0F8 0 ---  0F8 0 ---  0F8 0 ---  0F8 0 --- }
F921:      { 0F8 0 ---  0F8 0 ---  0F8 0 ---  0F8 0 --- }
F922:      { 0F8 0 ---  0F8 0 ---  0F8 0 ---  0F8 0 --- }
F923:      { 0F8 0 ---  0F8 0 ---  0F8 0 ---  0F8 0 --- }
F924:      { 0F8 0 ---  0F8 0 ---  0F8 0 ---  0F8 0 --- }
F925:      { 0F8 0 ---  0F8 0 ---  0F8 0 ---  0F8 0 --- }
F926:      { 0F8 0 ---  0F8 0 ---  0F8 0 ---  0F8 0 --- }
F927:      { 0F8 0 ---  0F8 0 ---  0F8 0 ---  0F8 0 --- }
F928:      { 0F8 0 ---  0F8 0 ---  0F8 0 ---  0F8 0 --- }
F929:      { 0F8 0 ---  0F8 0 ---  0F8 0 ---  0F8 0 --- }
F92A:      { 0F8 0 ---  0F8 0 ---  0F8 0 ---  0F8 0 --- }
F92B:      { 0F8 0 ---  0F8 0 ---  0F8 0 ---  0F8 0 --- }
F92C:      { 0F8 0 ---  0F8 0 ---  0F8 0 ---  0F8 0 --- }
F92D:      { 0F8 0 ---  0F8 0 ---  0F8 0 ---  0F8 0 --- }
F92E:      { 0F8 0 ---  0F8 0 ---  0F8 0 ---  0F8 0 --- }
F92F:      { 0F8 0 ---  0F8 0 ---  0F8 0 ---  0F8 0 --- }
F930:      { 0F8 0 ---  0F8 0 ---  0F8 0 ---  0F8 0 --- }
F931:      { 0F8 0 ---  0F8 0 ---  0F8 0 ---  0F8 0 --- }
F932:      { 0F8 0 ---  0F8 0 ---  0F8 0 ---  0F8 0 --- }
F933:      { 0F8 0 ---  0F8 0 ---  0F8 0 ---  0F8 0 --- }
F934:      { 0F8 0 ---  0F8 0 ---  0F8 0 ---  0F8 0 --- }
F935:      { 0F8 0 ---  0F8 0 ---  0F8 0 ---  0F8 0 --- }
F936:      { 0F8 0 ---  0F8 0 ---  0F8 0 ---  0F8 0 --- }
F937:      { 0F8 0 ---  0F8 0 ---  0F8 0 ---  0F8 0 --- }
F938:      { 0F8 0 ---  0F8 0 ---  0F8 0 ---  0F8 0 --- }
F939:      { 0F8 0 ---  0F8 0 ---  0F8 0 ---  0F8 0 --- }
F93A:      { 0F8 0 ---  0F8 0 ---  0F8 0 ---  0F8 0 --- }
F93B:      { 0F8 0 ---  0F8 0 ---  0F8 0 ---  0F8 0 --- }
F93C:      { 0F8 0 ---  0F8 0 ---  0F8 0 ---  0F8 0 --- }
F93D:      { 0F8 0 ---  0F8 0 ---  0F8 0 ---  0F8 0 --- }
F93E:      { 0F8 0 ---  0F8 0 ---  0F8 0 ---  0F8 0 --- }
F93F:      { 0F8 0 ---  0F8 0 ---  0F8 0 ---  0F8 0 --- }
F940:      { 0F8 0 ---  0F8 0 ---  0F8 0 ---  0F8 0 --- }
F941:      { 0F8 0 ---  0F8 0 ---  0F8 0 ---  0F8 0 --- }
F942:      { 0F8 0 ---  0F8 0 ---  0F8 0 ---  0F8 0 --- }
F943:      { 0F8 0 ---  0F8 0 ---  0F8 0 ---  0F8 0 --- }
F944:      { 0F8 0 ---  0F8 0 ---  0F8 0 ---  0F8 0 --- }
F945:      { 0F8 0 ---  0F8 0 ---  0F8 0 ---  0F8 0 --- }
F946:      { 0F8 0 ---  0F8 0 ---  0F8 0 ---  0F8 0 --- }
F947:      { 0F8 0 ---  0F8 0 ---  0F8 0 ---  0F8 0 --- }
F948:      { 0F8 0 ---  0F8 0 ---  0F8 0 ---  0F8 0 --- }
F949:      { 0F8 0 ---  0F8 0 ---  0F8 0 ---  0F8 0 --- }
F94A:      { 0F8 0 ---  0F8 0 ---  0F8 0 ---  0F8 0 --- }
F94B:      { 0F8 0 ---  0F8 0 ---  0F8 0 ---  0F8 0 --- }
F94C:      { 0F8 0 ---  0F8 0 ---  0F8 0 ---  0F8 0 --- }
F94D:      { 0F8 0 ---  0F8 0 ---  0F8 0 ---  0F8 0 --- }
F94E:      { 0F8 0 ---  0F8 0 ---  0F8 0 ---  0F8 0 --- }
F94F:      { 0F8 0 ---  0F8 0 ---  0F8 0 ---  0F8 0 --- }
F950:      { 0F8 0 ---  0F8 0 ---  0F8 0 ---  0F8 0 --- }
F951:      { 0F8 0 ---  0F8 0 ---  0F8 0 ---  0F8 0 --- }
F952:      { 0F8 0 ---  0F8 0 ---  0F8 0 ---  0F8 0 --- }
F953:      { 0F8 0 ---  0F8 0 ---  0F8 0 ---  0F8 0 --- }
F954:      { 0F8 0 ---  0F8 0 ---  0F8 0 ---  0F8 0 --- }
F955:      { 0F8 0 ---  0F8 0 ---  0F8 0 ---  0F8 0 --- }
F956:      { 0F8 0 ---  0F8 0 ---  0F8 0 ---  0F8 0 --- }
F957:      { 0F8 0 ---  0F8 0 ---  0F8 0 ---  0F8 0 --- }
F958:      { 0F8 0 ---  0F8 0 ---  0F8 0 ---  0F8 0 --- }
F959:      { 0F8 0 ---  0F8 0 ---  280 1 ---  284 1 --- }
F95A:      { 281 1 ---  285 1 ---  282 1 ---  286 1 --- }
F95B:      { 283 1 ---  287 1 ---  0F8 0 ---  288 1 --- }
F95C:      { 0F8 0 ---  0F8 0 ---  0F8 0 ---  0F8 0 --- }
F95D:      { 0F8 0 ---  0F8 0 ---  0F8 0 ---  0F8 0 --- }
F95E:      { 0F8 0 ---  0F8 0 ---  0F8 0 ---  0F8 0 --- }
F95F:      { 0F8 0 ---  0F8 0 ---  0F8 0 ---  0F8 0 --- }
F960:      { 0F8 0 ---  0F8 0 ---  0F8 0 ---  0F8 0 --- }
F961:      { 0F8 0 ---  0F8 0 ---  0F8 0 ---  0F8 0 --- }
F962:      { 0F8 0 ---  0F8 0 ---  0F8 0 ---  0F8 0 --- }
F963:      { 0F8 0 ---  0F8 0 ---  0F8 0 ---  0F8 0 --- }
F964:      { 0F8 0 ---  0F8 0 ---  0F8 0 ---  0F8 0 --- }
F965:      { 0F8 0 ---  0F8 0 ---  0F8 0 ---  0F8 0 --- }
F966:      { 0F8 0 ---  0F8 0 ---  0F8 0 ---  0F8 0 --- }
F967:      { 0F8 0 ---  0F8 0 ---  0F8 0 ---  0F8 0 --- }
F968:      { 0F8 0 ---  0F8 0 ---  0F8 0 ---  292 1 --- }
F969:      { 289 1 ---  293 1 ---  28A 1 ---  294 1 --- }
F96A:      { 28B 1 ---  295 1 ---  28C 1 ---  296 1 --- }
F96B:      { 28D 1 ---  297 1 ---  28E 1 ---  298 1 --- }
F96C:      { 28F 1 ---  299 1 ---  290 1 ---  29A 1 --- }
F96D:      { 291 1 ---  29B 1 ---  0F8 0 ---  0F8 0 --- }
F96E:      { 0F8 0 ---  0F8 0 ---  0F8 0 ---  0F8 0 --- }
F96F:      { 0F8 0 ---  0F8 0 ---  0F8 0 ---  0F8 0 --- }
F970:      { 0F8 0 ---  0F8 0 ---  0F8 0 ---  0F8 0 --- }
F971:      { 0F8 0 ---  0F8 0 ---  0F8 0 ---  0F8 0 --- }
F972:      { 0F8 0 ---  0F8 0 ---  0F8 0 ---  0F8 0 --- }
F973:      { 0F8 0 ---  0F8 0 ---  0F8 0 ---  0F8 0 --- }
F974:      { 0F8 0 ---  0F8 0 ---  0F8 0 ---  0F8 0 --- }
F975:      { 0F8 0 ---  0F8 0 ---  0F8 0 ---  0F8 0 --- }
F976:      { 0F8 0 ---  0F8 0 ---  0F8 0 ---  0F8 0 --- }
F977:      { 0F8 0 ---  0F8 0 ---  0F8 0 ---  0F8 0 --- }
F978:      { 0F8 0 ---  0F8 0 ---  29C 1 ---  2A7 1 --- }
F979:      { 29D 1 ---  2A8 1 ---  29E 1 ---  2A9 1 --- }
F97A:      { 29F 1 ---  2AA 1 ---  2A0 1 ---  2AB 1 --- }
F97B:      { 2A1 1 ---  2AC 1 ---  2A2 1 ---  2AD 1 --- }
F97C:      { 2A3 1 ---  2AE 1 ---  2A4 1 ---  2AF 1 --- }
F97D:      { 2A5 1 ---  2B0 1 ---  2A6 1 ---  2B1 1 --- }
F97E:      { 0F8 0 ---  0F8 0 ---  0F8 0 ---  0F8 0 --- }
F97F:      { 0F8 0 ---  0F8 0 ---  0F8 0 ---  0F8 0 --- }
F980:      { 0F8 0 ---  0F8 0 ---  0F8 0 ---  0F8 0 --- }
F981:      { 0F8 0 ---  0F8 0 ---  0F8 0 ---  0F8 0 --- }
F982:      { 0F8 0 ---  0F8 0 ---  0F8 0 ---  0F8 0 --- }
F983:      { 0F8 0 ---  0F8 0 ---  0F8 0 ---  0F8 0 --- }
F984:      { 0F8 0 ---  0F8 0 ---  0F8 0 ---  0F8 0 --- }
F985:      { 0F8 0 ---  0F8 0 ---  0F8 0 ---  0F8 0 --- }
F986:      { 0F8 0 ---  0F8 0 ---  0F8 0 ---  0F8 0 --- }
F987:      { 0F8 0 ---  0F8 0 ---  0F8 0 ---  0F8 0 --- }
F988:      { 0F8 0 ---  0F8 0 ---  2B2 1 ---  2BD 1 --- }
F989:      { 2B3 1 ---  2BE 1 ---  2B4 1 ---  2BF 1 --- }
F98A:      { 2B5 1 ---  2C0 1 ---  2B6 1 ---  2C1 1 --- }
F98B:      { 2B7 1 ---  2C2 1 ---  2B8 1 ---  2C3 1 --- }
F98C:      { 2B9 1 ---  2C4 1 ---  2BA 1 ---  2C5 1 --- }
F98D:      { 2BB 1 ---  2C6 1 ---  2BC 1 ---  2C7 1 --- }
F98E:      { 0F8 0 ---  0F8 0 ---  0F8 0 ---  0F8 0 --- }
F98F:      { 0F8 0 ---  0F8 0 ---  0F8 0 ---  0F8 0 --- }
F990:      { 0F8 0 ---  0F8 0 ---  0F8 0 ---  0F8 0 --- }
F991:      { 0F8 0 ---  0F8 0 ---  0F8 0 ---  0F8 0 --- }
F992:      { 0F8 0 ---  0F8 0 ---  0F8 0 ---  0F8 0 --- }
F993:      { 0F8 0 ---  0F8 0 ---  0F8 0 ---  0F8 0 --- }
F994:      { 0F8 0 ---  0F8 0 ---  0F8 0 ---  0F8 0 --- }
F995:      { 0F8 0 ---  0F8 0 ---  0F8 0 ---  0F8 0 --- }
F996:      { 0F8 0 ---  0F8 0 ---  0F8 0 ---  0F8 0 --- }
F997:      { 0F8 0 ---  0F8 0 ---  0F8 0 ---  0F8 0 --- }
F998:      { 2C8 1 ---  0F8 0 ---  2C9 1 ---  0F8 0 --- }
F999:      { 2CA 1 ---  2D4 1 ---  2CB 1 ---  2D5 1 --- }
F99A:      { 2CC 1 ---  2D6 1 ---  2CD 1 ---  2D7 1 --- }
F99B:      { 2CE 1 ---  2D8 1 ---  2CF 1 ---  2D9 1 --- }
F99C:      { 2D0 1 ---  2DA 1 ---  2D1 1 ---  2DB 1 --- }
F99D:      { 2D2 1 ---  2DC 1 ---  2D3 1 ---  0F8 0 --- }
F99E:      { 0F8 0 ---  0F8 0 ---  0F8 0 ---  0F8 0 --- }
F99F:      { 0F8 0 ---  0F8 0 ---  0F8 0 ---  0F8 0 --- }
F9A0:      { 0F8 0 ---  0F8 0 ---  0F8 0 ---  0F8 0 --- }
F9A1:      { 0F8 0 ---  0F8 0 ---  0F8 0 ---  0F8 0 --- }
F9A2:      { 0F8 0 ---  0F8 0 ---  0F8 0 ---  0F8 0 --- }
F9A3:      { 0F8 0 ---  0F8 0 ---  0F8 0 ---  0F8 0 --- }
F9A4:      { 0F8 0 ---  0F8 0 ---  0F8 0 ---  0F8 0 --- }
F9A5:      { 0F8 0 ---  0F8 0 ---  0F8 0 ---  0F8 0 --- }
F9A6:      { 0F8 0 ---  0F8 0 ---  0F8 0 ---  0F8 0 --- }
F9A7:      { 0F8 0 ---  0F8 0 ---  0F8 0 ---  0F8 0 --- }
F9A8:      { 0F8 0 ---  0F8 0 ---  0F8 0 ---  0F8 0 --- }
F9A9:      { 2DD 1 ---  0F8 0 ---  2DE 1 ---  2E6 1 --- }
F9AA:      { 2DF 1 ---  2E7 1 ---  2E0 1 ---  2E8 1 --- }
F9AB:      { 2E1 1 ---  2E9 1 ---  2E2 1 ---  2EA 1 --- }
F9AC:      { 2E3 1 ---  2EB 1 ---  2E4 1 ---  0F8 0 --- }
F9AD:      { 2E5 1 ---  2EC 1 ---  0F8 0 ---  0F8 0 --- }
F9AE:      { 0F8 0 ---  0F8 0 ---  0F8 0 ---  0F8 0 --- }
F9AF:      { 0F8 0 ---  0F8 0 ---  0F8 0 ---  0F8 0 --- }
F9B0:      { 0F8 0 ---  0F8 0 ---  0F8 0 ---  0F8 0 --- }
F9B1:      { 0F8 0 ---  0F8 0 ---  0F8 0 ---  0F8 0 --- }
F9B2:      { 0F8 0 ---  0F8 0 ---  0F8 0 ---  0F8 0 --- }
F9B3:      { 0F8 0 ---  0F8 0 ---  0F8 0 ---  0F8 0 --- }
F9B4:      { 0F8 0 ---  0F8 0 ---  0F8 0 ---  0F8 0 --- }
F9B5:      { 0F8 0 ---  0F8 0 ---  0F8 0 ---  0F8 0 --- }
F9B6:      { 0F8 0 ---  0F8 0 ---  0F8 0 ---  0F8 0 --- }
F9B7:      { 0F8 0 ---  0F8 0 ---  0F8 0 ---  0F8 0 --- }
F9B8:      { 0F8 0 ---  0F8 0 ---  0F8 0 ---  0F8 0 --- }
F9B9:      { 0F8 0 ---  0F8 0 ---  2ED 1 ---  0F8 0 --- }
F9BA:      { 2EE 1 ---  2F1 1 ---  2EF 1 ---  2F2 1 --- }
F9BB:      { 2E9 1 ---  2F3 1 ---  2EA 1 ---  2F4 1 --- }
F9BC:      { 2F0 1 ---  2F5 1 ---  0F8 0 ---  0F8 0 --- }
F9BD:      { 0F8 0 ---  0F8 0 ---  0F8 0 ---  0F8 0 --- }
F9BE:      { 0F8 0 ---  0F8 0 ---  0F8 0 ---  0F8 0 --- }
F9BF:      { 0F8 0 ---  0F8 0 ---  0F8 0 ---  0F8 0 --- }
F9C0:      { 0F8 0 ---  0F8 0 ---  0F8 0 ---  0F8 0 --- }
F9C1:      { 0F8 0 ---  0F8 0 ---  0F8 0 ---  0F8 0 --- }
F9C2:      { 0F8 0 ---  0F8 0 ---  0F8 0 ---  0F8 0 --- }
F9C3:      { 0F8 0 ---  0F8 0 ---  0F8 0 ---  0F8 0 --- }
F9C4:      { 0F8 0 ---  0F8 0 ---  0F8 0 ---  0F8 0 --- }
F9C5:      { 0F8 0 ---  0F8 0 ---  0F8 0 ---  0F8 0 --- }
F9C6:      { 0F8 0 ---  0F8 0 ---  0F8 0 ---  0F8 0 --- }
F9C7:      { 0F8 0 ---  0F8 0 ---  0F8 0 ---  0F8 0 --- }
F9C8:      { 0F8 0 ---  0F8 0 ---  0F8 0 ---  0F8 0 --- }
F9C9:      { 0F8 0 ---  0F8 0 ---  0F8 0 ---  0F8 0 --- }
F9CA:      { 2F6 1 ---  0F8 0 ---  2F7 1 ---  0F8 0 --- }
F9CB:      { 2F8 1 ---  0F8 0 ---  2F9 1 ---  0F8 0 --- }
F9CC:      { 0F8 0 ---  0F8 0 ---  0F8 0 ---  0F8 0 --- }
F9CD:      { 0F8 0 ---  0F8 0 ---  0F8 0 ---  0F8 0 --- }
F9CE:      { 0F8 0 ---  0F8 0 ---  0F8 0 ---  0F8 0 --- }
F9CF:      { 0F8 0 ---  0F8 0 ---  0F8 0 ---  0F8 0 --- }
F9D0:      { 0F8 0 ---  0F8 0 ---  0F8 0 ---  0F8 0 --- }
F9D1:      { 0F8 0 ---  0F8 0 ---  0F8 0 ---  0F8 0 --- }
F9D2:      { 0F8 0 ---  0F8 0 ---  0F8 0 ---  0F8 0 --- }
F9D3:      { 0F8 0 ---  0F8 0 ---  0F8 0 ---  0F8 0 --- }
F9D4:      { 0F8 0 ---  0F8 0 ---  0F8 0 ---  0F8 0 --- }
F9D5:      { 0F8 0 ---  0F8 0 ---  0F8 0 ---  0F8 0 --- }
F9D6:      { 0F8 0 ---  0F8 0 ---  0F8 0 ---  0F8 0 --- }
F9D7:      { 0F8 0 ---  0F8 0 ---  0F8 0 ---  0F8 0 --- }
F9D8:      { 0F8 0 ---  0F8 0 ---  0F8 0 ---  0F8 0 --- }
F9D9:      { 0F8 0 ---  0F8 0 ---  0F8 0 ---  0F8 0 --- }
F9DA:      { 0F8 0 ---  0F8 0 ---  0F8 0 ---  0F8 0 --- }
F9DB:      { 0F8 0 ---  0F8 0 ---  0F8 0 ---  0F8 0 --- }
F9DC:      { 0F8 0 ---  0F8 0 ---  0F8 0 ---  0F8 0 --- }
F9DD:      { 0F8 0 ---  0F8 0 ---  0F8 0 ---  0F8 0 --- }
F9DE:      { 0F8 0 ---  0F8 0 ---  0F8 0 ---  0F8 0 --- }
F9DF:      { 0F8 0 ---  0F8 0 ---  0F8 0 ---  0F8 0 --- }
F9E0: ~
F9E1: ~
F9E2: ~
F9E3: ~
F9E4: ~
F9E5: ~
F9E6: ~
F9E7: ~
F9E8: ~
F9E9: ~
F9EA: ~
F9EB: ~
F9EC: ~
F9ED: ~
F9EE: ~
F9EF: ~
F9F0: ~
F9F1: ~
F9F2: ~
F9F3: ~
F9F4: ~
F9F5: ~
F9F6: ~
F9F7: ~
F9F8: ~
F9F9: ~
F9FA: ~
F9FB: ~
F9FC: ~
F9FD: ~
F9FE: ~
F9FF: ~
