8400:      { 100 0 ---  100 0 ---  100 0 ---  100 0 --- }
8401:      { 101 0 ---  109 0 ---  102 0 ---  10A 0 --- }
8402:      { 103 0 ---  10B 0 ---  104 0 ---  10C 0 --- }
8403:      { 105 0 ---  10D 0 ---  106 0 ---  10E 0 --- }
8404:      { 107 0 ---  10F 0 ---  108 0 ---  110 0 --- }
8405:      { 100 0 ---  117 0 ---  111 0 ---  118 0 --- }
8406:      { 112 0 ---  119 0 ---  113 0 ---  11A 0 --- }
8407:      { 114 0 ---  11B 0 ---  115 0 ---  11C 0 --- }
8408:      { 116 0 ---  11D 0 ---  100 0 ---  11E 0 --- }
8409:      { 11F 0 ---  127 0 ---  120 0 ---  128 0 --- }
840A:      { 121 0 ---  129 0 ---  122 0 ---  12A 0 --- }
840B:      { 123 0 ---  12B 0 ---  124 0 ---  12C 0 --- }
840C:      { 125 0 ---  12D 0 ---  126 0 ---  12E 0 --- }
840D:      { 12F 0 ---  137 0 ---  130 0 ---  138 0 --- }
840E:      { 131 0 ---  139 0 ---  132 0 ---  13A 0 --- }
840F:      { 133 0 ---  13B 0 ---  134 0 ---  13C 0 --- }
8410:      { 129 0 ---  133 0 ---  12A 0 ---  134 0 --- }
8411:      { 12B 0 ---  13D 0 ---  12C 0 ---  13E 0 --- }
8412:      { 135 0 ---  13F 0 ---  136 0 ---  140 0 --- }
8413:      { 141 0 ---  147 0 ---  142 0 ---  148 0 --- }
8414:      { 143 0 ---  149 0 ---  144 0 ---  14A 0 --- }
8415:      { 145 0 ---  14B 0 ---  146 0 ---  14C 0 --- }
8416:      { 14D 0 ---  151 0 ---  14E 0 ---  152 0 --- }
8417:      { 14F 0 ---  153 0 ---  150 0 ---  154 0 --- }
8418:      { 155 0 ---  157 0 ---  156 0 ---  158 0 --- }
8419:      { 155 0 ---  157 0 ---  159 0 ---  15C 0 --- }
841A:      { 15A 0 ---  15D 0 ---  15B 0 ---  15E 0 --- }
841B:      { 156 0 x--  158 0 x--  155 0 x--  157 0 x-- }
841C:      { 15F 0 ---  165 0 ---  160 0 ---  166 0 --- }
841D:      { 161 0 ---  167 0 ---  162 0 ---  168 0 --- }
841E:      { 15D 0 ---  169 0 ---  15E 0 ---  16A 0 --- }
841F:      { 163 0 ---  16B 0 ---  164 0 ---  16C 0 --- }
8420:      { 16D 0 ---  171 0 ---  16E 0 ---  172 0 --- }
8421:      { 16F 0 ---  173 0 ---  170 0 ---  174 0 --- }
8422:      { 169 0 ---  175 0 ---  16A 0 ---  176 0 --- }
8423:      { 164 0 x--  16C 0 x--  163 0 x--  16B 0 x-- }
8424:      { 177 0 ---  17B 0 ---  178 0 ---  17C 0 --- }
8425:      { 175 0 ---  17A 0 ---  176 0 ---  179 0 --- }
8426:      { 179 0 x--  17D 0 x--  17A 0 x--  17E 0 x-- }
8427:      { 165 0 ---  16D 0 ---  166 0 ---  16E 0 --- }
8428:      { 17F 0 ---  17F 0 ---  17F 0 ---  17F 0 --- }
8429:      { 16E 0 x--  172 0 x--  16D 0 x--  171 0 x-- }
842A:      { 17A 0 ---  17E 0 ---  179 0 ---  17D 0 --- }
842B:      { 178 0 x--  17C 0 x--  177 0 x--  17B 0 x-- }
842C:      { 200 0 ---  202 0 ---  201 0 ---  203 0 --- }
842D:      { 204 0 ---  206 0 ---  205 0 ---  207 0 --- }
842E:      { 208 0 ---  20A 0 ---  209 0 ---  20B 0 --- }
842F:      { 20C 0 ---  20E 0 ---  20D 0 ---  20F 0 --- }
8430:      { 210 0 ---  210 0 ---  210 0 ---  210 0 --- }
8431:      { 211 1 ---  213 1 ---  212 1 ---  211 1 --- }
8432:      { 212 1 ---  211 1 ---  214 1 ---  215 1 --- }
8433:      { 216 1 ---  21D 1 ---  217 1 ---  21C 1 --- }
8434:      { 211 1 xy-  21B 1 ---  215 1 ---  21A 1 --- }
8435:      { 218 1 ---  220 1 ---  219 1 ---  221 1 --- }
8436:      { 21A 1 x--  222 1 x--  21B 1 x--  223 1 x-- }
8437:      { 21C 1 x--  224 1 x--  21D 1 x--  225 1 x-- }
8438:      { 21E 1 x--  219 1 x--  21F 1 x--  218 1 x-- }
8439:      { 21D 1 ---  225 1 ---  21C 1 ---  224 1 --- }
843A:      { 215 1 x--  21A 1 x--  211 1 -y-  21B 1 x-- }
843B:      { 217 1 x--  21C 1 x--  216 1 x--  21D 1 x-- }
843C:      { 21F 1 ---  218 1 ---  21E 1 ---  219 1 --- }
843D:      { 226 1 ---  230 1 ---  227 1 ---  231 1 --- }
843E:      { 228 1 ---  232 1 ---  229 1 ---  233 1 --- }
843F:      { 22A 1 ---  234 1 ---  22B 1 ---  235 1 --- }
8440:      { 22C 1 ---  236 1 ---  22D 1 ---  237 1 --- }
8441:      { 22E 1 ---  228 1 ---  22F 1 ---  229 1 --- }
8442:      { 229 1 x--  233 1 x--  228 1 x--  232 1 x-- }
8443:      { 219 1 x--  221 1 x--  218 1 x--  220 1 x-- }
8444:      { 237 1 x--  23F 1 x--  236 1 x--  240 1 x-- }
8445:      { 238 1 x--  241 1 x--  239 1 x--  242 1 x-- }
8446:      { 239 1 ---  242 1 ---  238 1 ---  241 1 --- }
8447:      { 23A 1 ---  23D 1 ---  23B 1 ---  23C 1 --- }
8448:      { 236 1 ---  240 1 ---  237 1 ---  23F 1 --- }
8449:      { 23C 1 x--  22F 1 x--  23D 1 x--  22E 1 x-- }
844A:      { 23E 1 ---  232 1 ---  22A 1 ---  234 1 --- }
844B:      { 228 1 -y-  22E 1 -y-  229 1 -y-  22F 1 -y- }
844C:      { 243 1 ---  239 1 ---  244 1 ---  238 1 --- }
844D:      { 22D 1 x--  237 1 x--  22C 1 x--  236 1 x-- }
844E:      { 23D 1 ---  22E 1 ---  23C 1 ---  22F 1 --- }
844F: ~
8450: ~
8451: ~
8452: ~
8453: ~
8454: ~
8455: ~
8456: ~
8457: ~
8458: ~
8459: ~
845A: ~
845B: ~
845C: ~
845D: ~
845E: ~
845F: ~
8460: ~
8461: ~
8462: ~
8463: ~
8464: ~
8465: ~
8466: ~
8467: ~
8468: ~
8469: ~
846A: ~
846B: ~
846C: ~
846D: ~
846E: ~
846F: ~
8470:      { 103 3 ---  103 3 ---  103 3 ---  103 3 --- }
8471:      { 103 3 ---  103 3 ---  103 3 ---  133 3 --- }
8472:      { 103 3 ---  134 3 ---  125 3 ---  135 3 --- }
8473:      { 126 3 ---  136 3 ---  127 3 ---  137 3 --- }
8474:      { 128 3 ---  138 3 ---  129 3 ---  139 3 --- }
8475:      { 12A 3 ---  13A 3 ---  12B 3 ---  13B 3 --- }
8476:      { 12C 3 ---  13C 3 ---  12D 3 ---  13D 3 --- }
8477:      { 12E 3 ---  13E 3 ---  103 3 ---  13F 3 --- }
8478:      { 102 3 ---  112 3 ---  103 3 ---  113 3 --- }
8479: ~
847A: ~
847B: ~
847C: ~
847D: ~
847E: ~
847F: ~
8480:      { 102 3 ---  150 3 ---  141 3 ---  151 3 --- }
8481:      { 142 3 ---  152 3 ---  109 3 ---  153 3 --- }
8482:      { 144 3 ---  154 3 ---  145 3 ---  155 3 --- }
8483:      { 146 3 ---  156 3 ---  147 3 ---  157 3 --- }
8484:      { 148 3 ---  158 3 ---  149 3 ---  159 3 --- }
8485:      { 14A 3 ---  15A 3 ---  14B 3 ---  15B 3 --- }
8486:      { 14C 3 ---  15C 3 ---  14D 3 ---  15D 3 --- }
8487:      { 14E 3 ---  15E 3 ---  14F 3 ---  15F 3 --- }
8488:      { 104 3 ---  114 3 ---  105 3 ---  115 3 --- }
8489: ~
848A: ~
848B: ~
848C: ~
848D: ~
848E: ~
848F: ~
8490:      { 160 3 ---  170 3 ---  161 3 ---  171 3 --- }
8491:      { 162 3 ---  172 3 ---  163 3 ---  173 3 --- }
8492:      { 164 3 ---  174 3 ---  165 3 ---  175 3 --- }
8493:      { 166 3 ---  176 3 ---  167 3 ---  177 3 --- }
8494:      { 168 3 ---  178 3 ---  169 3 ---  179 3 --- }
8495:      { 16A 3 ---  17A 3 ---  16B 3 ---  17B 3 --- }
8496:      { 16C 3 ---  17C 3 ---  16D 3 ---  17D 3 --- }
8497:      { 16E 3 ---  17E 3 ---  16F 3 ---  17F 3 --- }
8498:      { 100 3 ---  110 3 ---  101 3 ---  111 3 --- }
8499: ~
849A: ~
849B: ~
849C: ~
849D: ~
849E: ~
849F: ~
84A0:      { 120 3 ---  130 3 ---  121 3 ---  131 3 --- }
84A1:      { 122 3 ---  132 3 ---  123 3 ---  124 3 --- }
84A2:      { 10B 3 ---  11B 3 ---  10C 3 ---  11C 3 --- }
84A3:      { 10D 3 ---  11D 3 ---  10E 3 ---  11E 3 --- }
84A4:      { 147 3 x--  157 3 x--  146 3 x--  156 3 x-- }
84A5:      { 106 3 ---  116 3 ---  107 3 ---  117 3 --- }
84A6:      { 109 3 x--  153 3 x--  142 3 x--  152 3 x-- }
84A7:      { 141 3 x--  151 3 x--  102 3 x--  150 3 x-- }
84A8:      { 108 3 ---  118 3 ---  109 3 ---  119 3 --- }
84A9: ~
84AA: ~
84AB: ~
84AC: ~
84AD: ~
84AE: ~
84AF: ~
84B0: ~
84B1: ~
84B2: ~
84B3: ~
84B4:      { 167 3 x--  177 3 x--  166 3 x--  176 3 x-- }
84B5:      { 165 3 x--  175 3 x--  164 3 x--  174 3 x-- }
84B6:      { 163 3 x--  173 3 x--  162 3 x--  172 3 x-- }
84B7:      { 161 3 x--  171 3 x--  160 3 x--  170 3 x-- }
84B8:      { 10A 4 ---  11A 4 ---  10A 4 ---  11A 4 --- }
84B9: ~
84BA: ~
84BB: ~
84BC: ~
84BD: ~
84BE: ~
84BF: ~
84C0: ~
84C1: ~
84C2: ~
84C3: ~
84C4:      { 0F8 4 ---  203 4 ---  200 4 ---  204 4 --- }
84C5:      { 201 4 ---  205 4 ---  202 4 ---  206 4 --- }
84C6:      { 0F8 4 ---  207 4 ---  0F8 4 ---  208 4 --- }
84C7:      { 0F8 4 ---  209 4 ---  0F8 4 ---  20A 4 --- }
84C8:      { 12F 4 ---  21C 4 x--  20E 4 x--  21B 4 x-- }
84C9:      { 0F8 4 x--  21A 4 x--  0F8 4 x--  219 4 x-- }
84CA:      { 0F8 4 x--  218 4 x--  20D 4 x--  217 4 x-- }
84CB:      { 20C 4 x--  216 4 x--  20B 4 x--  215 4 x-- }
84CC:      { 12F 4 x--  214 4 x--  0F8 4 x--  0F8 4 x-- }
84CD: ~
84CE: ~
84CF: ~
84D0:      { 0F8 4 ---  0F8 4 ---  12F 4 ---  214 4 --- }
84D1:      { 20B 4 ---  215 4 ---  20C 4 ---  216 4 --- }
84D2:      { 20D 4 ---  217 4 ---  0F8 4 ---  218 4 --- }
84D3:      { 0F8 4 ---  219 4 ---  0F8 4 ---  21A 4 --- }
84D4:      { 20E 4 ---  21B 4 ---  12F 4 x--  21C 4 --- }
84D5:      { 20F 4 ---  21D 4 ---  210 4 ---  21E 4 --- }
84D6:      { 211 4 ---  21F 4 ---  212 4 ---  220 4 --- }
84D7:      { 213 4 ---  221 4 ---  0F8 4 ---  222 4 --- }
84D8:      { 22C 4 x--  23B 4 x--  22B 4 x--  23A 4 x-- }
84D9:      { 22A 4 x--  239 4 x--  229 4 x--  238 4 x-- }
84DA:      { 228 4 x--  237 4 x--  227 4 x--  236 4 x-- }
84DB:      { 226 4 x--  235 4 x--  225 4 x--  234 4 x-- }
84DC:      { 224 4 x--  233 4 x--  223 4 x--  232 4 x-- }
84DD: ~
84DE: ~
84DF: ~
84E0:      { 223 4 ---  232 4 ---  224 4 ---  233 4 --- }
84E1:      { 225 4 ---  234 4 ---  226 4 ---  235 4 --- }
84E2:      { 227 4 ---  236 4 ---  228 4 ---  237 4 --- }
84E3:      { 229 4 ---  238 4 ---  22A 4 ---  239 4 --- }
84E4:      { 22B 4 ---  23A 4 ---  22C 4 ---  23B 4 --- }
84E5:      { 22D 4 ---  23C 4 ---  22E 4 ---  23D 4 --- }
84E6:      { 22F 4 ---  23E 4 ---  230 4 ---  23F 4 --- }
84E7:      { 231 4 ---  240 4 ---  12F 4 x--  241 4 --- }
84E8:      { 0F8 4 x--  222 4 x--  213 4 x--  221 4 x-- }
84E9:      { 212 4 x--  220 4 x--  211 4 x--  21F 4 x-- }
84EA:      { 210 4 x--  21E 4 x--  20F 4 x--  21D 4 x-- }
84EB: ~
84EC: ~
84ED: ~
84EE: ~
84EF: ~
84F0:      { 242 4 ---  0F8 4 ---  243 4 ---  0F8 4 --- }
84F1:      { 244 4 ---  0F8 4 ---  245 4 ---  24C 4 --- }
84F2:      { 246 4 ---  24D 4 ---  247 4 ---  24E 4 --- }
84F3:      { 248 4 ---  24F 4 ---  249 4 ---  250 4 --- }
84F4:      { 24A 4 ---  251 4 ---  24B 4 ---  252 4 --- }
84F5:      { 24B 4 x--  252 4 x--  24A 4 x--  251 4 x-- }
84F6:      { 249 4 x--  250 4 x--  248 4 x--  24F 4 x-- }
84F7:      { 247 4 x--  24E 4 x--  246 4 x--  24D 4 x-- }
84F8:      { 12F 4 ---  241 4 x--  231 4 x--  240 4 x-- }
84F9:      { 230 4 x--  23F 4 x--  22F 4 x--  23E 4 x-- }
84FA:      { 22E 4 x--  23D 4 x--  22D 4 x--  23C 4 x-- }
84FB:      { 0F9 0 x--  108 0 ---  108 0 ---  102 0 --- }
84FC: ~
84FD: ~
84FE: ~
84FF: ~
