9600:      { 0F8 0 ---  100 3 ---  100 3 ---  109 3 --- }
9601:      { 101 3 ---  10A 3 ---  0F8 0 ---  10B 3 --- }
9602:      { 0F8 0 ---  10C 3 ---  0F8 0 ---  10D 3 --- }
9603:      { 0F8 0 ---  100 3 ---  0F8 0 ---  10E 3 --- }
9604:      { 0F8 0 ---  10F 3 ---  0F8 0 ---  110 3 --- }
9605:      { 102 3 ---  111 3 ---  103 3 ---  112 3 --- }
9606:      { 0F8 0 ---  113 3 ---  0F8 0 ---  102 3 --- }
9607:      { 0F8 0 ---  114 3 ---  0F8 0 ---  115 3 --- }
9608:      { 104 3 ---  116 3 ---  105 3 ---  117 3 --- }
9609:      { 106 3 ---  118 3 ---  107 3 ---  119 3 --- }
960A:      { 0F8 0 ---  11A 3 ---  108 3 ---  11B 3 --- }
960B:      { 0F8 0 ---  11C 3 ---  0F8 0 ---  11D 3 --- }
960C:      { 0F8 0 ---  11E 3 ---  0F8 0 ---  0F8 0 --- }
960D:      { 11F 3 ---  13C 3 ---  120 3 ---  13D 3 --- }
960E:      { 121 3 ---  13E 3 ---  122 3 ---  13F 3 --- }
960F:      { 123 3 ---  140 3 ---  124 3 ---  141 3 --- }
9610:      { 125 3 ---  142 3 ---  126 3 ---  143 3 --- }
9611:      { 127 3 ---  144 3 ---  128 3 ---  145 3 --- }
9612:      { 129 3 ---  146 3 ---  12A 3 ---  147 3 --- }
9613:      { 12B 3 ---  148 3 ---  12C 3 ---  149 3 --- }
9614:      { 12D 3 ---  14A 3 ---  12E 3 ---  14B 3 --- }
9615:      { 12F 3 ---  14C 3 ---  130 3 ---  14D 3 --- }
9616:      { 131 3 ---  14E 3 ---  132 3 ---  14F 3 --- }
9617:      { 133 3 ---  150 3 ---  134 3 ---  151 3 --- }
9618:      { 135 3 ---  152 3 ---  136 3 ---  153 3 --- }
9619:      { 137 3 ---  154 3 ---  138 3 ---  155 3 --- }
961A:      { 139 3 ---  156 3 ---  13A 3 ---  157 3 --- }
961B:      { 13B 3 ---  158 3 ---  126 3 ---  143 3 --- }
961C:      { 159 0 ---  16F 0 ---  15A 0 ---  170 0 --- }
961D:      { 15B 3 ---  171 0 ---  15C 3 ---  172 0 --- }
961E:      { 15D 3 ---  173 0 ---  15E 3 ---  174 0 --- }
961F:      { 15F 0 ---  175 0 ---  160 0 ---  176 0 --- }
9620:      { 161 3 ---  177 0 ---  162 0 ---  178 0 --- }
9621:      { 163 0 ---  179 0 ---  164 3 ---  17A 0 --- }
9622:      { 165 3 ---  17B 0 ---  166 3 ---  17C 0 --- }
9623:      { 167 3 ---  17D 0 ---  168 3 ---  17E 0 --- }
9624:      { 169 3 ---  17F 0 ---  16A 3 ---  200 0 --- }
9625:      { 16B 0 ---  201 0 ---  16C 0 ---  202 0 --- }
9626:      { 16D 3 ---  203 0 ---  16E 0 ---  204 0 --- }
9627:      { 205 0 ---  21D 0 ---  206 0 ---  21E 0 --- }
9628:      { 207 0 ---  21F 0 ---  208 0 ---  220 0 --- }
9629:      { 209 0 ---  221 0 ---  20A 0 ---  222 0 --- }
962A:      { 20B 0 ---  223 0 ---  20C 0 ---  224 0 --- }
962B:      { 20D 0 ---  225 0 ---  20E 0 ---  226 0 --- }
962C:      { 20F 0 ---  227 0 ---  210 0 ---  228 0 --- }
962D:      { 211 0 ---  229 0 ---  212 0 ---  22A 0 --- }
962E:      { 213 0 ---  22B 0 ---  214 3 ---  22C 0 --- }
962F:      { 215 0 ---  22D 3 ---  216 3 ---  22E 0 --- }
9630:      { 217 0 ---  22F 0 ---  218 0 ---  230 0 --- }
9631:      { 219 0 ---  231 0 ---  20A 0 ---  232 0 --- }
9632:      { 20B 0 ---  233 0 ---  21A 0 ---  234 0 --- }
9633:      { 21B 0 ---  235 0 ---  20E 0 ---  236 0 --- }
9634:      { 213 0 ---  237 0 ---  21C 0 ---  238 0 --- }
9635:      { 239 3 ---  255 0 ---  23A 0 ---  256 0 --- }
9636:      { 23B 0 ---  257 0 ---  23C 0 ---  258 0 --- }
9637:      { 23D 0 ---  259 0 ---  23E 0 ---  25A 0 --- }
9638:      { 23F 0 ---  25B 0 ---  240 0 ---  25C 3 --- }
9639:      { 241 0 ---  25D 0 ---  242 0 ---  25E 0 --- }
963A:      { 243 0 ---  25F 0 ---  244 0 ---  260 0 --- }
963B:      { 245 0 ---  261 0 ---  246 0 ---  262 0 --- }
963C:      { 247 3 ---  263 0 ---  248 3 ---  264 0 --- }
963D:      { 249 0 ---  265 0 ---  24A 0 ---  266 0 --- }
963E:      { 24B 0 ---  267 0 ---  24C 0 ---  268 0 --- }
963F:      { 24D 0 ---  269 0 ---  24E 0 ---  26A 0 --- }
9640:      { 24F 0 ---  26B 0 ---  250 0 ---  26C 0 --- }
9641:      { 251 0 ---  26D 0 ---  252 0 ---  26E 0 --- }
9642:      { 253 0 ---  26F 0 ---  254 0 ---  264 0 --- }
9643:      { 270 0 ---  27C 0 ---  271 0 ---  27D 0 --- }
9644:      { 272 0 ---  27E 0 ---  273 0 ---  27F 0 --- }
9645:      { 274 0 ---  280 0 ---  275 0 ---  281 0 --- }
9646:      { 276 0 ---  282 0 ---  277 0 ---  283 0 --- }
9647:      { 278 0 ---  284 0 ---  279 0 ---  285 0 --- }
9648:      { 27A 0 ---  286 0 ---  27B 0 ---  287 0 --- }
9649:      { 27B 0 x--  287 0 x--  27A 0 x--  286 0 x-- }
964A:      { 279 0 x--  285 0 x--  278 0 x--  284 0 x-- }
964B:      { 277 0 x--  283 0 x--  276 0 x--  282 0 x-- }
964C:      { 275 0 x--  281 0 x--  274 0 x--  280 0 x-- }
964D:      { 273 0 x--  27F 0 x--  272 0 x--  27E 0 x-- }
964E:      { 288 0 ---  294 0 ---  289 0 ---  295 0 --- }
964F:      { 28A 0 ---  296 0 ---  28B 0 ---  297 0 --- }
9650:      { 28C 0 ---  298 0 ---  28D 0 ---  299 0 --- }
9651:      { 28E 0 ---  29A 0 ---  28F 0 ---  29B 0 --- }
9652:      { 290 0 ---  29C 0 ---  291 0 ---  29D 0 --- }
9653:      { 292 0 ---  29E 0 ---  293 0 ---  29F 0 --- }
9654:      { 293 0 x--  29F 0 x--  292 0 x--  29E 0 x-- }
9655:      { 291 0 x--  29D 0 x--  290 0 x--  29C 0 x-- }
9656:      { 28F 0 x--  29B 0 x--  28E 0 x--  29A 0 x-- }
9657:      { 28D 0 x--  299 0 x--  28C 0 x--  298 0 x-- }
9658:      { 28B 0 x--  297 0 x--  28A 0 x--  296 0 x-- }
9659:      { 2C6 3 ---  2DF 3 ---  2C7 3 ---  2E0 3 --- }
965A: ~
965B: ~
965C: ~
965D: ~
965E: ~
965F: ~
9660: ~
9661: ~
9662: ~
9663: ~
9664: ~
9665: ~
9666: ~
9667: ~
9668: ~
9669: ~
966A: ~
966B: ~
966C: ~
966D: ~
966E: ~
966F: ~
9670: ~
9671: ~
9672: ~
9673: ~
9674: ~
9675: ~
9676: ~
9677: ~
9678: ~
9679: ~
967A: ~
967B: ~
967C: ~
967D: ~
967E: ~
967F: ~
9680: ~
9681: ~
9682: ~
9683: ~
9684: ~
9685: ~
9686: ~
9687: ~
9688: ~
9689: ~
968A: ~
968B: ~
968C: ~
968D: ~
968E: ~
968F: ~
9690: ~
9691: ~
9692: ~
9693: ~
9694: ~
9695: ~
9696: ~
9697: ~
9698: ~
9699: ~
969A: ~
969B: ~
969C: ~
969D: ~
969E: ~
969F: ~
96A0: ~
96A1: ~
96A2: ~
96A3: ~
96A4: ~
96A5: ~
96A6: ~
96A7: ~
96A8: ~
96A9: ~
96AA: ~
96AB: ~
96AC: ~
96AD: ~
96AE: ~
96AF: ~
96B0: ~
96B1: ~
96B2: ~
96B3: ~
96B4: ~
96B5: ~
96B6: ~
96B7: ~
96B8: ~
96B9: ~
96BA: ~
96BB: ~
96BC: ~
96BD: ~
96BE: ~
96BF: ~
96C0: ~
96C1: ~
96C2: ~
96C3: ~
96C4: ~
96C5: ~
96C6: ~
96C7: ~
96C8: ~
96C9: ~
96CA: ~
96CB: ~
96CC: ~
96CD: ~
96CE: ~
96CF: ~
96D0: ~
96D1: ~
96D2: ~
96D3: ~
96D4: ~
96D5: ~
96D6: ~
96D7: ~
96D8: ~
96D9: ~
96DA: ~
96DB: ~
96DC: ~
96DD: ~
96DE: ~
96DF: ~
96E0: ~
96E1: ~
96E2: ~
96E3: ~
96E4: ~
96E5: ~
96E6: ~
96E7: ~
96E8: ~
96E9: ~
96EA: ~
96EB: ~
96EC: ~
96ED: ~
96EE: ~
96EF: ~
96F0: ~
96F1: ~
96F2: ~
96F3: ~
96F4: ~
96F5: ~
96F6: ~
96F7: ~
96F8: ~
96F9: ~
96FA: ~
96FB: ~
96FC: ~
96FD: ~
96FE: ~
96FF: ~
