8200:      { 10A 3 ---  11A 3 ---  10B 3 ---  11B 3 --- }
8201:      { 100 3 ---  110 3 ---  101 3 ---  111 3 --- }
8202:      { 108 3 ---  118 3 ---  109 3 ---  119 3 --- }
8203:      { 10C 3 ---  11C 3 ---  10D 3 ---  11D 3 --- }
8204:      { 114 3 ---  124 3 ---  115 3 ---  125 3 --- }
8205:      { 112 3 ---  102 3 ---  113 3 ---  103 3 --- }
8206:      { 116 3 ---  0FA 3 ---  117 3 ---  107 3 --- }
8207:      { 112 3 ---  122 3 ---  113 3 ---  123 3 --- }
8208:      { 116 3 ---  126 3 ---  117 3 ---  127 3 --- }
8209:      { 114 3 ---  132 3 ---  115 3 ---  133 3 --- }
820A:      { 112 3 ---  132 3 ---  113 3 ---  133 3 --- }
820B:      { 116 3 ---  132 3 ---  117 3 ---  133 3 --- }
820C:      { 134 3 ---  136 3 ---  135 3 ---  137 3 --- }
820D:      { 134 3 ---  130 3 ---  135 3 ---  131 3 --- }
820E:      { 14C 3 ---  15C 3 ---  14D 3 ---  15D 3 --- }
820F:      { 14E 3 ---  15E 3 ---  14F 3 ---  15F 3 --- }
8210:      { 166 1 ---  168 1 ---  167 1 ---  169 1 --- }
8211:      { 158 1 ---  168 1 ---  159 1 ---  169 1 --- }
8212:      { 0E1 0 ---  0F1 0 ---  0E2 0 ---  0F2 0 --- }
8213:      { 0E3 0 ---  0F3 0 ---  0E4 0 ---  0F4 0 --- }
8214:      { 0F1 0 -y-  0E1 0 -y-  0F2 0 -y-  0E2 0 -y- }
8215:      { 0F3 0 -y-  0E3 0 -y-  0F4 0 -y-  0E4 0 -y- }
8216:      { 0E5 0 ---  0E5 0 -y-  0E6 0 ---  0E6 0 -y- }
8217:      { 0C0 0 ---  0C0 0 ---  0F8 0 ---  0F8 0 --- }
8218:      { 0F8 0 -y-  0F8 0 -y-  0C1 0 -y-  0C1 0 -y- }
8219: ~
821A: ~
821B: ~
821C: ~
821D: ~
821E: ~
821F: ~
8220: ~
8221: ~
8222: ~
8223: ~
8224: ~
8225: ~
8226: ~
8227: ~
8228: ~
8229: ~
822A: ~
822B: ~
822C: ~
822D: ~
822E: ~
822F: ~
8230: ~
8231: ~
8232: ~
8233: ~
8234: ~
8235: ~
8236: ~
8237: ~
8238: ~
8239: ~
823A: ~
823B: ~
823C: ~
823D: ~
823E: ~
823F: ~
8240: ~
8241: ~
8242: ~
8243: ~
8244: ~
8245: ~
8246: ~
8247: ~
8248: ~
8249: ~
824A: ~
824B: ~
824C: ~
824D: ~
824E: ~
824F: ~
8250: ~
8251: ~
8252: ~
8253: ~
8254: ~
8255: ~
8256: ~
8257: ~
8258: ~
8259: ~
825A: ~
825B: ~
825C: ~
825D: ~
825E: ~
825F: ~
8260: ~
8261: ~
8262: ~
8263: ~
8264: ~
8265: ~
8266: ~
8267: ~
8268: ~
8269: ~
826A: ~
826B: ~
826C: ~
826D: ~
826E: ~
826F: ~
8270: ~
8271: ~
8272: ~
8273: ~
8274: ~
8275: ~
8276: ~
8277: ~
8278: ~
8279: ~
827A: ~
827B: ~
827C: ~
827D: ~
827E: ~
827F: ~
8280: ~
8281: ~
8282: ~
8283: ~
8284: ~
8285: ~
8286: ~
8287: ~
8288: ~
8289: ~
828A: ~
828B: ~
828C: ~
828D: ~
828E: ~
828F: ~
8290: ~
8291: ~
8292: ~
8293: ~
8294: ~
8295: ~
8296: ~
8297: ~
8298: ~
8299: ~
829A: ~
829B: ~
829C: ~
829D: ~
829E: ~
829F: ~
82A0: ~
82A1: ~
82A2: ~
82A3: ~
82A4: ~
82A5: ~
82A6:      { 101 3 x--  104 3 x--  102 3 x--  103 3 x-- }
82A7:      { 102 3 ---  103 3 ---  101 3 ---  104 3 --- }
82A8:      { 102 3 ---  102 3 ---  102 3 ---  102 3 --- }
82A9:      { 103 3 -y-  102 3 -y-  104 3 -y-  101 3 -y- }
82AA:      { 100 3 ---  105 3 ---  105 3 ---  106 3 --- }
82AB:      { 105 3 x--  106 3 x--  100 3 x--  105 3 x-- }
82AC:      { 104 3 xy-  101 3 xy-  103 3 xy-  102 3 xy- }
82AD:      { 106 3 ---  106 3 ---  106 3 ---  106 3 --- }
82AE:      { 106 3 ---  107 3 ---  107 3 ---  108 3 --- }
82AF:      { 107 3 x--  108 3 x--  106 3 x--  107 3 x-- }
82B0:      { 108 3 ---  108 3 ---  108 3 ---  108 3 --- }
82B1:      { 108 3 ---  10F 3 x--  109 3 x--  110 3 --- }
82B2:      { 10A 3 ---  111 3 ---  10B 3 ---  111 3 --- }
82B3:      { 10C 3 ---  112 3 ---  10D 3 ---  113 3 --- }
82B4:      { 10E 3 ---  114 3 ---  108 3 ---  108 3 --- }
82B5:      { 115 3 x--  108 3 ---  116 3 x--  108 3 --- }
82B6:      { 117 3 x--  11C 3 ---  118 3 x--  11D 3 --- }
82B7:      { 119 3 ---  11E 3 ---  11A 3 ---  108 3 --- }
82B8:      { 11B 3 ---  108 3 ---  108 3 ---  108 3 --- }
82B9:      { 108 3 ---  125 3 ---  108 3 ---  126 3 --- }
82BA:      { 11F 3 ---  127 3 ---  120 3 ---  128 3 --- }
82BB:      { 121 3 ---  129 3 ---  122 3 ---  12A 3 --- }
82BC:      { 122 3 x--  12A 3 x--  121 3 x--  129 3 x-- }
82BD:      { 120 3 x--  128 3 x--  11F 3 x--  12B 3 --- }
82BE:      { 123 3 ---  110 3 ---  10A 3 ---  111 3 --- }
82BF:      { 10B 3 ---  12C 3 ---  124 3 ---  12D 3 --- }
82C0:      { 120 3 x--  128 3 x--  11F 3 x--  127 3 x-- }
82C1:      { 108 3 ---  126 3 x--  108 3 ---  126 3 --- }
82C2:      { 108 3 x--  126 3 x--  108 3 x--  125 3 x-- }
82C3:      { 108 3 ---  108 3 ---  125 3 ---  13A 3 --- }
82C4:      { 12E 3 ---  13B 3 ---  12F 3 ---  13C 3 --- }
82C5:      { 130 3 ---  13D 3 ---  131 3 ---  108 3 --- }
82C6:      { 132 3 ---  108 3 ---  108 3 ---  108 3 --- }
82C7:      { 108 3 x--  108 3 ---  132 3 x--  108 3 x-- }
82C8:      { 131 3 x--  108 3 x--  133 3 ---  13D 3 x-- }
82C9:      { 134 3 ---  13C 3 x--  135 3 ---  13E 3 --- }
82CA:      { 136 3 ---  13F 3 ---  137 3 ---  140 3 --- }
82CB:      { 131 3 x--  108 3 x--  138 3 ---  13A 3 --- }
82CC:      { 139 3 ---  13B 3 ---  12F 3 ---  141 3 --- }
82CD:      { 130 3 ---  13A 3 x--  131 3 ---  108 3 --- }
82CE:      { 131 3 x--  108 3 x--  130 3 x--  13D 3 x-- }
82CF:      { 12F 3 x--  13C 3 x--  12E 3 x--  13B 3 x-- }
82D0:      { 125 3 x--  13A 3 x--  108 3 x--  108 3 x-- }
82D1:      { 142 3 -y-  149 3 -y-  143 3 -y-  100 3 --- }
82D2:      { 143 3 xy-  100 3 x--  142 3 xy-  149 3 xy- }
82D3:      { 144 3 ---  14A 3 ---  145 3 ---  14B 3 --- }
82D4:      { 146 3 ---  14C 3 ---  108 3 ---  108 3 --- }
82D5:      { 108 3 x--  108 3 x--  146 3 x--  14C 3 x-- }
82D6:      { 145 3 x--  14B 3 x--  144 3 x--  14A 3 x-- }
82D7:      { 108 3 ---  108 3 ---  108 3 ---  14D 3 -y- }
82D8:      { 147 3 ---  100 3 x--  148 3 ---  100 3 x-- }
82D9:      { 146 3 ---  14C 3 ---  146 3 x--  14C 3 x-- }
82DA:      { 14E 3 -y-  152 3 -y-  14F 3 -y-  100 3 --- }
82DB:      { 108 3 ---  14D 3 -y-  108 3 ---  14D 3 xy- }
82DC:      { 150 3 ---  153 3 ---  151 3 ---  154 3 --- }
82DD:      { 108 3 ---  155 3 ---  108 3 ---  14D 3 -y- }
82DE:      { 100 3 ---  100 3 ---  14D 3 xy-  100 3 --- }
82DF:      { 108 3 ---  14D 3 xy-  108 3 x--  155 3 x-- }
82E0:      { 151 3 x--  154 3 x--  150 3 x--  153 3 x-- }
82E1:      { 14D 3 -y-  100 3 ---  100 3 x--  100 3 x-- }
82E2:      { 108 3 ---  155 3 ---  108 3 x--  155 3 x-- }
82E3:      { 108 3 ---  147 3 ---  108 3 ---  148 3 --- }
82E4:      { 156 3 ---  16A 3 ---  157 3 ---  16B 3 --- }
82E5:      { 158 3 ---  16C 3 ---  159 3 ---  16D 3 --- }
82E6:      { 15A 3 ---  16E 3 ---  15B 3 ---  16F 3 --- }
82E7:      { 15C 3 ---  111 3 ---  15D 3 ---  170 3 --- }
82E8:      { 15E 3 ---  171 3 ---  15F 3 ---  12C 3 --- }
82E9:      { 160 3 ---  16A 3 ---  161 3 ---  16B 3 --- }
82EA:      { 162 3 ---  12D 3 ---  163 3 ---  112 3 --- }
82EB:      { 164 3 ---  113 3 ---  165 3 ---  114 3 --- }
82EC:      { 100 3 ---  172 3 ---  166 3 ---  110 3 --- }
82ED:      { 161 3 x--  171 3 ---  160 3 x--  12C 3 --- }
82EE:      { 167 3 ---  113 3 ---  168 3 ---  173 3 --- }
82EF:      { 100 3 ---  174 3 -y-  169 3 -y-  175 3 -y- }
82F0:      { 176 3 ---  204 3 ---  177 3 ---  205 3 --- }
82F1:      { 178 3 ---  206 3 ---  179 3 ---  207 3 --- }
82F2:      { 17A 3 ---  208 3 ---  17B 3 ---  289 3 --- }
82F3:      { 17C 3 ---  28A 3 ---  17D 3 ---  28B 3 --- }
82F4:      { 17E 3 ---  28C 3 ---  17F 3 ---  28D 3 --- }
82F5:      { 118 3 ---  28E 3 ---  117 3 ---  28F 3 --- }
82F6:      { 280 3 ---  100 3 ---  281 3 ---  100 3 --- }
82F7:      { 282 3 ---  100 3 ---  283 3 ---  100 3 --- }
82F8:      { 290 3 ---  100 3 ---  291 3 ---  100 3 --- }
82F9:      { 292 3 ---  100 3 ---  293 3 ---  100 3 --- }
82FA:      { 294 3 ---  100 3 ---  295 3 ---  100 3 --- }
82FB:      { 174 3 ---  100 3 ---  152 3 ---  14E 3 --- }
82FC:      { 100 3 ---  14F 3 ---  100 3 ---  100 3 --- }
82FD:      { 100 3 ---  100 3 ---  100 3 ---  174 3 -y- }
82FE:      { 296 3 -y-  100 3 ---  100 3 ---  100 3 --- }
82FF:      { 100 3 ---  100 3 ---  100 3 ---  100 3 --- }
