9200:      { 200 0 ---  20E 0 ---  201 0 ---  20E 0 --- }
9201:      { 202 0 ---  20F 0 ---  203 0 ---  210 0 --- }
9202:      { 204 0 ---  211 0 ---  205 0 ---  212 0 --- }
9203:      { 206 0 ---  213 0 ---  207 0 ---  214 0 --- }
9204:      { 208 0 ---  215 0 ---  209 0 ---  216 0 --- }
9205:      { 20A 0 ---  217 0 ---  20B 0 ---  218 0 --- }
9206:      { 20C 0 ---  219 0 ---  20D 0 ---  21A 0 --- }
9207:      { 20E 0 ---  21B 0 ---  20E 0 ---  21C 0 --- }
9208:      { 20E 0 ---  20E 0 ---  20E 0 ---  20E 0 --- }
9209:      { 20E 0 ---  21D 0 ---  20E 0 ---  21E 0 --- }
920A:      { 20E 0 ---  21F 0 ---  20E 0 ---  220 0 --- }
920B:      { 20E 0 ---  221 0 ---  20E 0 ---  222 0 --- }
920C:      { 20E 0 ---  223 0 ---  20E 0 ---  20E 0 --- }
920D:      { 224 0 ---  20E 0 ---  225 0 ---  20E 0 --- }
920E:      { 226 0 ---  20E 0 ---  227 0 ---  20E 0 --- }
920F:      { 228 0 ---  20E 0 ---  229 0 ---  20E 0 --- }
9210:      { 22A 0 ---  20E 0 ---  22B 0 ---  20E 0 --- }
9211:      { 22C 0 ---  20E 0 ---  20E 0 ---  20E 0 --- }
9212:      { 200 0 -y-  20E 0 ---  22D 0 ---  20E 0 --- }
9213:      { 22E 0 ---  20E 0 ---  22F 0 ---  20E 0 --- }
9214:      { 230 0 ---  20E 0 ---  231 0 ---  20E 0 --- }
9215:      { 232 0 ---  20E 0 ---  233 0 ---  20E 0 --- }
9216:      { 234 0 ---  20E 0 ---  235 0 ---  20E 0 --- }
9217:      { 236 0 ---  20E 0 ---  237 0 ---  20E 0 --- }
9218:      { 238 0 ---  20E 0 ---  239 0 ---  20E 0 --- }
9219:      { 23A 0 x--  20E 0 ---  23B 0 x--  20E 0 --- }
921A:      { 23B 0 ---  20E 0 ---  23A 0 ---  20E 0 --- }
921B:      { 23C 0 ---  20E 0 ---  23D 0 ---  20E 0 --- }
921C:      { 23E 0 x--  20E 0 ---  236 0 ---  20E 0 --- }
921D:      { 23F 0 x--  20E 0 ---  23E 0 ---  20E 0 --- }
921E:      { 23D 0 x--  20E 0 ---  23C 0 x--  20E 0 --- }
921F:      { 240 0 ---  244 0 ---  241 0 ---  245 0 --- }
9220:      { 242 0 ---  246 0 ---  243 0 ---  247 0 --- }
9221:      { 20E 0 ---  248 0 ---  20E 0 ---  249 0 --- }
9222:      { 20E 0 ---  23A 0 x--  20E 0 ---  23B 0 x-- }
9223:      { 20E 0 ---  23F 0 ---  20E 0 ---  20E 0 --- }
9224:      { 20E 0 ---  23E 0 ---  20E 0 ---  23D 0 x-- }
9225:      { 20E 0 ---  23F 0 ---  20E 0 ---  24A 0 --- }
9226:      { 24B 0 ---  260 0 ---  24C 0 ---  261 0 --- }
9227:      { 24D 0 ---  262 0 ---  24E 0 ---  263 0 --- }
9228:      { 24F 0 ---  264 0 ---  250 0 ---  265 0 --- }
9229:      { 251 0 ---  266 0 ---  252 0 ---  267 0 --- }
922A:      { 253 0 ---  268 0 ---  254 0 ---  269 0 --- }
922B:      { 255 0 ---  26A 0 ---  252 0 ---  26B 0 --- }
922C:      { 256 0 ---  26C 0 ---  257 0 ---  26D 0 --- }
922D:      { 258 0 ---  26E 0 ---  259 0 ---  26F 0 --- }
922E:      { 25A 0 ---  270 0 ---  25B 0 ---  271 0 --- }
922F:      { 25C 0 ---  272 0 ---  25D 0 ---  273 0 --- }
9230:      { 25E 0 ---  274 0 ---  25F 0 ---  275 0 --- }
9231:      { 276 0 ---  281 0 ---  277 0 ---  282 0 --- }
9232:      { 278 0 ---  283 0 ---  279 0 ---  284 0 --- }
9233:      { 264 0 ---  285 0 ---  27A 0 ---  286 0 --- }
9234:      { 27B 0 ---  285 0 ---  27C 0 ---  286 0 --- }
9235:      { 24F 0 ---  264 0 ---  250 0 ---  27A 0 --- }
9236:      { 264 0 ---  264 0 ---  27A 0 ---  27D 0 --- }
9237:      { 27D 0 ---  27D 0 ---  27D 0 ---  27D 0 --- }
9238:      { 27D 0 ---  287 0 ---  27E 0 ---  288 0 --- }
9239:      { 27F 0 ---  289 0 ---  280 0 ---  28A 0 --- }
923A:      { 28B 0 ---  28E 0 ---  28C 0 ---  28F 0 --- }
923B:      { 28D 0 ---  290 0 ---  27D 0 ---  27D 0 --- }
923C:      { 264 0 ---  27D 0 ---  280 0 ---  28A 0 --- }
923D: ~
923E: ~
923F: ~
9240: ~
9241: ~
9242: ~
9243: ~
9244: ~
9245: ~
9246: ~
9247: ~
9248: ~
9249: ~
924A: ~
924B: ~
924C: ~
924D: ~
924E: ~
924F: ~
9250: ~
9251: ~
9252: ~
9253: ~
9254: ~
9255: ~
9256: ~
9257: ~
9258: ~
9259: ~
925A: ~
925B: ~
925C: ~
925D: ~
925E: ~
925F: ~
9260: ~
9261: ~
9262: ~
9263: ~
9264: ~
9265: ~
9266: ~
9267: ~
9268: ~
9269: ~
926A: ~
926B: ~
926C: ~
926D: ~
926E: ~
926F: ~
9270: ~
9271: ~
9272: ~
9273: ~
9274: ~
9275: ~
9276: ~
9277: ~
9278: ~
9279: ~
927A: ~
927B: ~
927C: ~
927D: ~
927E: ~
927F: ~
9280: ~
9281: ~
9282: ~
9283: ~
9284: ~
9285: ~
9286: ~
9287: ~
9288: ~
9289: ~
928A: ~
928B: ~
928C: ~
928D: ~
928E: ~
928F: ~
9290: ~
9291: ~
9292: ~
9293: ~
9294: ~
9295: ~
9296: ~
9297: ~
9298: ~
9299: ~
929A: ~
929B: ~
929C: ~
929D: ~
929E: ~
929F: ~
92A0: ~
92A1: ~
92A2: ~
92A3: ~
92A4: ~
92A5: ~
92A6: ~
92A7: ~
92A8: ~
92A9: ~
92AA: ~
92AB: ~
92AC: ~
92AD: ~
92AE: ~
92AF: ~
92B0: ~
92B1: ~
92B2: ~
92B3: ~
92B4: ~
92B5: ~
92B6: ~
92B7: ~
92B8: ~
92B9: ~
92BA: ~
92BB: ~
92BC: ~
92BD: ~
92BE: ~
92BF: ~
92C0: ~
92C1: ~
92C2: ~
92C3: ~
92C4: ~
92C5: ~
92C6: ~
92C7: ~
92C8: ~
92C9: ~
92CA: ~
92CB: ~
92CC: ~
92CD: ~
92CE: ~
92CF: ~
92D0: ~
92D1: ~
92D2: ~
92D3: ~
92D4: ~
92D5: ~
92D6: ~
92D7: ~
92D8: ~
92D9: ~
92DA: ~
92DB: ~
92DC: ~
92DD: ~
92DE: ~
92DF: ~
92E0: ~
92E1: ~
92E2: ~
92E3: ~
92E4: ~
92E5: ~
92E6: ~
92E7: ~
92E8: ~
92E9: ~
92EA: ~
92EB: ~
92EC: ~
92ED: ~
92EE: ~
92EF: ~
92F0: ~
92F1: ~
92F2: ~
92F3: ~
92F4: ~
92F5: ~
92F6: ~
92F7: ~
92F8: ~
92F9: ~
92FA: ~
92FB: ~
92FC: ~
92FD: ~
92FE: ~
92FF: ~
