8600:      { 0F8 4 ---  0F8 4 ---  0F8 4 ---  0F8 4 --- }
8601:      { 0F8 3 ---  0F8 3 ---  101 3 ---  0F8 3 --- }
8602:      { 0F8 3 ---  0F8 3 ---  0F8 3 ---  103 3 --- }
8603:      { 102 3 ---  0F8 3 ---  0F8 3 ---  0F8 3 --- }
8604:      { 102 3 -y-  0F8 3 ---  0F8 3 ---  0F8 3 --- }
8605:      { 101 3 ---  0F8 3 ---  0F8 3 ---  0F8 3 --- }
8606:      { 0F8 3 ---  0F8 3 ---  102 3 ---  0F8 3 --- }
8607:      { 0F8 3 ---  0F8 3 ---  0F8 3 ---  103 3 x-- }
8608:      { 101 3 xy-  0F8 3 ---  0F8 3 ---  0F8 3 --- }
8609:      { 0F8 3 ---  104 3 ---  0F8 3 ---  105 3 --- }
860A:      { 0F8 3 ---  106 3 ---  0F8 3 ---  107 3 --- }
860B:      { 0F8 3 ---  105 3 x--  0F8 3 ---  104 3 x-- }
860C:      { 108 3 ---  110 3 ---  109 3 ---  111 3 --- }
860D:      { 10A 3 ---  112 3 ---  10B 3 ---  113 3 --- }
860E:      { 10C 3 ---  114 3 ---  10D 3 ---  115 3 --- }
860F:      { 10E 3 ---  116 3 ---  10F 3 ---  117 3 --- }
8610:      { 10D 3 x--  115 3 x--  10C 3 x--  114 3 x-- }
8611:      { 10B 3 x--  113 3 x--  10A 3 x--  112 3 x-- }
8612:      { 109 3 x--  111 3 x--  108 3 x--  110 3 x-- }
8613:      { 118 3 ---  120 3 ---  119 3 ---  121 3 --- }
8614:      { 11A 3 ---  122 3 ---  11B 3 ---  123 3 --- }
8615:      { 11C 3 ---  124 3 ---  11D 3 ---  125 3 --- }
8616:      { 11E 3 ---  126 3 ---  11F 3 ---  127 3 --- }
8617:      { 11A 3 ---  122 3 ---  11B 3 ---  128 3 --- }
8618:      { 11C 3 ---  129 3 ---  11D 3 ---  129 3 --- }
8619:      { 11E 3 ---  129 3 ---  11F 3 ---  128 3 x-- }
861A:      { 11A 3 ---  122 3 ---  11B 3 ---  127 3 --- }
861B:      { 11C 3 ---  122 3 ---  11D 3 ---  128 3 --- }
861C:      { 11D 3 x--  129 3 ---  11C 3 x--  127 3 x-- }
861D:      { 11B 3 x--  129 3 ---  11A 3 x--  129 3 --- }
861E:      { 119 3 x--  121 3 x--  118 3 x--  120 3 x-- }
861F:      { 11C 3 ---  124 3 ---  11D 3 ---  120 3 --- }
8620:      { 11E 3 ---  121 3 ---  11F 3 ---  122 3 --- }
8621:      { 12A 3 ---  132 3 ---  12B 3 ---  133 3 --- }
8622:      { 12C 3 ---  134 3 ---  12D 3 ---  135 3 --- }
8623:      { 12E 3 ---  136 3 ---  12F 3 ---  137 3 --- }
8624:      { 130 3 ---  138 3 ---  131 3 ---  139 3 --- }
8625:      { 122 3 x--  12C 3 x--  121 3 x--  12B 3 x-- }
8626:      { 120 3 x--  12A 3 x--  12D 3 ---  135 3 --- }
8627:      { 12E 3 ---  136 3 ---  12E 3 x--  136 3 x-- }
8628:      { 12D 3 x--  135 3 x--  12F 3 ---  137 3 --- }
8629:      { 12F 3 x--  137 3 x--  131 3 ---  139 3 --- }
862A:      { 120 3 x--  12A 3 x--  131 3 x--  139 3 x-- }
862B:      { 130 3 x--  138 3 x--  12A 3 ---  132 3 --- }
862C:      { 12B 3 ---  133 3 ---  12C 3 ---  134 3 --- }
862D:      { 120 3 x--  12A 3 x--  12A 3 ---  132 3 --- }
862E:      { 13A 3 ---  142 3 ---  13B 3 ---  143 3 --- }
862F:      { 13C 3 ---  144 3 ---  13D 3 ---  145 3 --- }
8630:      { 13E 3 ---  146 3 ---  13F 3 ---  147 3 --- }
8631:      { 140 3 ---  148 3 ---  141 3 ---  149 3 --- }
8632:      { 134 3 x--  13C 3 x--  133 3 x--  13B 3 x-- }
8633:      { 132 3 x--  13A 3 x--  13D 3 ---  145 3 --- }
8634:      { 13E 3 ---  146 3 ---  13E 3 x--  146 3 x-- }
8635:      { 13D 3 x--  145 3 x--  13F 3 ---  147 3 --- }
8636:      { 13F 3 x--  147 3 x--  141 3 ---  149 3 --- }
8637:      { 132 3 x--  13A 3 x--  141 3 x--  149 3 x-- }
8638:      { 140 3 x--  148 3 x--  13A 3 ---  142 3 --- }
8639:      { 13B 3 ---  143 3 ---  13C 3 ---  144 3 --- }
863A:      { 132 3 x--  13A 3 x--  13A 3 ---  14A 3 --- }
863B:      { 13B 3 ---  14B 3 ---  13C 3 ---  144 3 --- }
863C:      { 14C 3 ---  156 3 ---  14D 3 ---  157 3 --- }
863D:      { 14E 3 ---  158 3 ---  14F 3 ---  159 3 --- }
863E:      { 150 3 ---  15A 3 ---  151 3 ---  15B 3 --- }
863F:      { 152 3 ---  15C 3 ---  153 3 ---  15D 3 --- }
8640:      { 144 3 x--  14E 3 x--  14B 3 x--  155 3 x-- }
8641:      { 14A 3 x--  154 3 ---  14F 3 ---  159 3 --- }
8642:      { 150 3 ---  15A 3 ---  150 3 x--  15E 3 --- }
8643:      { 14F 3 x--  159 3 x--  151 3 ---  15B 3 --- }
8644:      { 151 3 x--  15B 3 x--  153 3 ---  15D 3 --- }
8645:      { 14A 3 x--  154 3 ---  153 3 x--  15D 3 x-- }
8646:      { 152 3 x--  15C 3 x--  14C 3 ---  156 3 --- }
8647:      { 14D 3 ---  157 3 ---  14E 3 ---  158 3 --- }
8648:      { 14A 3 x--  154 3 ---  154 3 ---  129 3 --- }
8649:      { 155 3 ---  129 3 ---  14E 3 ---  14E 3 --- }
864A:      { 15F 3 ---  16A 3 ---  160 3 ---  16B 3 --- }
864B:      { 15E 3 ---  16C 3 ---  161 3 ---  16D 3 --- }
864C:      { 162 3 ---  14B 3 x--  163 3 ---  16E 3 --- }
864D:      { 164 3 ---  16F 3 ---  165 3 ---  14A 3 x-- }
864E:      { 166 3 ---  170 3 ---  167 3 ---  171 3 --- }
864F:      { 129 3 ---  129 3 ---  161 3 ---  155 3 x-- }
8650:      { 162 3 ---  156 3 ---  162 3 x--  172 3 --- }
8651:      { 161 3 x--  169 3 ---  163 3 ---  16E 3 --- }
8652:      { 163 3 x--  16E 3 x--  164 3 ---  156 3 --- }
8653:      { 165 3 ---  156 3 x--  166 3 ---  170 3 --- }
8654:      { 167 3 ---  171 3 ---  165 3 x--  14A 3 --- }
8655:      { 164 3 x--  16F 3 x--  15F 3 ---  16A 3 --- }
8656:      { 160 3 ---  16B 3 ---  15E 3 ---  16C 3 --- }
8657:      { 168 3 ---  129 3 ---  156 3 ---  15F 3 --- }
8658:      { 169 3 ---  16A 3 ---  14E 3 ---  16B 3 --- }
8659:      { 173 3 ---  179 3 ---  174 3 ---  17A 3 --- }
865A:      { 175 3 ---  17B 3 ---  167 3 x--  171 3 x-- }
865B:      { 166 3 x--  170 3 x--  176 3 ---  17C 3 --- }
865C:      { 177 3 ---  17D 3 ---  178 3 ---  17E 3 --- }
865D:      { 178 3 x--  17E 3 x--  177 3 x--  17D 3 x-- }
865E:      { 176 3 x--  17C 3 x--  168 3 ---  144 3 --- }
865F:      { 15F 3 ---  15F 3 ---  16A 3 ---  173 3 --- }
8660:      { 16B 3 ---  174 3 ---  16C 3 ---  175 3 --- }
8661:      { 168 3 ---  177 3 x--  15F 3 ---  16A 3 --- }
8662:      { 15F 3 x--  16A 3 x--  141 3 ---  12A 3 --- }
8663:      { 168 3 ---  154 3 ---  142 3 ---  14C 3 --- }
8664:      { 155 3 x--  154 3 ---  179 3 ---  179 3 --- }
8665:      { 17A 3 ---  17A 3 ---  17B 3 ---  17B 3 --- }
8666:      { 176 3 x--  17C 3 x--  15F 3 ---  15F 3 --- }
8667:      { 168 3 ---  154 3 ---  154 3 ---  13C 3 x-- }
8668:      { 17F 3 ---  205 3 ---  200 3 ---  206 3 --- }
8669:      { 201 3 ---  207 3 ---  172 3 ---  12D 3 --- }
866A:      { 169 3 ---  129 3 ---  202 3 ---  208 3 --- }
866B:      { 203 3 ---  155 3 x--  204 3 ---  168 3 --- }
866C:      { 204 3 x--  168 3 x--  203 3 x--  155 3 --- }
866D:      { 202 3 x--  208 3 x--  14E 3 ---  14E 3 --- }
866E:      { 15F 3 ---  16A 3 ---  179 3 ---  17F 3 --- }
866F:      { 17A 3 ---  200 3 ---  17B 3 ---  201 3 --- }
8670:      { 17D 3 x--  208 3 ---  17D 3 ---  155 3 x-- }
8671:      { 154 3 ---  209 3 ---  132 3 ---  13A 3 --- }
8672:      { 154 3 ---  154 3 ---  14C 3 ---  14C 3 --- }
8673:      { 154 3 ---  154 3 ---  179 3 ---  17F 3 --- }
8674:      { 202 3 x--  208 3 x--  16A 3 ---  154 3 --- }
8675:      { 154 3 ---  154 3 ---  144 3 x--  14E 3 x-- }
8676:      { 168 3 x--  177 3 ---  168 3 ---  168 3 --- }
8677:      { 150 3 ---  155 3 x--  135 3 ---  13D 3 --- }
8678:      { 20A 3 ---  20E 3 ---  20B 3 ---  20F 3 --- }
8679:      { 20C 3 ---  210 3 ---  20D 3 ---  211 3 --- }
867A:      { 14A 3 x--  154 3 ---  179 3 ---  17F 3 --- }
867B:      { 202 3 ---  208 3 ---  203 3 ---  155 3 x-- }
867C:      { 129 3 ---  129 3 ---  132 3 ---  13A 3 --- }
867D:      { 0F8 3 ---  176 3 ---  171 3 x--  177 3 --- }
867E:      { 0F8 3 ---  177 3 x--  205 3 ---  176 3 x-- }
867F:      { 206 3 ---  168 3 x--  207 3 ---  0F8 3 --- }
8680:      { 154 3 ---  168 3 ---  142 3 ---  14C 3 --- }
8681:      { 142 3 x--  14C 3 x--  154 3 ---  0F8 3 --- }
8682:      { 142 3 ---  14C 3 ---  142 3 x--  14C 3 x-- }
8683:      { 17D 3 ---  208 3 x--  20A 3 ---  20E 3 --- }
8684:      { 20D 3 ---  211 3 ---  145 3 ---  14F 3 --- }
8685:      { 212 3 ---  218 3 ---  213 3 ---  219 3 --- }
8686:      { 214 3 ---  21A 3 ---  215 3 ---  21B 3 --- }
8687:      { 14A 3 x--  154 3 ---  156 3 ---  15F 3 --- }
8688:      { 156 3 x--  15F 3 x--  14E 3 ---  155 3 x-- }
8689:      { 168 3 ---  129 3 ---  17F 3 ---  179 3 --- }
868A:      { 200 3 ---  17A 3 ---  201 3 ---  17B 3 --- }
868B:      { 204 3 ---  21C 3 ---  154 3 ---  21D 3 --- }
868C:      { 209 3 ---  21C 3 x--  20A 3 ---  20A 3 --- }
868D:      { 17C 3 ---  208 3 ---  17D 3 ---  20C 3 --- }
868E:      { 17D 3 x--  204 3 ---  17C 3 x--  208 3 --- }
868F:      { 168 3 x--  20A 3 x--  0F8 3 ---  0F8 3 --- }
8690:      { 168 3 ---  20A 3 ---  14C 3 ---  14C 3 --- }
8691:      { 216 3 ---  20E 3 ---  20B 3 ---  20F 3 --- }
8692:      { 20C 3 ---  210 3 ---  217 3 ---  211 3 --- }
8693:      { 202 3 x--  208 3 x--  212 3 ---  218 3 --- }
8694:      { 215 3 ---  21B 3 ---  154 3 ---  168 3 --- }
8695:      { 21E 3 ---  218 3 ---  21F 3 ---  219 3 --- }
8696:      { 220 3 ---  21A 3 ---  221 3 ---  21B 3 --- }
8697:      { 168 3 ---  129 3 ---  15F 3 ---  15F 3 --- }
8698:      { 15F 3 x--  15F 3 x--  141 3 x--  149 3 x-- }
8699:      { 0F8 3 ---  0F8 3 ---  17F 3 ---  205 3 --- }
869A:      { 200 3 ---  206 3 ---  201 3 ---  207 3 --- }
869B:      { 222 3 ---  229 3 ---  223 3 ---  22A 3 --- }
869C:      { 222 3 x--  229 3 x--  20A 3 ---  20A 3 --- }
869D:      { 168 3 ---  22B 3 ---  224 3 ---  22C 3 --- }
869E:      { 225 3 ---  22D 3 ---  226 3 ---  22E 3 --- }
869F:      { 227 3 ---  22F 3 ---  228 3 ---  230 3 --- }
86A0:      { 209 3 ---  231 3 ---  132 3 x--  13A 3 x-- }
86A1:      { 204 3 x--  241 3 ---  21E 3 ---  22B 3 --- }
86A2:      { 232 3 ---  22C 3 ---  225 3 ---  22D 3 --- }
86A3:      { 226 3 ---  22E 3 ---  227 3 ---  22F 3 --- }
86A4:      { 228 3 ---  230 3 ---  233 3 ---  231 3 --- }
86A5:      { 0F8 3 ---  0F8 3 ---  15F 3 ---  15F 3 --- }
86A6:      { 15F 3 x--  15F 3 x--  153 3 x--  204 3 x-- }
86A7:      { 234 3 ---  242 3 ---  235 3 ---  243 3 --- }
86A8:      { 235 3 x--  243 3 x--  236 3 ---  242 3 x-- }
86A9:      { 237 3 ---  244 3 ---  238 3 ---  245 3 --- }
86AA:      { 237 3 x--  244 3 x--  239 3 ---  246 3 --- }
86AB:      { 23A 3 ---  247 3 ---  23B 3 ---  248 3 --- }
86AC:      { 23C 3 ---  249 3 ---  23D 3 ---  21D 3 --- }
86AD:      { 23E 3 ---  24A 3 ---  23F 3 ---  24B 3 --- }
86AE:      { 240 3 ---  24C 3 ---  14A 3 x--  154 3 --- }
86AF:      { 21E 3 ---  212 3 ---  21F 3 ---  213 3 --- }
86B0:      { 220 3 ---  214 3 ---  221 3 ---  215 3 --- }
86B1:      { 239 3 ---  246 3 ---  23A 3 ---  247 3 --- }
86B2:      { 23B 3 ---  248 3 ---  23C 3 ---  249 3 --- }
86B3:      { 23D 3 ---  21D 3 ---  23E 3 ---  24A 3 --- }
86B4:      { 23F 3 ---  24B 3 ---  240 3 ---  24C 3 --- }
86B5:      { 168 3 x--  144 3 x--  16A 3 ---  168 3 x-- }
86B6:      { 16A 3 x--  0F8 3 ---  168 3 x--  14A 3 x-- }
86B7:      { 24D 3 ---  258 3 ---  24E 3 ---  259 3 --- }
86B8:      { 24E 3 x--  259 3 x--  24D 3 x--  258 3 x-- }
86B9:      { 21C 3 ---  222 3 ---  24F 3 ---  25A 3 --- }
86BA:      { 21C 3 x--  222 3 x--  250 3 ---  25B 3 --- }
86BB:      { 251 3 ---  25C 3 ---  252 3 ---  25D 3 --- }
86BC:      { 253 3 ---  25E 3 ---  223 3 ---  22A 3 --- }
86BD:      { 254 3 ---  25F 3 ---  255 3 ---  260 3 --- }
86BE:      { 256 3 ---  229 3 x--  257 3 ---  261 3 --- }
86BF:      { 218 3 ---  262 3 ---  21F 3 ---  263 3 --- }
86C0:      { 21A 3 ---  220 3 ---  21B 3 ---  221 3 --- }
86C1:      { 250 3 ---  25B 3 ---  251 3 ---  25C 3 --- }
86C2:      { 252 3 ---  25D 3 ---  253 3 ---  25E 3 --- }
86C3:      { 223 3 ---  22A 3 ---  254 3 ---  25F 3 --- }
86C4:      { 255 3 ---  260 3 ---  256 3 ---  229 3 x-- }
86C5:      { 14E 3 x--  14E 3 x--  177 3 ---  17D 3 --- }
86C6:      { 0F8 3 ---  270 3 ---  154 3 ---  234 3 --- }
86C7:      { 264 3 ---  235 3 ---  265 3 ---  271 3 --- }
86C8:      { 266 3 ---  272 3 ---  258 3 x--  261 3 --- }
86C9:      { 21C 3 ---  262 3 ---  25A 3 ---  263 3 --- }
86CA:      { 229 3 x--  237 3 x--  267 3 ---  273 3 --- }
86CB:      { 268 3 ---  274 3 ---  269 3 ---  275 3 --- }
86CC:      { 26A 3 ---  276 3 ---  238 3 ---  245 3 --- }
86CD:      { 26B 3 ---  277 3 ---  26C 3 ---  278 3 --- }
86CE:      { 237 3 x--  244 3 x--  26D 3 ---  279 3 --- }
86CF:      { 26E 3 ---  27A 3 ---  26F 3 ---  27B 3 --- }
86D0:      { 267 3 ---  273 3 ---  268 3 ---  274 3 --- }
86D1:      { 269 3 ---  275 3 ---  26A 3 ---  276 3 --- }
86D2:      { 238 3 ---  245 3 ---  26B 3 ---  277 3 --- }
86D3:      { 26C 3 ---  278 3 ---  237 3 x--  244 3 x-- }
86D4:      { 14E 3 x--  14E 3 x--  168 3 x--  14A 3 x-- }
86D5:      { 27C 3 ---  287 3 ---  242 3 ---  24D 3 --- }
86D6:      { 243 3 ---  24E 3 ---  27D 3 ---  288 3 --- }
86D7:      { 27E 3 ---  289 3 ---  26D 3 ---  279 3 --- }
86D8:      { 244 3 x--  21C 3 x--  27F 3 ---  28A 3 --- }
86D9:      { 280 3 ---  28B 3 ---  281 3 ---  28C 3 --- }
86DA:      { 282 3 ---  28D 3 ---  24F 3 ---  25A 3 --- }
86DB:      { 283 3 ---  28E 3 ---  284 3 ---  28F 3 --- }
86DC:      { 21C 3 x--  222 3 x--  285 3 ---  26D 3 --- }
86DD:      { 286 3 ---  290 3 ---  27B 3 ---  27B 3 --- }
86DE:      { 27F 3 ---  28A 3 ---  280 3 ---  28B 3 --- }
86DF:      { 281 3 ---  28C 3 ---  282 3 ---  28D 3 --- }
86E0:      { 24F 3 ---  25A 3 ---  283 3 ---  28E 3 --- }
86E1:      { 284 3 ---  28F 3 ---  21C 3 x--  222 3 x-- }
86E2:      { 14E 3 x--  155 3 ---  154 3 ---  0F8 3 --- }
86E3:      { 291 3 ---  291 3 ---  258 3 ---  258 3 --- }
86E4:      { 259 3 ---  294 3 ---  292 3 ---  286 3 --- }
86E5:      { 293 3 ---  295 3 ---  285 3 ---  26D 3 --- }
86E6:      { 222 3 x--  207 3 ---  25B 3 ---  267 3 --- }
86E7:      { 25C 3 ---  268 3 ---  25D 3 ---  269 3 --- }
86E8:      { 25E 3 ---  26A 3 ---  22A 3 ---  238 3 --- }
86E9:      { 25F 3 ---  26B 3 ---  260 3 ---  26C 3 --- }
86EA:      { 229 3 x--  237 3 x--  26D 3 ---  26D 3 --- }
86EB:      { 288 3 ---  234 3 ---  27B 3 ---  235 3 --- }
86EC:      { 220 3 ---  235 3 x--  221 3 ---  236 3 --- }
86ED:      { 25B 3 ---  267 3 ---  25C 3 ---  268 3 --- }
86EE:      { 25D 3 ---  269 3 ---  25E 3 ---  26A 3 --- }
86EF:      { 22A 3 ---  238 3 ---  25F 3 ---  26B 3 --- }
86F0:      { 260 3 ---  26C 3 ---  229 3 x--  237 3 x-- }
86F1:      { 204 3 x--  204 3 x--  204 3 ---  204 3 --- }
86F2:      { 291 3 ---  287 3 ---  258 3 ---  24D 3 --- }
86F3:      { 259 3 ---  24E 3 ---  290 3 ---  288 3 --- }
86F4:      { 296 3 ---  289 3 ---  26D 3 ---  26D 3 --- }
86F5:      { 288 3 ---  27A 3 ---  27B 3 ---  27B 3 --- }
86F6:      { 168 3 ---  168 3 x--  273 3 ---  27F 3 --- }
86F7:      { 274 3 ---  280 3 ---  275 3 ---  281 3 --- }
86F8:      { 276 3 ---  282 3 ---  245 3 ---  24F 3 --- }
86F9:      { 277 3 ---  283 3 ---  278 3 ---  284 3 --- }
86FA:      { 244 3 x--  21C 3 x--  279 3 ---  285 3 --- }
86FB:      { 242 3 ---  24D 3 ---  243 3 ---  24E 3 --- }
86FC:      { 243 3 x--  24E 3 x--  242 3 x--  24D 3 x-- }
86FD:      { 273 3 ---  27F 3 ---  274 3 ---  280 3 --- }
86FE:      { 275 3 ---  281 3 ---  276 3 ---  282 3 --- }
86FF:      { 245 3 ---  24F 3 ---  277 3 ---  283 3 --- }
