8F00:      { 100 4 ---  100 4 ---  100 4 ---  10A 4 --- }
8F01:      { 100 4 ---  100 4 ---  101 4 ---  10B 4 --- }
8F02:      { 100 4 ---  100 4 ---  100 4 ---  100 4 --- }
8F03:      { 100 4 ---  10C 4 ---  102 4 ---  100 4 --- }
8F04:      { 100 4 ---  100 4 ---  100 4 ---  10D 4 --- }
8F05:      { 100 4 ---  10E 4 ---  100 4 ---  10F 4 --- }
8F06:      { 100 4 ---  100 4 ---  100 4 ---  110 4 --- }
8F07:      { 103 4 ---  100 4 ---  100 4 ---  111 4 --- }
8F08:      { 104 4 ---  112 4 ---  105 4 ---  113 4 --- }
8F09:      { 100 4 ---  114 4 ---  100 4 ---  115 4 --- }
8F0A:      { 100 4 ---  116 4 ---  106 4 ---  100 4 --- }
8F0B:      { 107 4 ---  100 4 ---  108 4 ---  117 4 --- }
8F0C:      { 109 4 ---  100 4 ---  100 4 ---  100 4 --- }
8F0D:      { 109 4 xy-  11F 4 ---  100 4 ---  100 4 --- }
8F0E:      { 100 4 ---  100 4 ---  118 4 ---  120 4 --- }
8F0F:      { 100 4 ---  100 4 ---  119 4 ---  121 4 --- }
8F10:      { 11A 4 ---  100 4 ---  100 4 ---  100 4 --- }
8F11:      { 11B 4 ---  100 4 ---  100 4 ---  100 4 --- }
8F12:      { 100 4 ---  122 4 ---  11C 4 ---  123 4 --- }
8F13:      { 11D 4 ---  100 4 ---  11E 4 ---  124 4 --- }
8F14:      { 100 4 ---  125 4 ---  100 4 ---  126 4 --- }
8F15:      { 100 4 ---  100 4 ---  100 4 ---  127 4 --- }
8F16:      { 100 4 ---  100 4 ---  100 4 ---  128 4 --- }
8F17:      { 129 4 ---  133 4 ---  100 4 ---  123 4 x-- }
8F18:      { 100 4 ---  100 4 ---  100 4 ---  134 4 --- }
8F19:      { 12A 4 ---  135 4 ---  12B 4 ---  136 4 --- }
8F1A:      { 100 4 ---  100 4 ---  12C 4 ---  100 4 --- }
8F1B:      { 12D 4 ---  100 4 ---  12E 4 ---  137 4 --- }
8F1C:      { 100 4 ---  138 4 ---  100 4 ---  139 4 --- }
8F1D:      { 118 4 xy-  100 4 ---  120 4 ---  100 4 --- }
8F1E:      { 100 4 ---  100 4 ---  12F 4 ---  100 4 --- }
8F1F:      { 100 4 ---  100 4 ---  130 4 ---  109 4 xy- }
8F20:      { 131 4 ---  100 4 ---  100 4 ---  100 4 --- }
8F21:      { 132 4 ---  100 4 ---  10B 4 x--  100 4 --- }
8F22:      { 100 4 ---  118 4 x--  100 4 ---  100 4 --- }
8F23:      { 100 4 ---  100 4 ---  13A 4 ---  100 4 --- }
8F24:      { 100 4 ---  100 4 ---  13B 4 ---  140 4 --- }
8F25:      { 100 4 ---  141 4 ---  100 4 ---  100 4 --- }
8F26:      { 100 4 ---  100 4 ---  13C 4 ---  100 4 --- }
8F27:      { 13D 4 ---  100 4 ---  100 4 ---  10E 4 --- }
8F28:      { 100 4 ---  100 4 ---  100 4 ---  12E 4 --- }
8F29:      { 100 4 ---  100 4 ---  13E 4 ---  100 4 --- }
8F2A:      { 107 4 x--  142 4 ---  100 4 ---  100 4 --- }
8F2B:      { 100 4 ---  103 4 ---  100 4 ---  100 4 --- }
8F2C:      { 13F 4 ---  100 4 ---  100 4 ---  100 4 --- }
8F2D:      { 143 4 ---  100 4 ---  100 4 ---  100 4 --- }
8F2E:      { 100 4 ---  100 4 ---  100 4 ---  149 4 --- }
8F2F:      { 144 4 ---  100 4 ---  100 4 ---  14A 4 --- }
8F30:      { 102 4 -y-  127 4 -y-  145 4 ---  100 4 --- }
8F31:      { 137 4 ---  103 4 xy-  100 4 ---  144 4 xy- }
8F32:      { 100 4 ---  100 4 ---  146 4 ---  100 4 --- }
8F33:      { 147 4 ---  100 4 ---  100 4 ---  100 4 --- }
8F34:      { 148 4 ---  100 4 ---  100 4 ---  100 4 --- }
8F35:      { 100 4 ---  100 4 ---  100 4 ---  137 4 xy- }
8F36:      { 100 4 ---  158 4 ---  100 4 ---  100 4 --- }
8F37:      { 100 4 ---  159 4 ---  100 4 ---  15A 4 --- }
8F38:      { 143 4 -y-  15B 4 ---  14B 4 ---  15C 4 --- }
8F39:      { 14C 4 ---  15D 4 ---  14D 4 ---  15E 4 --- }
8F3A:      { 14E 4 ---  15F 4 ---  14F 4 ---  160 4 --- }
8F3B:      { 150 4 ---  161 4 ---  151 4 ---  162 4 --- }
8F3C:      { 152 4 ---  163 4 ---  153 4 ---  164 4 --- }
8F3D:      { 100 4 ---  165 4 ---  154 4 ---  166 4 --- }
8F3E:      { 155 4 ---  167 4 ---  156 4 ---  168 4 --- }
8F3F:      { 100 4 ---  169 4 ---  100 4 ---  16A 4 --- }
8F40:      { 100 4 ---  16B 4 ---  100 4 ---  100 4 --- }
8F41:      { 157 4 ---  100 4 ---  100 4 ---  100 4 --- }
8F42:      { 100 4 ---  100 4 ---  100 4 ---  11E 4 x-- }
8F43:      { 16C 4 ---  208 4 ---  16D 4 ---  100 4 --- }
8F44:      { 16E 4 ---  209 4 ---  16F 4 ---  20A 4 --- }
8F45:      { 170 4 ---  20B 4 ---  171 4 ---  20C 4 --- }
8F46:      { 172 4 ---  20D 4 ---  173 4 ---  20E 4 --- }
8F47:      { 174 4 ---  20F 4 ---  175 4 ---  210 4 --- }
8F48:      { 176 4 ---  211 4 ---  177 4 ---  212 4 --- }
8F49:      { 178 4 ---  213 4 ---  179 4 ---  214 4 --- }
8F4A:      { 200 4 ---  215 4 ---  201 4 ---  216 4 --- }
8F4B:      { 202 4 ---  217 4 ---  203 4 ---  218 4 --- }
8F4C:      { 204 4 ---  219 4 ---  205 4 ---  21A 4 --- }
8F4D:      { 206 4 ---  21B 4 ---  100 4 ---  21C 4 --- }
8F4E:      { 207 4 ---  21D 4 ---  100 4 ---  21E 4 --- }
8F4F:      { 100 4 ---  21F 4 ---  100 4 ---  220 4 --- }
8F50:      { 100 4 ---  221 4 ---  100 4 ---  100 4 --- }
8F51:      { 222 4 ---  100 4 ---  100 4 ---  23B 4 --- }
8F52:      { 223 4 ---  23C 4 ---  224 4 ---  23D 4 --- }
8F53:      { 225 4 ---  23E 4 ---  226 4 ---  23F 4 --- }
8F54:      { 227 4 ---  240 4 ---  228 4 ---  241 4 --- }
8F55:      { 229 4 ---  242 4 ---  22A 4 ---  243 4 --- }
8F56:      { 22B 4 ---  244 4 ---  22C 4 ---  245 4 --- }
8F57:      { 22D 4 ---  246 4 ---  22E 4 ---  247 4 --- }
8F58:      { 22F 4 ---  248 4 ---  230 4 ---  249 4 --- }
8F59:      { 231 4 ---  24A 4 ---  232 4 ---  24B 4 --- }
8F5A:      { 233 4 ---  24C 4 ---  234 4 ---  24D 4 --- }
8F5B:      { 235 4 ---  24E 4 ---  236 4 ---  24F 4 --- }
8F5C:      { 237 4 ---  250 4 ---  238 4 ---  251 4 --- }
8F5D:      { 239 4 ---  252 4 ---  23A 4 ---  253 4 --- }
8F5E:      { 100 4 ---  254 4 ---  102 4 -y-  255 4 --- }
8F5F:      { 14A 4 xy-  100 4 ---  100 4 ---  100 4 --- }
8F60:      { 108 4 ---  100 4 ---  256 4 ---  100 4 --- }
8F61:      { 257 4 ---  271 4 ---  258 4 ---  272 4 --- }
8F62:      { 259 4 ---  273 4 ---  25A 4 ---  274 4 --- }
8F63:      { 25B 4 ---  275 4 ---  25C 4 ---  276 4 --- }
8F64:      { 25D 4 ---  277 4 ---  25E 4 ---  278 4 --- }
8F65:      { 25F 4 ---  279 4 ---  260 4 ---  27A 4 --- }
8F66:      { 261 4 ---  27B 4 ---  262 4 ---  27C 4 --- }
8F67:      { 263 4 ---  27D 4 ---  264 4 ---  27E 4 --- }
8F68:      { 265 4 ---  27F 4 ---  266 4 ---  280 4 --- }
8F69:      { 267 4 ---  281 4 ---  268 4 ---  282 4 --- }
8F6A:      { 269 4 ---  283 4 ---  26A 4 ---  284 4 --- }
8F6B:      { 26B 4 ---  285 4 ---  26C 4 ---  286 4 --- }
8F6C:      { 26D 4 ---  287 4 ---  26E 4 ---  288 4 --- }
8F6D:      { 26F 4 ---  289 4 ---  270 4 ---  28A 4 --- }
8F6E:      { 10C 4 ---  28B 4 ---  100 4 ---  28C 4 --- }
8F6F:      { 221 4 -y-  2A7 4 ---  100 4 ---  100 4 --- }
8F70:      { 100 4 ---  100 4 ---  28D 4 ---  100 4 --- }
8F71:      { 28E 4 ---  100 4 ---  28F 4 ---  13A 4 -y- }
8F72:      { 290 4 ---  2A8 4 ---  291 4 ---  2A9 4 --- }
8F73:      { 292 4 ---  2AA 4 ---  293 4 ---  2AB 4 --- }
8F74:      { 294 4 ---  2AC 4 ---  295 4 ---  2AD 4 --- }
8F75:      { 296 4 ---  2AE 4 ---  297 4 ---  2AF 4 --- }
8F76:      { 298 4 ---  2B0 4 ---  299 4 ---  2B1 4 --- }
8F77:      { 29A 4 ---  2B2 4 ---  29B 4 ---  2B3 4 --- }
8F78:      { 29C 4 ---  2B4 4 ---  29D 4 ---  2B5 4 --- }
8F79:      { 29E 4 ---  2B6 4 ---  29F 4 ---  2B7 4 --- }
8F7A:      { 2A0 4 ---  2B8 4 ---  2A1 4 ---  2B9 4 --- }
8F7B:      { 2A2 4 ---  2BA 4 ---  2A3 4 ---  2BB 4 --- }
8F7C:      { 2A4 4 ---  2BC 4 ---  2A5 4 ---  2BD 4 --- }
8F7D:      { 2A6 4 ---  2BE 4 ---  100 4 ---  100 4 --- }
8F7E:      { 100 4 ---  100 4 ---  13A 4 -y-  100 4 --- }
8F7F:      { 116 4 -y-  100 4 ---  100 4 ---  2D3 4 --- }
8F80:      { 2BF 4 ---  100 4 ---  2C0 4 ---  2D4 4 --- }
8F81:      { 2C1 4 ---  2D5 4 ---  2C2 4 ---  2D6 4 --- }
8F82:      { 2C3 4 ---  100 4 ---  2C4 4 ---  2D7 4 --- }
8F83:      { 2C5 4 ---  2D8 4 ---  2C6 4 ---  2D9 4 --- }
8F84:      { 2C7 4 ---  2DA 4 ---  2C8 4 ---  2DB 4 --- }
8F85:      { 2C9 4 ---  2DC 4 ---  2CA 4 ---  2DD 4 --- }
8F86:      { 2CB 4 ---  2DE 4 ---  2CC 4 ---  2DF 4 --- }
8F87:      { 2CD 4 ---  2E0 4 ---  2CE 4 ---  2E1 4 --- }
8F88:      { 2CF 4 ---  100 4 ---  2D0 4 ---  100 4 --- }
8F89:      { 2D1 4 ---  100 4 ---  100 4 ---  100 4 --- }
8F8A:      { 100 4 ---  100 4 ---  2D2 4 ---  100 4 --- }
8F8B:      { 100 4 ---  140 4 x--  100 4 ---  100 4 --- }
8F8C:      { 112 4 x--  12E 4 ---  100 4 ---  2E6 4 --- }
8F8D:      { 100 4 ---  100 4 ---  2E2 4 ---  100 4 --- }
8F8E:      { 100 4 ---  2E7 4 ---  2E3 4 ---  100 4 --- }
8F8F:      { 100 4 ---  120 4 x--  156 4 ---  100 4 --- }
8F90:      { 2E4 4 ---  10B 4 x--  100 4 ---  100 4 --- }
8F91:      { 2E5 4 ---  14A 4 x--  100 4 ---  100 4 --- }
8F92:      { 157 4 ---  11B 4 ---  100 4 ---  28C 4 -y- }
8F93:      { 107 4 -y-  100 4 ---  100 4 ---  100 4 --- }
8F94:      { 100 4 ---  100 4 ---  100 4 ---  2EC 4 --- }
8F95:      { 109 4 x--  2ED 4 ---  100 4 ---  100 4 --- }
8F96:      { 100 4 ---  222 4 xy-  2E8 4 ---  2EE 4 --- }
8F97:      { 100 4 ---  100 4 ---  100 4 ---  140 4 xy- }
8F98:      { 100 4 ---  100 4 ---  148 4 xy-  100 4 --- }
8F99:      { 2E9 4 ---  100 4 ---  100 4 ---  107 4 xy- }
8F9A:      { 100 4 ---  11E 4 -y-  100 4 ---  100 4 --- }
8F9B:      { 2EA 4 ---  2E3 4 x--  100 4 ---  100 4 --- }
8F9C:      { 108 4 x--  100 4 ---  100 4 ---  100 4 --- }
8F9D:      { 11E 4 x--  2EF 4 ---  100 4 ---  100 4 --- }
8F9E:      { 2EB 4 ---  100 4 ---  100 4 ---  100 4 --- }
8F9F:      { 100 4 ---  100 4 ---  2D3 4 -y-  2F0 4 --- }
8FA0:      { 100 4 ---  100 4 ---  2F1 4 ---  100 4 --- }
8FA1:      { 2F2 4 ---  100 4 ---  14A 4 -y-  108 4 x-- }
8FA2:      { 2F3 4 ---  100 4 ---  2F4 4 ---  2F7 4 --- }
8FA3:      { 2F5 4 ---  100 4 ---  10B 4 ---  100 4 --- }
8FA4:      { 100 4 ---  100 4 ---  100 4 ---  2F8 4 --- }
8FA5:      { 100 4 ---  2F9 4 ---  100 4 ---  2FA 4 --- }
8FA6:      { 10C 4 ---  100 4 ---  10B 4 ---  100 4 --- }
8FA7:      { 100 4 ---  28C 4 x--  10B 4 ---  100 4 --- }
8FA8:      { 100 4 ---  100 4 ---  11B 4 xy-  100 4 --- }
8FA9:      { 100 4 ---  108 4 x--  100 4 ---  100 4 --- }
8FAA:      { 2F6 4 ---  100 4 ---  100 4 ---  2FB 4 --- }
8FAB:      { 100 4 ---  100 4 ---  2EB 4 x--  145 4 xy- }
8FAC:      { 10E 4 x--  100 4 ---  100 4 ---  100 4 --- }
8FAD:      { 100 4 ---  100 4 ---  2FC 4 ---  140 4 x-- }
8FAE:      { 2E8 4 x--  100 4 ---  2E8 4 ---  100 4 --- }
8FAF:      { 111 4 x--  100 4 ---  100 4 ---  2FF 4 --- }
8FB0:      { 100 4 ---  100 4 ---  2FD 4 ---  100 4 --- }
8FB1:      { 100 4 ---  100 4 ---  2FE 4 ---  100 4 --- }
8FB2:      { 2E9 4 ---  100 4 ---  100 4 ---  100 4 --- }
8FB3: ~
8FB4: ~
8FB5: ~
8FB6: ~
8FB7: ~
8FB8: ~
8FB9: ~
8FBA: ~
8FBB: ~
8FBC: ~
8FBD: ~
8FBE: ~
8FBF: ~
8FC0: ~
8FC1: ~
8FC2: ~
8FC3: ~
8FC4: ~
8FC5: ~
8FC6: ~
8FC7: ~
8FC8: ~
8FC9: ~
8FCA: ~
8FCB: ~
8FCC: ~
8FCD: ~
8FCE: ~
8FCF: ~
8FD0: ~
8FD1: ~
8FD2: ~
8FD3: ~
8FD4: ~
8FD5: ~
8FD6: ~
8FD7: ~
8FD8: ~
8FD9: ~
8FDA: ~
8FDB: ~
8FDC: ~
8FDD: ~
8FDE: ~
8FDF: ~
8FE0: ~
8FE1: ~
8FE2: ~
8FE3: ~
8FE4: ~
8FE5: ~
8FE6: ~
8FE7: ~
8FE8: ~
8FE9: ~
8FEA: ~
8FEB: ~
8FEC: ~
8FED: ~
8FEE: ~
8FEF: ~
8FF0: ~
8FF1: ~
8FF2: ~
8FF3: ~
8FF4: ~
8FF5: ~
8FF6: ~
8FF7: ~
8FF8: ~
8FF9: ~
8FFA: ~
8FFB: ~
8FFC: ~
8FFD: ~
8FFE: ~
8FFF: ~
