9800:      { 200 3 ---  207 3 ---  201 3 ---  0F8 0 --- }
9801:      { 202 3 ---  208 3 ---  0F8 0 ---  209 3 --- }
9802:      { 203 3 ---  20A 3 ---  204 3 ---  20B 3 --- }
9803:      { 205 0 ---  20C 0 ---  206 0 ---  20D 3 --- }
9804:      { 0F8 0 ---  0F8 0 ---  201 3 ---  20E 3 --- }
9805:      { 20F 3 ---  0F8 0 ---  0F8 0 ---  211 3 --- }
9806:      { 0F8 0 ---  212 3 ---  0F8 0 ---  213 3 --- }
9807:      { 0F8 0 ---  214 3 ---  210 3 ---  0F8 0 --- }
9808:      { 0F8 0 ---  0F8 0 ---  0F8 0 ---  211 3 --- }
9809:      { 0F8 0 ---  0F8 0 ---  215 3 ---  0F8 0 --- }
980A:      { 216 3 ---  0F8 0 ---  0F8 0 ---  213 3 --- }
980B:      { 200 3 ---  0F8 0 ---  201 3 ---  0F8 0 --- }
980C:      { 0F8 0 ---  208 3 ---  0F8 0 ---  0F8 0 --- }
980D:      { 0F8 0 ---  207 3 ---  201 3 ---  0F8 0 --- }
980E:      { 202 3 ---  0F8 0 ---  0F8 0 ---  209 3 --- }
980F:      { 0F8 0 ---  214 3 ---  0F8 0 ---  211 3 --- }
9810:      { 216 3 ---  212 3 ---  0F8 0 ---  0F8 0 --- }
9811:      { 0F8 0 ---  0F8 0 ---  0F8 0 ---  202 3 --- }
9812:      { 217 3 ---  21F 3 ---  218 3 ---  220 3 --- }
9813:      { 219 3 ---  221 3 ---  21A 3 ---  222 3 --- }
9814:      { 21B 3 ---  223 3 ---  21C 3 ---  224 3 --- }
9815:      { 21D 3 ---  225 3 ---  21E 3 ---  226 3 --- }
9816:      { 227 3 ---  22F 3 ---  228 3 ---  230 3 --- }
9817:      { 229 3 ---  231 3 ---  22A 3 ---  232 3 --- }
9818:      { 22B 3 ---  233 3 ---  22C 3 ---  234 3 --- }
9819:      { 22D 3 ---  235 3 ---  22E 3 ---  236 3 --- }
981A:      { 237 3 ---  23F 3 ---  238 3 ---  240 3 --- }
981B:      { 239 3 ---  241 3 ---  23A 3 ---  242 3 --- }
981C:      { 23B 3 ---  243 3 ---  23C 3 ---  244 3 --- }
981D:      { 23D 3 ---  245 3 ---  23E 3 ---  246 3 --- }
981E:      { 247 3 ---  24F 3 ---  248 3 ---  250 3 --- }
981F:      { 249 3 ---  251 3 ---  24A 3 ---  252 3 --- }
9820:      { 24B 3 ---  253 3 ---  24C 3 ---  254 3 --- }
9821:      { 24D 3 ---  255 3 ---  24E 3 ---  256 3 --- }
9822:      { 257 3 ---  25F 3 ---  258 3 ---  260 3 --- }
9823:      { 259 3 ---  261 3 ---  25A 3 ---  262 3 --- }
9824:      { 25B 3 ---  263 3 ---  25C 3 ---  264 3 --- }
9825:      { 25D 3 ---  265 3 ---  25E 3 ---  266 3 --- }
9826: ~
9827: ~
9828: ~
9829: ~
982A: ~
982B: ~
982C: ~
982D: ~
982E: ~
982F: ~
9830:      { 17B 2 ---  20A 2 ---  17C 2 ---  20B 2 --- }
9831:      { 17D 2 ---  20C 2 ---  17E 2 ---  20D 2 --- }
9832:      { 155 2 ---  152 2 ---  152 2 ---  17D 2 --- }
9833:      { 152 2 ---  20E 2 ---  152 2 ---  20F 2 --- }
9834:      { 152 2 ---  210 2 ---  152 2 ---  211 2 --- }
9835:      { 152 2 ---  212 2 ---  152 2 ---  17D 2 --- }
9836:      { 17F 2 ---  20A 2 ---  200 2 ---  213 2 --- }
9837:      { 201 2 ---  214 2 ---  16C 2 ---  175 2 --- }
9838:      { 16C 2 ---  215 2 ---  16C 2 ---  216 2 --- }
9839:      { 202 2 ---  217 2 ---  174 2 ---  211 2 --- }
983A:      { 203 2 ---  17C 2 ---  204 2 ---  17D 2 --- }
983B:      { 205 2 ---  20E 2 ---  206 2 ---  20F 2 --- }
983C:      { 207 2 ---  210 2 ---  152 2 ---  211 2 --- }
983D:      { 152 2 ---  211 2 ---  152 2 ---  20F 2 --- }
983E:      { 208 2 ---  20A 2 ---  17C 2 ---  20B 2 --- }
983F:      { 17D 2 ---  20C 2 ---  209 2 ---  20D 2 --- }
9840:      { 218 2 ---  21C 2 ---  219 2 ---  21C 2 --- }
9841:      { 157 2 -y-  21C 2 ---  152 2 ---  21C 2 --- }
9842:      { 152 2 ---  21C 2 ---  21A 2 ---  21C 2 --- }
9843:      { 21B 2 ---  21C 2 ---  20B 2 ---  21C 2 --- }
9844:      { 21C 2 ---  21C 2 ---  21C 2 ---  21C 2 --- }
9845:      { 21D 2 ---  21C 2 ---  21E 2 ---  21C 2 --- }
9846:      { 152 2 ---  21C 2 ---  21F 2 ---  21C 2 --- }
9847:      { 20A 2 ---  21C 2 ---  15F 2 ---  21C 2 --- }
9848:      { 20C 2 ---  21C 2 ---  20D 2 ---  21C 2 --- }
9849:      { 100 2 ---  100 2 ---  100 2 ---  100 2 --- }
984A:      { 004 2 ---  004 2 ---  004 2 ---  004 2 --- }
984B:      { 004 2 ---  004 2 ---  004 2 ---  004 2 --- }
984C:      { 004 2 ---  004 2 ---  004 2 ---  004 2 --- }
984D:      { 004 2 ---  004 2 ---  004 2 ---  004 2 --- }
984E:      { 004 2 ---  004 2 ---  004 2 ---  004 2 --- }
984F:      { 004 2 ---  004 2 ---  004 2 ---  004 2 --- }
9850:      { 100 3 ---  100 3 ---  100 3 ---  100 3 --- }
9851:      { 100 3 -y-  100 3 -y-  101 3 -y-  102 3 -y- }
9852:      { 100 3 ---  105 3 ---  103 3 ---  106 3 --- }
9853:      { 100 3 -y-  107 3 -y-  104 3 -y-  108 3 -y- }
9854:      { 109 3 -y-  10D 3 -y-  10A 3 -y-  10E 3 -y- }
9855:      { 10B 3 -y-  10F 3 -y-  10C 3 -y-  110 3 -y- }
9856:      { 111 3 -y-  118 3 -y-  112 3 -y-  119 3 -y- }
9857:      { 113 3 -y-  11A 3 -y-  114 3 -y-  11B 3 -y- }
9858:      { 115 3 -y-  11C 3 -y-  116 3 -y-  116 3 -y- }
9859:      { 116 3 -y-  116 3 -y-  117 3 -y-  11D 3 -y- }
985A:      { 11E 3 -y-  116 3 -y-  11F 3 -y-  122 3 -y- }
985B:      { 120 3 -y-  123 3 -y-  116 3 -y-  116 3 -y- }
985C:      { 116 3 ---  116 3 ---  116 3 ---  116 3 --- }
985D:      { 116 3 -y-  116 3 -y-  121 3 -y-  124 3 -y- }
985E:      { 125 3 -y-  127 3 -y-  100 3 -y-  128 3 -y- }
985F:      { 126 3 -y-  129 3 -y-  116 3 -y-  116 3 -y- }
9860:      { 12A 3 xy-  12B 3 xy-  116 3 xy-  116 3 xy- }
9861:      { 116 3 ---  116 3 ---  124 3 ---  121 3 --- }
9862:      { 11C 3 ---  115 3 ---  116 3 ---  116 3 --- }
9863:      { 116 3 ---  11E 3 ---  122 3 ---  11F 3 --- }
9864:      { 129 3 ---  126 3 ---  116 3 ---  116 3 --- }
9865:      { 12B 3 x--  12A 3 x--  116 3 x--  116 3 x-- }
9866:      { 116 3 ---  116 3 ---  11D 3 ---  117 3 --- }
9867:      { 10D 3 ---  109 3 ---  10E 3 ---  10A 3 --- }
9868:      { 118 3 ---  111 3 ---  119 3 ---  112 3 --- }
9869:      { 123 3 ---  120 3 ---  116 3 ---  116 3 --- }
986A:      { 127 3 ---  125 3 ---  128 3 ---  100 3 --- }
986B:      { 10F 3 ---  10B 3 ---  110 3 ---  10C 3 --- }
986C:      { 107 3 ---  100 3 ---  108 3 ---  104 3 --- }
986D:      { 11A 3 ---  113 3 ---  11B 3 ---  114 3 --- }
986E:      { 100 3 ---  100 3 ---  102 3 ---  101 3 --- }
986F:      { 105 3 -y-  100 3 -y-  106 3 -y-  103 3 -y- }
9870:      { 100 5 x--  100 5 x--  100 5 x--  12E 5 x-- }
9871:      { 12C 5 ---  12F 5 ---  12D 5 ---  130 5 --- }
9872:      { 100 5 -y-  131 5 -y-  100 5 -y-  132 5 -y- }
9873:      { 100 5 ---  133 5 ---  100 5 ---  134 5 --- }
9874:      { 100 5 -y-  135 5 -y-  100 5 -y-  136 5 -y- }
9875:      { 100 5 ---  100 5 ---  100 5 ---  100 5 --- }
9876:      { 137 5 x--  141 5 x--  138 5 x--  142 5 x-- }
9877:      { 139 5 ---  143 5 ---  13A 5 ---  144 5 --- }
9878:      { 13B 5 ---  145 5 ---  13C 5 ---  146 5 --- }
9879:      { 100 5 xy-  147 5 xy-  100 5 xy-  148 5 xy- }
987A:      { 100 5 ---  149 5 ---  100 5 ---  14A 5 --- }
987B:      { 13D 5 ---  14B 5 ---  13E 5 ---  14C 5 --- }
987C:      { 13F 5 ---  14D 5 ---  140 5 ---  14E 5 --- }
987D:      { 14F 5 ---  15C 5 ---  150 5 ---  15D 5 --- }
987E:      { 151 5 ---  15E 5 ---  152 5 ---  15F 5 --- }
987F:      { 153 5 xy-  160 5 xy-  154 5 xy-  161 5 xy- }
9880:      { 155 5 ---  162 5 ---  100 5 ---  163 5 --- }
9881:      { 156 5 ---  164 5 ---  157 5 ---  165 5 --- }
9882:      { 158 5 ---  166 5 ---  159 5 ---  167 5 --- }
9883:      { 15A 5 ---  168 5 ---  15B 5 ---  169 5 --- }
9884:      { 16A 3 ---  176 3 ---  16B 3 ---  177 3 --- }
9885:      { 16C 3 ---  178 3 ---  16D 3 ---  179 3 --- }
9886:      { 16E 5 ---  17A 5 ---  16F 5 ---  17B 5 --- }
9887:      { 170 5 ---  17C 5 ---  171 5 ---  17D 5 --- }
9888:      { 172 5 ---  17E 5 ---  173 5 ---  17F 5 --- }
9889:      { 174 5 ---  200 5 ---  175 5 ---  100 5 --- }
988A:      { 201 3 ---  20F 3 ---  202 3 ---  210 3 --- }
988B:      { 203 3 ---  211 3 ---  204 3 ---  212 3 --- }
988C:      { 205 3 ---  213 3 ---  206 3 ---  214 3 --- }
988D:      { 207 5 ---  215 5 ---  208 5 ---  216 5 --- }
988E:      { 209 5 ---  217 5 ---  20A 5 ---  218 5 --- }
988F:      { 20B 5 ---  219 5 ---  20C 5 ---  21A 5 --- }
9890:      { 20D 3 ---  21B 3 ---  20E 3 ---  21C 3 --- }
9891:      { 21D 3 ---  22A 3 ---  21E 3 ---  22B 3 --- }
9892:      { 21F 3 ---  22C 3 ---  220 3 ---  22D 3 --- }
9893:      { 221 3 ---  100 3 ---  222 3 ---  22E 3 --- }
9894:      { 223 3 ---  22F 3 ---  224 3 ---  230 3 --- }
9895:      { 225 3 ---  231 3 ---  226 3 ---  232 3 --- }
9896:      { 227 3 ---  233 3 ---  100 3 ---  234 3 --- }
9897:      { 228 3 ---  235 3 ---  229 3 ---  236 3 --- }
9898:      { 237 3 ---  241 3 ---  238 3 ---  242 3 --- }
9899:      { 239 3 ---  243 3 ---  23A 3 ---  244 3 --- }
989A:      { 23B 3 -y-  245 3 -y-  23C 3 -y-  246 3 -y- }
989B:      { 23D 3 ---  247 3 ---  23E 3 ---  248 3 --- }
989C:      { 23F 3 ---  249 3 ---  240 3 ---  24A 3 --- }
989D:      { 24B 3 -y-  251 3 -y-  24C 3 -y-  252 3 -y- }
989E:      { 24D 3 ---  253 3 ---  24E 3 ---  254 3 --- }
989F:      { 24F 3 ---  255 3 ---  250 3 ---  256 3 --- }
98A0:      { 257 3 -y-  100 3 -y-  258 3 -y-  25B 3 -y- }
98A1:      { 259 3 ---  25C 3 ---  25A 3 ---  25D 3 --- }
98A2:      { 25E 3 ---  260 3 ---  25F 3 ---  261 3 --- }
98A3:      { 262 3 ---  264 3 ---  263 3 ---  265 3 --- }
98A4:      { 0F8 0 ---  0F8 0 ---  0F8 0 ---  0F8 0 --- }
98A5: ~
98A6: ~
98A7: ~
98A8: ~
98A9: ~
98AA: ~
98AB: ~
98AC: ~
98AD: ~
98AE: ~
98AF: ~
98B0: ~
98B1: ~
98B2: ~
98B3: ~
98B4: ~
98B5: ~
98B6: ~
98B7: ~
98B8: ~
98B9: ~
98BA: ~
98BB: ~
98BC: ~
98BD: ~
98BE: ~
98BF: ~
98C0: ~
98C1: ~
98C2: ~
98C3: ~
98C4: ~
98C5: ~
98C6: ~
98C7: ~
98C8: ~
98C9: ~
98CA: ~
98CB: ~
98CC: ~
98CD: ~
98CE: ~
98CF: ~
98D0: ~
98D1: ~
98D2: ~
98D3: ~
98D4: ~
98D5: ~
98D6: ~
98D7: ~
98D8: ~
98D9: ~
98DA: ~
98DB: ~
98DC: ~
98DD: ~
98DE: ~
98DF: ~
98E0: ~
98E1: ~
98E2: ~
98E3: ~
98E4: ~
98E5: ~
98E6: ~
98E7: ~
98E8: ~
98E9: ~
98EA: ~
98EB: ~
98EC: ~
98ED: ~
98EE: ~
98EF: ~
98F0: ~
98F1: ~
98F2: ~
98F3: ~
98F4: ~
98F5: ~
98F6: ~
98F7: ~
98F8: ~
98F9: ~
98FA: ~
98FB: ~
98FC: ~
98FD: ~
98FE: ~
98FF: ~
