8500:      { 205 3 ---  22C 3 ---  206 3 ---  229 3 x-- }
8501:      { 209 3 ---  22D 3 ---  20A 3 ---  22E 3 --- }
8502:      { 20B 3 ---  20B 3 ---  20C 3 ---  20C 3 --- }
8503:      { 20E 3 ---  22F 3 ---  20F 3 ---  230 3 --- }
8504:      { 213 3 ---  231 3 ---  214 3 ---  232 3 --- }
8505:      { 215 3 ---  233 3 ---  216 3 ---  257 3 --- }
8506:      { 20E 3 x--  235 3 ---  217 3 ---  217 3 -y- }
8507:      { 219 3 ---  236 3 ---  21A 3 ---  237 3 --- }
8508:      { 21B 3 ---  238 3 ---  21C 3 ---  22C 3 --- }
8509:      { 21E 3 ---  239 3 ---  21F 3 ---  23A 3 --- }
850A:      { 276 3 ---  23C 3 ---  277 3 ---  23D 3 --- }
850B:      { 226 3 ---  227 3 x--  227 3 ---  23F 3 --- }
850C:      { 20C 3 x--  20C 3 x--  20B 3 x--  20B 3 x-- }
850D:      { 20A 3 x--  22E 3 x--  209 3 x--  22D 3 x-- }
850E:      { 228 3 ---  240 3 ---  229 3 ---  241 3 --- }
850F:      { 22A 3 ---  21C 3 x--  22B 3 ---  242 3 --- }
8510:      { 243 3 ---  21A 3 x--  206 3 x--  256 3 --- }
8511:      { 244 3 ---  258 3 ---  245 3 ---  259 3 --- }
8512:      { 246 3 ---  20B 3 ---  247 3 ---  25E 3 --- }
8513:      { 248 3 ---  20E 3 ---  249 3 ---  25F 3 --- }
8514:      { 230 3 xy-  233 3 x--  24A 3 ---  260 3 --- }
8515:      { 230 3 ---  233 3 ---  24B 3 ---  230 3 --- }
8516:      { 248 3 x--  261 3 ---  24C 3 ---  262 3 --- }
8517:      { 24D 3 ---  263 3 ---  24E 3 ---  24E 3 -y- }
8518:      { 20C 3 x--  264 3 ---  22C 3 ---  254 3 xy- }
8519:      { 24F 3 ---  23A 3 ---  250 3 ---  265 3 --- }
851A:      { 251 3 ---  266 3 ---  252 3 ---  267 3 --- }
851B:      { 23F 3 xy-  268 3 ---  253 3 ---  269 3 --- }
851C:      { 247 3 x--  25E 3 x--  246 3 x--  20B 3 x-- }
851D:      { 245 3 x--  259 3 x--  244 3 x--  258 3 x-- }
851E:      { 228 3 -y-  26E 3 ---  240 3 x--  241 3 -y- }
851F:      { 254 3 ---  26F 3 ---  255 3 ---  21B 3 x-- }
8520:      { 271 3 ---  103 3 ---  272 3 ---  256 3 --- }
8521:      { 273 3 ---  104 3 ---  274 3 ---  239 3 x-- }
8522:      { 275 3 ---  20B 3 ---  279 3 ---  105 3 --- }
8523:      { 248 3 ---  22F 3 ---  233 3 ---  27A 3 --- }
8524:      { 27A 3 ---  27A 3 ---  27B 3 ---  249 3 --- }
8525:      { 27A 3 ---  106 3 ---  233 3 x--  106 3 --- }
8526:      { 27C 3 ---  107 3 ---  27D 3 ---  27D 3 --- }
8527:      { 27E 3 ---  108 3 ---  205 3 x--  22C 3 x-- }
8528:      { 22B 3 x--  242 3 x--  22A 3 x--  21C 3 --- }
8529:      { 280 3 ---  109 3 ---  101 3 ---  265 3 x-- }
852A:      { 23C 3 -y-  23C 3 ---  277 3 ---  277 3 --- }
852B:      { 269 3 x--  10A 3 ---  269 3 ---  10B 3 --- }
852C:      { 279 3 x--  105 3 x--  275 3 x--  20B 3 x-- }
852D:      { 274 3 x--  239 3 ---  273 3 x--  104 3 x-- }
852E:      { 272 3 x--  10C 3 ---  102 3 ---  241 3 --- }
852F:      { 22C 3 x--  22C 3 x--  264 3 x--  10D 3 --- }
8530:      { 10E 3 ---  237 3 x--  272 3 x--  256 3 --- }
8531:      { 10F 3 ---  239 3 ---  110 3 ---  11F 3 --- }
8532:      { 25E 3 x--  279 3 x--  111 3 ---  275 3 x-- }
8533:      { 112 3 ---  261 3 x--  113 3 ---  230 3 --- }
8534:      { 114 3 ---  27A 3 ---  25F 3 ---  27B 3 -y- }
8535:      { 20F 3 ---  233 3 xy-  213 3 ---  263 3 --- }
8536:      { 115 3 ---  24C 3 x--  262 3 -y-  217 3 --- }
8537:      { 116 3 ---  219 3 ---  243 3 x--  21A 3 --- }
8538:      { 255 3 x--  21B 3 ---  254 3 x--  26F 3 x-- }
8539:      { 23A 3 -y-  120 3 ---  101 3 ---  121 3 --- }
853A:      { 117 3 ---  280 3 ---  118 3 ---  122 3 --- }
853B:      { 119 3 ---  123 3 ---  11A 3 ---  124 3 --- }
853C:      { 111 3 x--  275 3 ---  25E 3 ---  279 3 --- }
853D:      { 110 3 x--  125 3 ---  10F 3 x--  239 3 x-- }
853E:      { 11B 3 ---  10C 3 ---  11C 3 ---  126 3 --- }
853F:      { 11D 3 ---  127 3 ---  11E 3 ---  128 3 --- }
8540:      { 24E 3 x--  24E 3 x--  206 3 x--  10C 3 --- }
8541:      { 129 3 ---  260 3 ---  12A 3 ---  133 3 --- }
8542:      { 105 3 x--  20B 3 ---  25E 3 ---  279 3 --- }
8543:      { 261 3 xy-  261 3 x--  27B 3 ---  249 3 --- }
8544:      { 27A 3 ---  233 3 xy-  27B 3 ---  263 3 --- }
8545:      { 27E 3 ---  134 3 ---  12B 3 ---  24D 3 x-- }
8546:      { 12C 3 ---  135 3 ---  12D 3 ---  12D 3 -y- }
8547:      { 116 3 ---  116 3 ---  271 3 x--  103 3 x-- }
8548:      { 264 3 ---  10D 3 x--  22C 3 ---  22C 3 --- }
8549:      { 239 3 x--  11F 3 ---  21E 3 ---  11F 3 --- }
854A:      { 21F 3 ---  136 3 ---  12E 3 ---  137 3 --- }
854B:      { 12F 3 ---  138 3 ---  130 3 ---  139 3 --- }
854C:      { 25E 3 x--  279 3 x--  105 3 ---  20B 3 x-- }
854D:      { 12A 3 x--  133 3 x--  129 3 x--  260 3 x-- }
854E:      { 26E 3 ---  272 3 x--  11C 3 -y-  102 3 --- }
854F:      { 131 3 ---  13A 3 ---  132 3 ---  13B 3 --- }
8550:      { 13C 3 ---  14C 3 ---  206 3 ---  10C 3 --- }
8551:      { 13D 3 ---  108 3 x--  13E 3 ---  14D 3 --- }
8552:      { 20B 3 ---  14E 3 ---  105 3 ---  14F 3 --- }
8553:      { 261 3 x--  20E 3 ---  25F 3 ---  216 3 x-- }
8554:      { 13F 3 ---  215 3 x--  140 3 ---  214 3 x-- }
8555:      { 141 3 ---  150 3 ---  233 3 x--  151 3 --- }
8556:      { 12C 3 ---  152 3 ---  142 3 ---  153 3 --- }
8557:      { 236 3 ---  154 3 ---  10E 3 x--  237 3 --- }
8558:      { 11E 3 x--  128 3 x--  11D 3 x--  127 3 x-- }
8559:      { 143 3 ---  155 3 ---  144 3 ---  156 3 --- }
855A:      { 145 3 ---  157 3 ---  146 3 ---  158 3 --- }
855B:      { 147 3 ---  159 3 ---  148 3 ---  15A 3 --- }
855C:      { 279 3 x--  14F 3 x--  20B 3 x--  14E 3 x-- }
855D:      { 13E 3 x--  14D 3 ---  13D 3 x--  108 3 --- }
855E:      { 149 3 ---  27A 3 ---  14A 3 ---  102 3 --- }
855F:      { 14B 3 ---  15B 3 ---  238 3 x--  20C 3 --- }
8560:      { 15C 3 ---  261 3 xy-  15D 3 ---  11B 3 --- }
8561:      { 15E 3 ---  167 3 ---  12B 3 -y-  168 3 --- }
8562:      { 15F 3 ---  169 3 ---  160 3 ---  16A 3 --- }
8563:      { 235 3 x--  248 3 ---  257 3 x--  24B 3 x-- }
8564:      { 233 3 x--  230 3 x--  232 3 x--  24A 3 x-- }
8565:      { 263 3 -y-  263 3 x--  161 3 ---  16B 3 --- }
8566:      { 115 3 ---  16C 3 ---  153 3 -y-  153 3 -y- }
8567:      { 162 3 ---  16D 3 ---  24E 3 ---  24E 3 --- }
8568:      { 132 3 x--  13B 3 x--  131 3 x--  13A 3 x-- }
8569:      { 163 3 ---  125 3 ---  11F 3 ---  11F 3 --- }
856A:      { 24F 3 ---  11F 3 ---  12E 3 ---  16E 3 --- }
856B:      { 164 3 ---  16F 3 ---  11E 3 -y-  170 3 --- }
856C:      { 160 3 x--  16A 3 x--  15F 3 x--  169 3 x-- }
856D:      { 12B 3 xy-  168 3 x--  15E 3 x--  167 3 x-- }
856E:      { 27A 3 ---  27A 3 ---  14A 3 ---  171 3 --- }
856F:      { 165 3 ---  170 3 ---  166 3 ---  166 3 --- }
8570:      { 238 3 x--  20C 3 ---  279 3 x--  275 3 --- }
8571:      { 172 3 ---  13A 3 x--  173 3 ---  13A 3 --- }
8572:      { 174 3 ---  17A 3 ---  175 3 ---  275 3 x-- }
8573:      { 27C 3 xy-  22F 3 ---  24B 3 x--  24B 3 x-- }
8574:      { 231 3 ---  14A 3 ---  154 3 ---  162 3 --- }
8575:      { 172 3 x--  17B 3 ---  176 3 ---  213 3 --- }
8576:      { 22F 3 ---  135 3 ---  177 3 ---  10C 3 xy- }
8577:      { 154 3 ---  134 3 ---  13C 3 x--  139 3 --- }
8578:      { 238 3 ---  13B 3 x--  14B 3 x--  15B 3 x-- }
8579:      { 154 3 ---  134 3 x--  239 3 x--  11F 3 --- }
857A:      { 104 3 xy-  138 3 xy-  233 3 ---  27A 3 --- }
857B:      { 139 3 x--  17C 3 ---  178 3 ---  178 3 --- }
857C:      { 175 3 x--  275 3 ---  174 3 x--  17A 3 x-- }
857D:      { 173 3 x--  13A 3 x--  172 3 x--  17B 3 --- }
857E:      { 149 3 ---  27A 3 ---  102 3 ---  233 3 x-- }
857F:      { 179 3 ---  20C 3 x--  166 3 ---  166 3 --- }
8580:      { 132 3 ---  105 3 -y-  275 3 ---  25E 3 x-- }
8581:      { 14B 3 x--  15B 3 x--  14B 3 ---  15B 3 --- }
8582:      { 17D 3 ---  275 3 x--  25E 3 ---  279 3 --- }
8583:      { 27C 3 xy-  248 3 ---  24B 3 x--  106 3 --- }
8584:      { 171 3 ---  171 3 ---  134 3 ---  154 3 --- }
8585:      { 172 3 x--  162 3 ---  233 3 x--  161 3 --- }
8586:      { 12C 3 ---  152 3 ---  14F 3 xy-  279 3 x-- }
8587:      { 138 3 -y-  14B 3 x--  17C 3 x--  102 3 x-- }
8588:      { 238 3 ---  279 3 x--  165 3 x--  17E 3 --- }
8589:      { 254 3 ---  237 3 ---  104 3 -y-  138 3 -y- }
858A:      { 237 3 ---  237 3 -y-  149 3 ---  27A 3 --- }
858B:      { 102 3 ---  106 3 ---  229 3 x--  10C 3 -y- }
858C:      { 20C 3 ---  279 3 x--  17D 3 x--  275 3 --- }
858D:      { 14B 3 x--  15B 3 x--  172 3 x--  167 3 x-- }
858E:      { 27A 3 ---  27A 3 ---  27A 3 ---  149 3 --- }
858F:      { 105 3 x--  275 3 ---  17D 3 ---  17F 3 --- }
8590:      { 165 3 x--  105 3 -y-  165 3 ---  105 3 xy- }
8591:      { 105 3 ---  275 3 x--  275 3 x--  17F 3 --- }
8592:      { 22F 3 ---  27C 3 xy-  149 3 ---  24B 3 x-- }
8593:      { 16B 3 x--  16E 3 x--  134 3 ---  154 3 -y- }
8594:      { 172 3 xy-  172 3 x--  16B 3 ---  149 3 --- }
8595:      { 152 3 -y-  22F 3 ---  13B 3 x--  275 3 --- }
8596:      { 15B 3 x--  165 3 x--  178 3 ---  229 3 x-- }
8597:      { 275 3 ---  25E 3 x--  105 3 -y-  105 3 --- }
8598:      { 173 3 x--  13A 3 x--  138 3 ---  236 3 --- }
8599:      { 16F 3 x--  139 3 ---  27A 3 ---  27A 3 --- }
859A:      { 149 3 x--  24B 3 ---  22F 3 x--  27C 3 -y- }
859B:      { 275 3 ---  17F 3 x--  105 3 x--  275 3 --- }
859C:      { 165 3 x--  105 3 -y-  16B 3 ---  149 3 --- }
859D:      { 275 3 ---  17F 3 x--  17F 3 ---  279 3 --- }
859E:      { 166 3 ---  166 3 ---  279 3 ---  111 3 -y- }
859F:      { 17F 3 x--  238 3 ---  166 3 ---  166 3 --- }
85A0:      { 275 3 xy-  279 3 ---  279 3 ---  111 3 --- }
85A1:      { 248 3 ---  22F 3 ---  106 3 ---  22F 3 x-- }
85A2:      { 233 3 x--  176 3 x--  24A 3 xy-  27E 3 -y- }
85A3:      { 17B 3 ---  16B 3 ---  27A 3 ---  27A 3 --- }
85A4:      { 261 3 -y-  13B 3 xy-  166 3 ---  166 3 --- }
85A5:      { 17E 3 ---  175 3 ---  10C 3 -y-  279 3 x-- }
85A6:      { 279 3 x--  279 3 xy-  111 3 x--  105 3 x-- }
85A7:      { 14B 3 x--  15B 3 x--  162 3 x--  27E 3 xy- }
85A8:      { 17C 3 x--  16B 3 ---  27A 3 ---  149 3 x-- }
85A9:      { 106 3 x--  149 3 x--  248 3 x--  22F 3 x-- }
85AA:      { 279 3 x--  111 3 xy-  166 3 ---  166 3 --- }
85AB:      { 166 3 ---  166 3 ---  261 3 xy-  238 3 x-- }
85AC:      { 106 3 x--  22F 3 -y-  248 3 x--  13B 3 xy- }
85AD:      { 279 3 x--  166 3 ---  166 3 ---  166 3 --- }
85AE:      { 166 3 ---  166 3 ---  111 3 ---  166 3 --- }
85AF:      { 275 3 ---  166 3 ---  166 3 ---  166 3 --- }
85B0:      { 166 3 ---  166 3 ---  166 3 ---  166 3 --- }
85B1:      { 17F 3 -y-  105 3 -y-  175 3 xy-  13B 3 xy- }
85B2:      { 14F 3 xy-  111 3 ---  176 3 x--  14F 3 xy- }
85B3:      { 12C 3 ---  16A 3 -y-  22F 3 x--  238 3 --- }
85B4:      { 275 3 ---  111 3 x--  166 3 ---  166 3 --- }
85B5:      { 279 3 ---  166 3 ---  275 3 ---  17F 3 --- }
85B6:      { 279 3 ---  275 3 ---  111 3 x--  166 3 --- }
85B7:      { 12C 3 ---  16A 3 -y-  16A 3 xy-  166 3 --- }
85B8:      { 176 3 x--  175 3 -y-  13B 3 xy-  17F 3 xy- }
85B9:      { 111 3 x--  166 3 ---  166 3 ---  166 3 --- }
85BA:      { 166 3 ---  166 3 ---  105 3 -y-  166 3 --- }
85BB:      { 16A 3 -y-  166 3 ---  105 3 xy-  166 3 --- }
85BC:      { 166 3 ---  166 3 ---  275 3 ---  166 3 --- }
85BD:      { 166 3 ---  166 3 ---  279 3 ---  166 3 --- }
85BE:      { 13B 3 -y-  166 3 ---  105 3 xy-  166 3 --- }
85BF: ~
85C0: ~
85C1: ~
85C2: ~
85C3: ~
85C4: ~
85C5: ~
85C6: ~
85C7: ~
85C8: ~
85C9: ~
85CA: ~
85CB: ~
85CC: ~
85CD: ~
85CE: ~
85CF: ~
85D0: ~
85D1: ~
85D2: ~
85D3: ~
85D4: ~
85D5: ~
85D6: ~
85D7: ~
85D8: ~
85D9: ~
85DA: ~
85DB: ~
85DC: ~
85DD: ~
85DE: ~
85DF: ~
85E0: ~
85E1: ~
85E2: ~
85E3: ~
85E4: ~
85E5: ~
85E6: ~
85E7: ~
85E8: ~
85E9: ~
85EA: ~
85EB: ~
85EC: ~
85ED: ~
85EE: ~
85EF: ~
85F0: ~
85F1: ~
85F2: ~
85F3: ~
85F4: ~
85F5: ~
85F6: ~
85F7: ~
85F8: ~
85F9: ~
85FA: ~
85FB: ~
85FC: ~
85FD: ~
85FE: ~
85FF: ~
