9400:      { 100 3 ---  119 3 ---  101 3 ---  116 3 -y- }
9401:      { 102 3 ---  11A 3 ---  103 3 ---  11A 3 x-- }
9402:      { 104 3 ---  11B 3 ---  105 3 ---  105 3 xy- }
9403:      { 106 3 ---  105 3 xy-  107 3 ---  11C 3 --- }
9404:      { 108 3 ---  11A 3 ---  109 3 ---  11D 3 --- }
9405:      { 10A 3 ---  11E 3 ---  10B 5 ---  11F 5 --- }
9406:      { 10C 5 ---  120 5 ---  10D 5 ---  121 5 --- }
9407:      { 10E 5 ---  10F 5 x--  10F 5 ---  10E 5 x-- }
9408:      { 10F 5 ---  122 5 ---  10F 5 ---  122 5 --- }
9409:      { 10D 5 x--  10E 5 -y-  110 5 ---  10F 5 x-- }
940A:      { 111 3 ---  123 3 ---  112 3 ---  124 5 --- }
940B:      { 113 3 ---  125 5 ---  114 3 ---  113 3 --- }
940C:      { 115 3 ---  114 3 ---  115 3 xy-  126 3 --- }
940D:      { 116 3 ---  127 3 ---  103 3 ---  128 3 --- }
940E:      { 117 3 ---  129 3 ---  118 3 ---  12A 3 --- }
940F:      { 105 3 ---  105 3 xy-  106 3 ---  12B 3 --- }
9410:      { 12C 3 ---  142 3 ---  105 3 xy-  143 3 --- }
9411:      { 11B 3 ---  142 3 ---  12D 3 ---  144 3 --- }
9412:      { 12E 3 ---  145 3 ---  12F 3 ---  125 5 --- }
9413:      { 12E 3 ---  125 5 ---  12F 3 ---  145 3 --- }
9414:      { 130 3 ---  146 3 ---  131 3 ---  114 3 --- }
9415:      { 132 3 ---  115 3 ---  133 5 ---  147 3 --- }
9416:      { 134 5 ---  148 3 ---  135 3 ---  149 3 --- }
9417:      { 10E 5 x--  121 5 ---  136 5 ---  136 5 --- }
9418:      { 137 5 ---  138 5 ---  138 5 ---  138 5 xy- }
9419:      { 139 5 ---  14A 5 ---  13A 5 ---  14B 3 --- }
941A:      { 13B 5 ---  10D 5 x--  110 5 -y-  14C 5 --- }
941B:      { 125 5 ---  14C 5 x--  125 5 ---  124 5 --- }
941C:      { 113 3 ---  125 5 ---  13C 3 ---  14D 3 --- }
941D:      { 13D 3 ---  13E 3 -y-  13E 3 ---  14E 3 --- }
941E:      { 13F 3 ---  14F 3 ---  103 3 x--  150 3 --- }
941F:      { 140 3 ---  105 3 xy-  141 3 ---  142 3 --- }
9420:      { 12D 3 xy-  116 3 ---  151 3 ---  133 5 --- }
9421:      { 152 3 ---  160 3 ---  153 3 ---  161 5 --- }
9422:      { 154 3 ---  162 5 ---  125 5 ---  163 3 --- }
9423:      { 125 5 ---  111 3 x--  111 3 ---  123 3 --- }
9424:      { 145 3 ---  125 5 ---  113 3 ---  125 5 --- }
9425:      { 126 3 ---  114 3 ---  132 3 x--  164 3 --- }
9426:      { 155 3 ---  165 3 ---  148 3 ---  100 3 --- }
9427:      { 135 3 ---  116 3 ---  156 5 ---  115 3 -y- }
9428:      { 138 5 xy-  166 3 ---  157 5 ---  166 3 --- }
9429:      { 158 5 ---  165 3 ---  115 3 xy-  167 3 --- }
942A:      { 159 5 ---  164 3 ---  15A 3 ---  127 3 --- }
942B:      { 15B 3 ---  155 3 -y-  15C 3 ---  114 3 x-- }
942C:      { 15D 3 ---  15E 3 ---  15E 3 ---  168 3 --- }
942D:      { 128 3 -y-  101 3 xy-  15F 3 ---  169 3 --- }
942E:      { 101 3 xy-  16A 3 ---  12C 3 ---  16B 3 --- }
942F:      { 143 3 x--  12C 3 ---  143 3 x--  12D 3 xy- }
9430:      { 16C 3 ---  172 3 ---  165 3 -y-  155 3 -y- }
9431:      { 16D 5 ---  10B 5 ---  16E 5 ---  10C 5 --- }
9432:      { 16F 5 ---  174 5 ---  170 5 ---  175 5 --- }
9433:      { 123 3 x--  13B 5 x--  13B 5 ---  10D 5 x-- }
9434:      { 111 3 ---  123 3 ---  125 5 ---  124 5 --- }
9435:      { 171 3 ---  176 3 ---  172 3 ---  16C 3 --- }
9436:      { 147 3 ---  177 3 ---  119 3 ---  178 3 --- }
9437:      { 127 3 ---  172 3 ---  167 3 ---  16C 3 x-- }
9438:      { 164 3 ---  140 3 ---  164 3 ---  172 3 --- }
9439:      { 127 3 ---  147 3 ---  128 3 ---  13E 3 --- }
943A:      { 129 3 ---  13F 3 ---  11E 3 -y-  10A 3 -y- }
943B:      { 105 3 x--  114 3 x--  113 3 xy-  113 3 x-- }
943C:      { 15D 3 xy-  179 3 ---  105 3 x--  17A 3 --- }
943D:      { 105 3 xy-  17B 3 ---  16A 3 ---  17C 3 --- }
943E:      { 102 3 xy-  117 3 x--  101 3 xy-  130 3 --- }
943F:      { 16B 3 ---  17D 3 ---  173 3 ---  17E 3 --- }
9440:      { 109 3 ---  206 3 ---  148 3 x--  13C 3 --- }
9441:      { 11F 5 ---  207 5 ---  120 5 ---  134 5 --- }
9442:      { 121 5 ---  135 3 ---  10E 5 ---  10E 5 x-- }
9443:      { 10D 5 ---  10F 5 ---  10F 5 ---  208 5 --- }
9444:      { 13B 5 ---  10D 5 x--  17F 5 ---  15E 3 --- }
9445:      { 200 3 ---  11D 3 ---  140 3 ---  16C 3 --- }
9446:      { 201 3 ---  155 3 ---  202 3 ---  172 3 --- }
9447:      { 100 3 x--  119 3 x--  131 3 ---  172 3 --- }
9448:      { 16C 3 x--  150 3 ---  114 3 x--  143 3 --- }
9449:      { 13E 3 -y-  128 3 -y-  14E 3 ---  15F 3 --- }
944A:      { 14F 3 ---  105 3 -y-  150 3 ---  209 3 --- }
944B:      { 143 3 ---  105 3 x--  113 3 xy-  105 3 x-- }
944C:      { 203 3 ---  113 3 xy-  204 3 ---  179 3 -y- }
944D:      { 17A 3 ---  20A 3 ---  118 3 ---  20B 3 --- }
944E:      { 205 3 ---  15D 3 ---  12E 3 ---  20C 3 --- }
944F:      { 130 3 ---  118 3 ---  11E 3 xy-  130 3 --- }
9450:      { 20D 3 ---  12D 3 -y-  14D 3 ---  212 3 --- }
9451:      { 11D 3 ---  131 3 ---  148 3 ---  155 3 --- }
9452:      { 149 3 ---  213 3 ---  16E 5 ---  10C 5 --- }
9453:      { 10F 5 ---  136 5 ---  10F 5 ---  122 5 --- }
9454:      { 10E 5 -y-  17F 5 ---  176 3 ---  176 3 --- }
9455:      { 116 3 ---  140 3 ---  126 3 ---  155 3 xy- }
9456:      { 165 3 ---  172 3 ---  20E 3 ---  15F 3 --- }
9457:      { 20F 3 ---  214 3 ---  114 3 x--  143 3 --- }
9458:      { 105 3 -y-  12D 3 xy-  105 3 x--  116 3 --- }
9459:      { 101 3 xy-  116 3 ---  169 3 ---  105 3 x-- }
945A:      { 143 3 x--  151 3 ---  12D 3 xy-  152 3 --- }
945B:      { 116 3 ---  114 3 x--  210 3 ---  215 3 --- }
945C:      { 118 3 x--  125 5 ---  112 3 -y-  125 5 --- }
945D:      { 179 3 -y-  179 3 -y-  20A 3 ---  179 3 --- }
945E:      { 211 3 ---  17A 3 ---  113 3 xy-  17B 3 --- }
945F:      { 203 3 x--  113 3 -y-  113 3 -y-  176 3 --- }
9460:      { 11B 3 ---  15E 3 ---  216 3 ---  11E 3 --- }
9461:      { 131 3 -y-  131 3 ---  115 3 xy-  165 3 --- }
9462:      { 116 3 ---  16C 3 x--  120 5 ---  21B 5 --- }
9463:      { 138 5 -y-  21C 5 ---  137 5 ---  17F 5 --- }
9464:      { 217 5 ---  176 3 ---  129 3 x--  13F 3 x-- }
9465:      { 128 3 x--  13E 3 x--  150 3 x--  116 3 --- }
9466:      { 150 3 x--  116 3 -y-  148 3 x--  150 3 x-- }
9467:      { 140 3 ---  116 3 ---  105 3 x--  21D 3 --- }
9468:      { 151 3 ---  21E 3 ---  218 3 ---  21F 3 --- }
9469:      { 105 3 -y-  220 3 ---  114 3 x--  215 3 --- }
946A:      { 12F 3 ---  111 3 ---  219 3 ---  20A 3 --- }
946B:      { 153 3 ---  212 3 ---  21A 3 ---  14C 5 x-- }
946C:      { 125 5 ---  221 5 ---  111 3 ---  123 3 --- }
946D:      { 112 3 -y-  179 3 -y-  179 3 xy-  222 3 --- }
946E:      { 17A 3 ---  20A 3 ---  211 3 ---  113 3 --- }
946F:      { 118 3 ---  219 3 ---  105 3 x--  17C 3 --- }
9470:      { 176 3 ---  105 3 -y-  109 3 ---  22B 3 --- }
9471:      { 172 3 ---  150 3 ---  147 3 ---  22C 5 --- }
9472:      { 105 3 xy-  121 5 -y-  223 3 ---  22D 3 --- }
9473:      { 224 5 ---  22E 5 ---  225 5 ---  176 3 --- }
9474:      { 200 3 ---  22F 3 ---  14F 3 x--  230 3 --- }
9475:      { 14E 3 ---  15F 3 ---  172 3 ---  114 3 x-- }
9476:      { 101 3 ---  21D 3 ---  12D 3 ---  21E 3 --- }
9477:      { 105 3 -y-  220 3 ---  226 3 ---  231 3 --- }
9478:      { 227 3 ---  232 3 ---  21F 3 -y-  21F 3 --- }
9479:      { 228 3 ---  233 3 ---  21A 3 ---  154 3 --- }
947A:      { 123 3 ---  13B 5 ---  179 3 -y-  124 5 --- }
947B:      { 229 3 ---  229 3 ---  124 5 x--  10F 5 -y- }
947C:      { 22A 5 ---  234 5 ---  13B 5 ---  10D 5 x-- }
947D:      { 14C 5 ---  124 5 ---  179 3 xy-  179 3 -y- }
947E:      { 179 3 ---  222 3 ---  203 3 xy-  222 3 x-- }
947F:      { 113 3 ---  179 3 ---  118 3 ---  113 3 --- }
9480:      { 235 3 ---  105 3 x--  150 3 x--  23F 3 --- }
9481:      { 236 3 ---  240 3 ---  237 5 ---  241 3 --- }
9482:      { 174 5 -y-  242 5 ---  238 3 ---  243 3 --- }
9483:      { 239 3 ---  12B 3 ---  12B 3 ---  100 3 --- }
9484:      { 116 3 ---  244 3 ---  23A 3 ---  245 3 --- }
9485:      { 169 3 ---  114 3 x--  143 3 ---  12F 3 --- }
9486:      { 226 3 ---  231 3 ---  227 3 ---  232 3 --- }
9487:      { 228 3 ---  233 3 ---  21F 3 -y-  218 3 -y- }
9488:      { 23B 3 ---  246 3 ---  160 3 ---  16D 5 --- }
9489:      { 161 5 ---  16E 5 ---  162 5 ---  16F 5 --- }
948A:      { 10D 5 x--  10E 5 xy-  122 5 ---  139 5 --- }
948B:      { 23C 3 ---  247 3 ---  208 5 ---  248 5 --- }
948C:      { 23D 5 ---  136 5 x--  10E 5 -y-  137 5 xy- }
948D:      { 23E 5 ---  122 5 ---  110 5 ---  10E 5 --- }
948E:      { 179 3 -y-  249 3 ---  222 3 x--  179 3 --- }
948F:      { 146 3 ---  112 3 xy-  113 3 -y-  15D 3 xy- }
9490:      { 210 3 -y-  257 3 ---  24A 3 ---  113 3 --- }
9491:      { 24B 3 ---  105 3 -y-  216 3 ---  106 3 -y- }
9492:      { 24C 3 ---  107 3 -y-  24D 3 ---  101 3 -y- }
9493:      { 155 3 -y-  258 3 ---  119 3 ---  259 3 --- }
9494:      { 155 3 -y-  25A 3 ---  24E 3 ---  12B 3 x-- }
9495:      { 151 3 ---  133 5 ---  111 3 ---  151 3 --- }
9496:      { 21F 3 -y-  218 3 -y-  23B 3 ---  246 3 --- }
9497:      { 24F 5 ---  25B 5 ---  250 5 ---  25C 3 --- }
9498:      { 251 5 ---  25D 5 ---  10B 5 ---  11F 5 --- }
9499:      { 10C 5 ---  120 5 ---  174 5 ---  121 5 --- }
949A:      { 10E 5 x--  23E 5 ---  14A 5 ---  217 5 --- }
949B:      { 252 3 ---  240 3 ---  253 5 ---  25E 3 --- }
949C:      { 254 5 ---  25F 5 ---  10E 5 ---  10E 5 -y- }
949D:      { 10F 5 -y-  208 5 ---  10F 5 -y-  10F 5 -y- }
949E:      { 255 3 ---  255 3 ---  222 3 x--  222 3 xy- }
949F:      { 222 3 x--  179 3 -y-  256 3 ---  146 3 --- }
94A0:      { 260 3 ---  265 3 ---  112 3 -y-  222 3 x-- }
94A1:      { 113 3 ---  203 3 xy-  105 3 -y-  113 3 --- }
94A2:      { 140 3 x--  266 3 ---  116 3 ---  150 3 xy- }
94A3:      { 261 3 ---  267 3 ---  172 3 ---  263 3 --- }
94A4:      { 109 3 x--  150 3 x--  108 3 x--  24E 3 x-- }
94A5:      { 262 3 ---  22B 3 ---  105 3 x--  116 3 x-- }
94A6:      { 16C 3 ---  11D 3 xy-  100 3 ---  119 3 --- }
94A7:      { 263 3 ---  10A 3 ---  116 3 x--  268 3 --- }
94A8:      { 133 5 ---  262 3 ---  207 5 ---  10A 3 --- }
94A9:      { 134 5 ---  107 3 ---  135 3 ---  135 3 --- }
94AA:      { 10E 5 -y-  242 5 ---  24A 3 ---  113 3 xy- }
94AB:      { 24B 3 ---  15D 3 xy-  216 3 ---  14D 3 --- }
94AC:      { 264 5 ---  135 3 ---  10F 5 -y-  269 5 --- }
94AD:      { 10F 5 x--  254 5 ---  10E 5 -y-  110 5 -y- }
94AE:      { 249 3 -y-  179 3 -y-  222 3 x--  222 3 x-- }
94AF:      { 203 3 xy-  146 3 ---  113 3 -y-  26A 3 --- }
94B0:      { 179 3 xy-  113 3 -y-  112 3 ---  26B 3 --- }
94B1:      { 179 3 xy-  15D 3 ---  113 3 -y-  15E 3 --- }
94B2:      { 114 3 -y-  105 3 x--  10A 3 x--  11E 3 x-- }
94B3:      { 116 3 ---  14E 3 -y-  268 3 ---  116 3 --- }
94B4:      { 11E 3 ---  17E 3 ---  17D 3 ---  12B 3 --- }
94B5:      { 155 3 -y-  25A 3 x--  209 3 ---  26E 3 --- }
94B6:      { 258 3 ---  26F 3 ---  261 3 ---  105 3 xy- }
94B7:      { 22B 3 ---  12D 3 x--  116 3 ---  105 3 -y- }
94B8:      { 10A 3 x--  106 3 -y-  209 3 x--  116 3 --- }
94B9:      { 116 3 ---  262 3 x--  213 3 ---  22B 3 --- }
94BA:      { 17B 3 ---  26E 3 ---  26B 3 ---  26F 3 --- }
94BB:      { 15D 3 ---  266 3 -y-  212 3 ---  105 3 xy- }
94BC:      { 149 3 ---  13C 3 ---  24B 3 ---  105 3 xy- }
94BD:      { 26C 5 ---  12E 3 -y-  26D 3 ---  12E 3 -y- }
94BE:      { 179 3 -y-  113 3 xy-  146 3 ---  113 3 -y- }
94BF:      { 146 3 ---  26B 3 ---  113 3 x--  15D 3 --- }
94C0:      { 270 3 ---  275 3 ---  271 3 ---  266 3 --- }
94C1:      { 104 3 ---  151 3 ---  105 3 -y-  105 3 x-- }
94C2:      { 129 3 x--  13F 3 x--  128 3 x--  13E 3 x-- }
94C3:      { 13E 3 -y-  128 3 -y-  245 3 ---  24E 3 --- }
94C4:      { 109 3 ---  262 3 x--  108 3 ---  22B 3 --- }
94C5:      { 109 3 ---  10A 3 x--  209 3 ---  105 3 xy- }
94C6:      { 272 3 ---  20D 3 ---  142 3 ---  143 3 --- }
94C7:      { 272 3 ---  276 3 ---  273 3 ---  12F 3 --- }
94C8:      { 273 3 ---  12E 3 ---  11C 3 ---  12F 3 --- }
94C9:      { 11A 3 ---  130 3 ---  22B 3 xy-  26F 3 -y- }
94CA:      { 116 3 ---  11C 3 ---  16C 3 x--  262 3 x-- }
94CB:      { 105 3 x--  209 3 ---  270 3 ---  105 3 x-- }
94CC:      { 14D 3 ---  212 3 ---  12D 3 -y-  271 3 --- }
94CD:      { 270 3 ---  274 3 ---  12D 3 xy-  105 3 -y- }
94CE:      { 105 3 x--  209 3 ---  142 3 xy-  151 3 --- }
94CF:      { 105 3 -y-  277 3 ---  274 3 ---  278 3 --- }
94D0:      { 142 3 x--  266 3 ---  105 3 ---  262 3 x-- }
94D1:      { 116 3 ---  116 3 ---  148 3 x--  108 3 --- }
94D2:      { 14F 3 x--  12B 3 x--  14E 3 ---  169 3 --- }
94D3:      { 101 3 xy-  117 3 ---  279 3 ---  17B 3 --- }
94D4:      { 11A 3 ---  17B 3 xy-  10A 3 x--  26E 3 --- }
94D5:      { 12C 3 ---  20D 3 ---  270 3 ---  143 3 --- }
94D6:      { 272 3 ---  276 3 ---  142 3 ---  12F 3 --- }
94D7:      { 144 3 ---  146 3 x--  145 3 ---  125 5 --- }
94D8:      { 125 5 ---  125 5 ---  125 5 ---  111 3 --- }
94D9:      { 20A 3 ---  204 3 ---  12A 3 ---  20B 3 --- }
94DA:      { 277 3 ---  27B 3 ---  105 3 -y-  12E 3 --- }
94DB:      { 273 3 ---  27C 3 ---  273 3 ---  27D 3 --- }
94DC:      { 275 3 ---  26F 3 ---  266 3 ---  27C 3 --- }
94DD:      { 27A 3 ---  27D 3 ---  27A 3 ---  278 3 --- }
94DE:      { 273 3 ---  27C 3 x--  278 3 ---  12E 3 --- }
94DF:      { 27B 3 ---  113 3 x--  205 3 ---  113 3 --- }
94E0:      { 105 3 ---  114 3 ---  11E 3 xy-  25A 3 --- }
94E1:      { 12B 3 ---  177 3 ---  13D 3 ---  178 3 --- }
94E2:      { 177 3 ---  172 3 ---  20E 3 ---  15F 3 --- }
94E3:      { 20F 3 ---  214 3 ---  105 3 ---  168 3 --- }
94E4:      { 11E 3 xy-  10A 3 xy-  105 3 x--  116 3 -y- }
94E5:      { 142 3 ---  12D 3 -y-  142 3 ---  152 3 --- }
94E6:      { 144 3 ---  153 3 ---  125 5 ---  111 3 x-- }
94E7:      { 111 3 x--  123 3 x--  163 3 ---  170 5 --- }
94E8:      { 111 3 ---  123 3 ---  123 3 ---  13B 5 --- }
94E9:      { 249 3 ---  111 3 ---  27E 3 ---  249 3 --- }
94EA:      { 118 3 ---  20B 3 ---  12E 3 -y-  12A 3 --- }
94EB:      { 105 3 ---  12B 3 ---  105 3 ---  16C 3 x-- }
94EC:      { 116 3 ---  263 3 x--  105 3 x--  100 3 x-- }
94ED:      { 12D 3 xy-  16C 3 x--  105 3 x--  140 3 --- }
94EE:      { 113 3 xy-  266 3 xy-  26D 3 -y-  146 3 xy- }
94EF:      { 20C 3 ---  222 3 -y-  113 3 -y-  113 3 --- }
94F0:      { 266 3 -y-  140 3 xy-  109 3 x--  105 3 x-- }
94F1:      { 201 3 ---  105 3 xy-  202 3 ---  261 3 --- }
94F2:      { 267 3 ---  116 3 ---  10A 3 x--  105 3 -y- }
94F3:      { 262 3 x--  11E 3 xy-  11E 3 ---  267 3 --- }
94F4:      { 150 3 x--  12B 3 ---  148 3 x--  25A 3 x-- }
94F5:      { 116 3 ---  108 3 ---  160 3 ---  16D 5 --- }
94F6:      { 161 5 ---  16E 5 ---  123 3 x--  13B 5 x-- }
94F7:      { 13B 5 x--  10D 5 ---  175 5 ---  10E 5 x-- }
94F8:      { 13B 5 ---  10D 5 x--  10D 5 x--  208 5 --- }
94F9:      { 123 3 ---  13B 5 ---  145 3 ---  14C 5 --- }
94FA:      { 27E 3 ---  249 3 ---  105 3 -y-  204 3 x-- }
94FB:      { 131 3 ---  114 3 ---  132 3 x--  126 3 --- }
94FC:      { 155 3 ---  115 3 xy-  119 3 x--  155 3 --- }
94FD:      { 11D 3 -y-  258 3 x--  266 3 x--  151 3 --- }
94FE:      { 113 3 x--  26B 3 ---  203 3 -y-  15D 3 --- }
94FF:      { 203 3 x--  113 3 -y-  113 3 -y-  105 3 --- }
