8800:      { 100 2 ---  101 2 ---  100 2 ---  101 2 --- }
8801:      { 102 2 ---  103 2 ---  102 2 ---  103 2 --- }
8802:      { 104 2 ---  105 2 ---  104 2 ---  105 2 --- }
8803:      { 106 2 ---  107 2 ---  106 2 ---  107 2 --- }
8804:      { 108 2 ---  109 2 ---  108 2 ---  109 2 --- }
8805:      { 10A 2 ---  112 2 ---  10B 2 ---  113 2 --- }
8806:      { 10C 2 ---  114 2 ---  10D 2 ---  115 2 --- }
8807:      { 10E 2 ---  116 2 ---  10F 2 ---  117 2 --- }
8808:      { 110 2 ---  118 2 ---  111 2 ---  119 2 --- }
8809:      { 11A 2 ---  122 2 ---  11B 2 ---  123 2 --- }
880A:      { 11C 2 ---  124 2 ---  11D 2 ---  125 2 --- }
880B:      { 11E 2 ---  126 2 ---  11F 2 ---  127 2 --- }
880C:      { 120 2 ---  128 2 ---  121 2 ---  129 2 --- }
880D:      { 11A 2 ---  12A 2 ---  11B 2 ---  12B 2 --- }
880E:      { 11C 2 ---  12C 2 ---  11D 2 ---  12D 2 --- }
880F:      { 11E 2 ---  12E 2 ---  11F 2 ---  12F 2 --- }
8810:      { 120 2 ---  130 2 ---  121 2 ---  131 2 --- }
8811:      { 132 2 ---  142 2 ---  133 2 ---  142 2 --- }
8812:      { 134 2 ---  143 2 ---  135 2 ---  144 2 --- }
8813:      { 136 2 ---  145 2 ---  137 2 ---  146 2 x-- }
8814:      { 138 2 ---  147 2 ---  139 2 ---  148 2 --- }
8815:      { 13A 2 ---  149 2 ---  13B 2 ---  14A 2 --- }
8816:      { 13C 2 ---  144 2 ---  13D 2 ---  145 2 --- }
8817:      { 13E 2 ---  146 2 x--  13F 2 ---  14B 2 --- }
8818:      { 140 2 ---  146 2 ---  141 2 ---  14C 2 --- }
8819:      { 132 2 ---  14D 2 ---  133 2 ---  142 2 --- }
881A:      { 134 2 ---  14A 2 ---  135 2 ---  144 2 --- }
881B:      { 138 2 ---  147 2 ---  139 2 ---  14E 2 --- }
881C:      { 13A 2 ---  14D 2 ---  13B 2 ---  142 2 --- }
881D:      { 13C 2 ---  142 2 ---  13D 2 ---  142 2 --- }
881E:      { 13E 2 ---  142 2 ---  13F 2 ---  142 2 --- }
881F:      { 140 2 ---  142 2 ---  141 2 ---  142 2 --- }
8820:      { 14F 2 ---  15F 2 ---  150 2 ---  152 2 --- }
8821:      { 151 2 ---  160 2 ---  152 2 ---  161 2 --- }
8822:      { 152 2 ---  162 2 ---  152 2 ---  163 2 --- }
8823:      { 152 2 ---  164 2 ---  152 2 ---  165 2 --- }
8824:      { 153 2 ---  152 2 ---  154 2 ---  166 2 --- }
8825:      { 155 2 ---  152 2 ---  156 2 ---  157 2 xy- }
8826:      { 157 2 ---  167 2 ---  152 2 ---  168 2 --- }
8827:      { 158 2 ---  169 2 ---  157 2 x--  16A 2 --- }
8828:      { 159 2 ---  16B 2 ---  15A 2 ---  16C 2 --- }
8829:      { 15B 2 ---  16D 2 ---  152 2 ---  16E 2 --- }
882A:      { 152 2 ---  16F 2 ---  152 2 ---  170 2 --- }
882B:      { 152 2 ---  171 2 ---  152 2 ---  172 2 --- }
882C:      { 159 2 ---  173 2 ---  15A 2 ---  174 2 --- }
882D:      { 15A 2 ---  175 2 ---  15A 2 ---  176 2 x-- }
882E:      { 15A 2 ---  177 2 ---  15C 2 ---  178 2 --- }
882F:      { 15D 2 ---  179 2 ---  15E 2 ---  17A 2 --- }
8830:      { 17B 2 ---  20A 2 ---  17C 2 ---  20B 2 --- }
8831:      { 17D 2 ---  20C 2 ---  17E 2 ---  20D 2 --- }
8832:      { 155 2 ---  152 2 ---  152 2 ---  17D 2 --- }
8833:      { 152 2 ---  20E 2 ---  152 2 ---  20F 2 --- }
8834:      { 152 2 ---  210 2 ---  152 2 ---  211 2 --- }
8835:      { 152 2 ---  212 2 ---  152 2 ---  17D 2 --- }
8836:      { 17F 2 ---  20A 2 ---  200 2 ---  213 2 --- }
8837:      { 201 2 ---  214 2 ---  16C 2 ---  175 2 --- }
8838:      { 16C 2 ---  215 2 ---  16C 2 ---  216 2 --- }
8839:      { 202 2 ---  217 2 ---  174 2 ---  211 2 --- }
883A:      { 203 2 ---  17C 2 ---  204 2 ---  17D 2 --- }
883B:      { 205 2 ---  20E 2 ---  206 2 ---  20F 2 --- }
883C:      { 207 2 ---  210 2 ---  152 2 ---  211 2 --- }
883D:      { 152 2 ---  211 2 ---  152 2 ---  20F 2 --- }
883E:      { 208 2 ---  20A 2 ---  17C 2 ---  20B 2 --- }
883F:      { 17D 2 ---  20C 2 ---  209 2 ---  20D 2 --- }
8840:      { 218 2 ---  21C 2 ---  219 2 ---  21C 2 --- }
8841:      { 157 2 -y-  21C 2 ---  152 2 ---  21C 2 --- }
8842:      { 152 2 ---  21C 2 ---  21A 2 ---  21C 2 --- }
8843:      { 21B 2 ---  21C 2 ---  20B 2 ---  21C 2 --- }
8844:      { 21C 2 ---  21C 2 ---  21C 2 ---  21C 2 --- }
8845:      { 21D 2 ---  21C 2 ---  21E 2 ---  21C 2 --- }
8846:      { 152 2 ---  21C 2 ---  21F 2 ---  21C 2 --- }
8847:      { 20A 2 ---  21C 2 ---  15F 2 ---  21C 2 --- }
8848:      { 20C 2 ---  21C 2 ---  20D 2 ---  21C 2 --- }
8849:      { 100 2 ---  100 2 ---  100 2 ---  100 2 --- }
884A:      { 004 2 ---  004 2 ---  004 2 ---  004 2 --- }
884B:      { 004 2 ---  004 2 ---  004 2 ---  004 2 --- }
884C:      { 004 2 ---  004 2 ---  004 2 ---  004 2 --- }
884D:      { 004 2 ---  004 2 ---  004 2 ---  004 2 --- }
884E:      { 004 2 ---  004 2 ---  004 2 ---  004 2 --- }
884F:      { 004 2 ---  004 2 ---  004 2 ---  004 2 --- }
8850:      { 100 3 ---  100 3 ---  100 3 ---  100 3 --- }
8851:      { 100 3 -y-  100 3 -y-  101 3 -y-  102 3 -y- }
8852:      { 100 3 ---  105 3 ---  103 3 ---  106 3 --- }
8853:      { 100 3 -y-  107 3 -y-  104 3 -y-  108 3 -y- }
8854:      { 109 3 -y-  10D 3 -y-  10A 3 -y-  10E 3 -y- }
8855:      { 10B 3 -y-  10F 3 -y-  10C 3 -y-  110 3 -y- }
8856:      { 111 3 -y-  118 3 -y-  112 3 -y-  119 3 -y- }
8857:      { 113 3 -y-  11A 3 -y-  114 3 -y-  11B 3 -y- }
8858:      { 115 3 -y-  11C 3 -y-  116 3 -y-  116 3 -y- }
8859:      { 116 3 -y-  116 3 -y-  117 3 -y-  11D 3 -y- }
885A:      { 11E 3 -y-  116 3 -y-  11F 3 -y-  122 3 -y- }
885B:      { 120 3 -y-  123 3 -y-  116 3 -y-  116 3 -y- }
885C:      { 116 3 ---  116 3 ---  116 3 ---  116 3 --- }
885D:      { 116 3 -y-  116 3 -y-  121 3 -y-  124 3 -y- }
885E:      { 125 3 -y-  127 3 -y-  100 3 -y-  128 3 -y- }
885F:      { 126 3 -y-  129 3 -y-  116 3 -y-  116 3 -y- }
8860:      { 12A 3 xy-  12B 3 xy-  116 3 xy-  116 3 xy- }
8861:      { 116 3 ---  116 3 ---  124 3 ---  121 3 --- }
8862:      { 11C 3 ---  115 3 ---  116 3 ---  116 3 --- }
8863:      { 116 3 ---  11E 3 ---  122 3 ---  11F 3 --- }
8864:      { 129 3 ---  126 3 ---  116 3 ---  116 3 --- }
8865:      { 12B 3 x--  12A 3 x--  116 3 x--  116 3 x-- }
8866:      { 116 3 ---  116 3 ---  11D 3 ---  117 3 --- }
8867:      { 10D 3 ---  109 3 ---  10E 3 ---  10A 3 --- }
8868:      { 118 3 ---  111 3 ---  119 3 ---  112 3 --- }
8869:      { 123 3 ---  120 3 ---  116 3 ---  116 3 --- }
886A:      { 127 3 ---  125 3 ---  128 3 ---  100 3 --- }
886B:      { 10F 3 ---  10B 3 ---  110 3 ---  10C 3 --- }
886C:      { 107 3 ---  100 3 ---  108 3 ---  104 3 --- }
886D:      { 11A 3 ---  113 3 ---  11B 3 ---  114 3 --- }
886E:      { 100 3 ---  100 3 ---  102 3 ---  101 3 --- }
886F:      { 105 3 -y-  100 3 -y-  106 3 -y-  103 3 -y- }
8870:      { 100 5 x--  100 5 x--  100 5 x--  12E 5 x-- }
8871:      { 12C 5 ---  12F 5 ---  12D 5 ---  130 5 --- }
8872:      { 100 5 -y-  131 5 -y-  100 5 -y-  132 5 -y- }
8873:      { 100 5 ---  133 5 ---  100 5 ---  134 5 --- }
8874:      { 100 5 -y-  135 5 -y-  100 5 -y-  136 5 -y- }
8875:      { 100 5 ---  100 5 ---  100 5 ---  100 5 --- }
8876:      { 137 5 x--  141 5 x--  138 5 x--  142 5 x-- }
8877:      { 139 5 ---  143 5 ---  13A 5 ---  144 5 --- }
8878:      { 13B 5 ---  145 5 ---  13C 5 ---  146 5 --- }
8879:      { 100 5 xy-  147 5 xy-  100 5 xy-  148 5 xy- }
887A:      { 100 5 ---  149 5 ---  100 5 ---  14A 5 --- }
887B:      { 13D 5 ---  14B 5 ---  13E 5 ---  14C 5 --- }
887C:      { 13F 5 ---  14D 5 ---  140 5 ---  14E 5 --- }
887D:      { 14F 5 ---  15C 5 ---  150 5 ---  15D 5 --- }
887E:      { 151 5 ---  15E 5 ---  152 5 ---  15F 5 --- }
887F:      { 153 5 xy-  160 5 xy-  154 5 xy-  161 5 xy- }
8880:      { 155 5 ---  162 5 ---  100 5 ---  163 5 --- }
8881:      { 156 5 ---  164 5 ---  157 5 ---  165 5 --- }
8882:      { 158 5 ---  166 5 ---  159 5 ---  167 5 --- }
8883:      { 15A 5 ---  168 5 ---  15B 5 ---  169 5 --- }
8884:      { 16A 3 ---  176 3 ---  16B 3 ---  177 3 --- }
8885:      { 16C 3 ---  178 3 ---  16D 3 ---  179 3 --- }
8886:      { 16E 5 ---  17A 5 ---  16F 5 ---  17B 5 --- }
8887:      { 170 5 ---  17C 5 ---  171 5 ---  17D 5 --- }
8888:      { 172 5 ---  17E 5 ---  173 5 ---  17F 5 --- }
8889:      { 174 5 ---  200 5 ---  175 5 ---  100 5 --- }
888A:      { 201 3 ---  20F 3 ---  202 3 ---  210 3 --- }
888B:      { 203 3 ---  211 3 ---  204 3 ---  212 3 --- }
888C:      { 205 3 ---  213 3 ---  206 3 ---  214 3 --- }
888D:      { 207 5 ---  215 5 ---  208 5 ---  216 5 --- }
888E:      { 209 5 ---  217 5 ---  20A 5 ---  218 5 --- }
888F:      { 20B 5 ---  219 5 ---  20C 5 ---  21A 5 --- }
8890:      { 20D 3 ---  21B 3 ---  20E 3 ---  21C 3 --- }
8891:      { 21D 3 ---  22A 3 ---  21E 3 ---  22B 3 --- }
8892:      { 21F 3 ---  22C 3 ---  220 3 ---  22D 3 --- }
8893:      { 221 3 ---  100 3 ---  222 3 ---  22E 3 --- }
8894:      { 223 3 ---  22F 3 ---  224 3 ---  230 3 --- }
8895:      { 225 3 ---  231 3 ---  226 3 ---  232 3 --- }
8896:      { 227 3 ---  233 3 ---  100 3 ---  234 3 --- }
8897:      { 228 3 ---  235 3 ---  229 3 ---  236 3 --- }
8898:      { 237 3 ---  241 3 ---  238 3 ---  242 3 --- }
8899:      { 239 3 ---  243 3 ---  23A 3 ---  244 3 --- }
889A:      { 23B 3 -y-  245 3 -y-  23C 3 -y-  246 3 -y- }
889B:      { 23D 3 ---  247 3 ---  23E 3 ---  248 3 --- }
889C:      { 23F 3 ---  249 3 ---  240 3 ---  24A 3 --- }
889D:      { 24B 3 -y-  251 3 -y-  24C 3 -y-  252 3 -y- }
889E:      { 24D 3 ---  253 3 ---  24E 3 ---  254 3 --- }
889F:      { 24F 3 ---  255 3 ---  250 3 ---  256 3 --- }
88A0:      { 257 3 -y-  100 3 -y-  258 3 -y-  25B 3 -y- }
88A1:      { 259 3 ---  25C 3 ---  25A 3 ---  25D 3 --- }
88A2:      { 25E 3 ---  260 3 ---  25F 3 ---  261 3 --- }
88A3:      { 262 3 ---  264 3 ---  263 3 ---  265 3 --- }
88A4:      { 2E8 0 ---  2E9 0 ---  2E9 0 ---  2F8 0 --- }
88A5:      { 2F8 0 ---  2F9 0 ---  2E9 0 ---  2E8 0 --- }
88A6:      { 2F8 0 ---  2E9 0 ---  2F9 0 ---  2F8 0 --- }
88A7:      { 2E6 0 ---  2F6 0 ---  2E7 0 ---  2F7 0 --- }
88A8: ~
88A9: ~
88AA: ~
88AB: ~
88AC: ~
88AD: ~
88AE: ~
88AF: ~
88B0:      { 0F8 0 ---  100 0 ---  0F8 0 ---  101 0 --- }
88B1:      { 0F8 0 ---  102 0 ---  0F8 0 ---  0F8 0 --- }
88B2:      { 0F8 0 ---  0F8 0 ---  0F8 0 ---  100 0 --- }
88B3:      { 103 0 ---  105 0 ---  104 0 ---  106 0 --- }
88B4:      { 0F8 0 ---  101 0 ---  0F8 0 ---  102 0 --- }
88B5:      { 0F8 0 ---  0F8 0 ---  0F8 0 ---  102 0 x-- }
88B6:      { 0F8 0 ---  101 0 x--  0F8 0 ---  101 0 --- }
88B7:      { 0F8 0 ---  107 0 ---  0F8 0 ---  108 0 --- }
88B8:      { 0F8 0 ---  109 0 ---  0F8 0 ---  10A 0 --- }
88B9:      { 0F8 0 ---  10B 0 ---  0F8 0 ---  0F8 0 --- }
88BA:      { 0F8 0 ---  10C 0 ---  107 0 ---  10D 0 --- }
88BB:      { 108 0 ---  10E 0 ---  109 0 ---  10E 0 --- }
88BC:      { 10A 0 ---  10E 0 ---  10B 0 ---  10E 0 --- }
88BD:      { 0F8 0 ---  111 0 ---  10C 0 ---  10E 0 --- }
88BE:      { 109 0 ---  10E 0 ---  10A 0 ---  10E 0 --- }
88BF:      { 10B 0 ---  10E 0 ---  0F8 0 ---  109 0 x-- }
88C0:      { 0F8 0 ---  109 0 x--  0F8 0 ---  108 0 x-- }
88C1:      { 0F8 0 ---  107 0 x--  0F8 0 ---  0F8 0 --- }
88C2:      { 0F8 0 ---  112 0 ---  0F8 0 ---  113 0 --- }
88C3:      { 0F8 0 ---  114 0 ---  10F 0 ---  115 0 --- }
88C4:      { 110 0 ---  10E 0 ---  10E 0 ---  10E 0 --- }
88C5:      { 10E 0 ---  10E 0 ---  10E 0 ---  10E 0 --- }
88C6:      { 10E 0 ---  116 0 ---  111 0 ---  10E 0 --- }
88C7:      { 10E 0 ---  117 0 ---  10E 0 ---  10E 0 --- }
88C8:      { 10E 0 ---  10E 0 ---  116 0 ---  10E 0 --- }
88C9:      { 110 0 x--  10E 0 ---  10F 0 x--  10E 0 --- }
88CA:      { 118 0 ---  11F 0 ---  119 0 ---  120 0 --- }
88CB:      { 10E 0 ---  121 0 ---  11A 0 ---  10E 0 --- }
88CC:      { 11B 0 ---  10E 0 ---  10E 0 ---  116 0 --- }
88CD:      { 11C 0 ---  10E 0 ---  11D 0 ---  10E 0 --- }
88CE:      { 11E 0 ---  10E 0 ---  10E 0 ---  10E 0 --- }
88CF:      { 10E 0 ---  10E 0 ---  117 0 ---  11C 0 --- }
88D0:      { 10E 0 ---  11D 0 ---  10E 0 ---  11E 0 --- }
88D1:      { 110 0 x--  10E 0 ---  10F 0 x--  115 0 x-- }
88D2:      { 0F8 0 ---  114 0 x--  0F8 0 ---  113 0 x-- }
88D3:      { 0F8 0 ---  112 0 x--  0F8 0 ---  0F8 0 --- }
88D4:      { 2EC 0 ---  2FC 0 ---  2ED 0 ---  2FD 0 --- }
88D5:      { 2EE 0 ---  2EF 0 ---  2E9 0 ---  2E8 0 --- }
88D6:      { 2F8 0 ---  2F9 0 ---  2EC 0 ---  2FC 0 --- }
88D7:      { 2ED 0 ---  2FD 0 ---  2EE 0 ---  2EF 0 --- }
88D8: ~
88D9: ~
88DA: ~
88DB: ~
88DC: ~
88DD: ~
88DE: ~
88DF: ~
88E0: ~
88E1: ~
88E2: ~
88E3: ~
88E4:      { 2FE 0 ---  2E9 0 ---  2FF 0 ---  2F8 0 --- }
88E5:      { 2FB 0 ---  2F9 0 ---  2E9 0 ---  2E8 0 --- }
88E6:      { 2F8 0 ---  2F9 0 ---  2FE 0 ---  2E8 0 --- }
88E7:      { 2FF 0 ---  2E9 0 ---  2FB 0 ---  2F8 0 --- }
88E8: ~
88E9: ~
88EA: ~
88EB: ~
88EC: ~
88ED: ~
88EE: ~
88EF: ~
88F0: ~
88F1: ~
88F2: ~
88F3: ~
88F4: ~
88F5: ~
88F6: ~
88F7: ~
88F8: ~
88F9: ~
88FA: ~
88FB: ~
88FC: ~
88FD: ~
88FE: ~
88FF: ~
