8700:      { 278 3 ---  284 3 ---  244 3 x--  21C 3 x-- }
8701:      { 291 3 ---  299 3 ---  258 3 ---  264 3 --- }
8702:      { 293 3 ---  295 3 ---  285 3 ---  29A 3 --- }
8703:      { 297 3 ---  29B 3 ---  298 3 ---  29C 3 --- }
8704:      { 14A 3 x--  154 3 ---  28A 3 ---  25B 3 --- }
8705:      { 28B 3 ---  25C 3 ---  28C 3 ---  25D 3 --- }
8706:      { 28D 3 ---  25E 3 ---  25A 3 ---  22A 3 --- }
8707:      { 28E 3 ---  25F 3 ---  28F 3 ---  260 3 --- }
8708:      { 222 3 x--  229 3 x--  26D 3 ---  26D 3 --- }
8709:      { 258 3 ---  258 3 ---  259 3 ---  294 3 --- }
870A:      { 259 3 x--  294 3 x--  258 3 x--  258 3 x-- }
870B:      { 28A 3 ---  25B 3 ---  28B 3 ---  25C 3 --- }
870C:      { 28C 3 ---  25D 3 ---  28D 3 ---  25E 3 --- }
870D:      { 25A 3 ---  2A6 3 ---  28E 3 ---  2A7 3 --- }
870E:      { 28F 3 ---  2A8 3 ---  222 3 x--  224 3 --- }
870F:      { 204 3 x--  225 3 ---  204 3 ---  226 3 --- }
8710:      { 29D 3 ---  227 3 ---  29E 3 ---  228 3 --- }
8711:      { 29F 3 ---  209 3 ---  290 3 ---  286 3 --- }
8712:      { 296 3 ---  295 3 ---  2A0 3 ---  2A9 3 --- }
8713:      { 2A1 3 ---  234 3 ---  2A2 3 ---  22B 3 --- }
8714:      { 224 3 ---  22C 3 ---  225 3 ---  2AA 3 --- }
8715:      { 268 3 ---  100 3 ---  269 3 ---  271 3 --- }
8716:      { 2A3 3 ---  271 3 ---  2A4 3 ---  272 3 --- }
8717:      { 2A5 3 ---  261 3 ---  284 3 ---  262 3 --- }
8718:      { 21C 3 x--  263 3 ---  279 3 ---  285 3 --- }
8719:      { 258 3 ---  24D 3 ---  259 3 ---  24E 3 --- }
871A:      { 259 3 x--  24E 3 x--  258 3 x--  24D 3 x-- }
871B:      { 2A3 3 ---  239 3 ---  22B 3 ---  23A 3 --- }
871C:      { 22C 3 ---  23B 3 ---  0F8 3 ---  241 3 --- }
871D:      { 22B 3 ---  22B 3 ---  22C 3 ---  22C 3 --- }
871E:      { 22D 3 ---  23C 3 ---  22E 3 ---  23D 3 --- }
871F:      { 22F 3 ---  22F 3 ---  230 3 ---  230 3 --- }
8720:      { 231 3 ---  231 3 ---  292 3 ---  292 3 --- }
8721:      { 263 3 x--  26F 3 x--  262 3 x--  26E 3 x-- }
8722:      { 261 3 x--  26D 3 x--  272 3 x--  27E 3 x-- }
8723:      { 271 3 x--  27D 3 x--  271 3 ---  27D 3 --- }
8724:      { 272 3 ---  27E 3 ---  27D 3 ---  288 3 --- }
8725:      { 27D 3 ---  288 3 ---  27E 3 ---  289 3 --- }
8726:      { 26D 3 ---  279 3 ---  26E 3 ---  27A 3 --- }
8727:      { 26F 3 ---  27B 3 ---  26D 3 ---  26D 3 --- }
8728:      { 258 3 ---  258 3 ---  259 3 ---  259 3 --- }
8729:      { 259 3 x--  259 3 x--  258 3 x--  258 3 x-- }
872A:      { 246 3 ---  250 3 ---  247 3 ---  251 3 --- }
872B:      { 248 3 ---  252 3 ---  249 3 ---  251 3 --- }
872C:      { 23C 3 ---  249 3 ---  23C 3 ---  21D 3 --- }
872D:      { 240 3 ---  24C 3 ---  292 3 ---  292 3 --- }
872E:      { 27B 3 x--  27B 3 x--  27A 3 x--  286 3 x-- }
872F:      { 279 3 x--  285 3 x--  289 3 x--  293 3 x-- }
8730:      { 288 3 x--  292 3 x--  288 3 ---  292 3 --- }
8731:      { 289 3 ---  293 3 ---  292 3 ---  286 3 --- }
8732:      { 292 3 ---  286 3 ---  293 3 ---  295 3 --- }
8733:      { 285 3 ---  26D 3 ---  286 3 ---  290 3 --- }
8734:      { 27B 3 ---  27B 3 ---  29D 3 ---  29E 3 --- }
8735:      { 28A 3 ---  273 3 ---  29A 3 x--  29A 3 x-- }
8736:      { 25E 3 xy-  28D 3 xy-  25D 3 xy-  28C 3 xy- }
8737:      { 25C 3 xy-  28B 3 xy-  25B 3 xy-  28A 3 xy- }
8738:      { 256 3 ---  229 3 x--  258 3 x--  264 3 x-- }
8739:      { 27B 3 x--  27B 3 x--  26E 3 x--  27A 3 x-- }
873A:      { 26D 3 x--  279 3 x--  27E 3 x--  289 3 x-- }
873B:      { 27D 3 x--  288 3 x--  27D 3 ---  288 3 --- }
873C:      { 27E 3 ---  289 3 ---  288 3 ---  292 3 --- }
873D:      { 288 3 ---  292 3 ---  289 3 ---  293 3 --- }
873E:      { 279 3 ---  285 3 ---  27A 3 ---  286 3 --- }
873F:      { 27B 3 ---  27B 3 ---  29D 3 ---  0F8 3 --- }
8740:      { 258 3 ---  264 3 ---  259 3 ---  294 3 --- }
8741:      { 259 3 x--  294 3 x--  258 3 x--  264 3 x-- }
8742:      { 273 3 ---  262 3 ---  2A0 3 x--  263 3 --- }
8743:      { 282 3 xy-  276 3 xy-  281 3 xy-  275 3 xy- }
8744:      { 280 3 xy-  274 3 xy-  27F 3 xy-  273 3 xy- }
8745:      { 237 3 x--  244 3 x--  13C 3 x--  144 3 x-- }
8746:      { 27B 3 x--  27B 3 x--  286 3 x--  26E 3 x-- }
8747:      { 285 3 x--  26D 3 x--  293 3 x--  27E 3 x-- }
8748:      { 292 3 x--  27D 3 x--  292 3 ---  27D 3 --- }
8749:      { 293 3 ---  27E 3 ---  286 3 ---  288 3 --- }
874A:      { 286 3 ---  288 3 ---  295 3 ---  289 3 --- }
874B:      { 26D 3 ---  279 3 ---  290 3 ---  27A 3 --- }
874C:      { 27B 3 ---  27B 3 ---  0F8 3 ---  270 3 --- }
874D:      { 29E 3 ---  234 3 ---  29F 3 ---  235 3 --- }
874E:      { 29F 3 x--  271 3 ---  29E 3 x--  272 3 --- }
874F:      { 26A 3 xy-  25E 3 xy-  269 3 xy-  25D 3 xy- }
8750:      { 268 3 xy-  25C 3 xy-  267 3 xy-  25B 3 xy- }
8751:      { 21C 3 x--  222 3 x--  14E 3 x--  166 3 --- }
8752:      { 27B 3 ---  27B 3 ---  27C 3 ---  287 3 --- }
8753:      { 28D 3 xy-  282 3 xy-  28C 3 xy-  281 3 xy- }
8754:      { 28B 3 xy-  280 3 xy-  28A 3 xy-  27F 3 xy- }
8755:      { 229 3 x--  237 3 x--  170 3 ---  178 3 x-- }
8756:      { 27B 3 ---  27B 3 ---  291 3 ---  291 3 --- }
8757:      { 276 3 xy-  26A 3 xy-  275 3 xy-  269 3 xy- }
8758:      { 274 3 xy-  268 3 xy-  273 3 xy-  267 3 xy- }
8759:      { 244 3 x--  21C 3 x--  17E 3 x--  204 3 x-- }
875A:      { 27B 3 ---  27B 3 ---  291 3 ---  287 3 --- }
875B:      { 290 3 ---  288 3 ---  296 3 ---  289 3 --- }
875C:      { 28E 3 ---  24A 3 ---  28F 3 ---  24B 3 --- }
875D:      { 222 3 x--  24C 3 ---  168 3 x--  204 3 x-- }
875E:      { 27B 3 ---  27B 3 ---  291 3 ---  299 3 --- }
875F:      { 256 3 ---  229 3 x--  168 3 x--  14A 3 x-- }
8760:      { 27B 3 ---  27B 3 ---  29D 3 ---  227 3 --- }
8761:      { 29E 3 ---  228 3 ---  29F 3 ---  209 3 --- }
8762:      { 290 3 ---  286 3 ---  296 3 ---  295 3 --- }
8763: ~
8764: ~
8765: ~
8766: ~
8767: ~
8768: ~
8769: ~
876A: ~
876B: ~
876C: ~
876D: ~
876E: ~
876F: ~
8770: ~
8771: ~
8772: ~
8773: ~
8774: ~
8775: ~
8776: ~
8777: ~
8778: ~
8779: ~
877A: ~
877B: ~
877C: ~
877D: ~
877E: ~
877F: ~
8780: ~
8781: ~
8782: ~
8783: ~
8784: ~
8785: ~
8786: ~
8787: ~
8788: ~
8789: ~
878A: ~
878B: ~
878C: ~
878D: ~
878E: ~
878F: ~
8790: ~
8791: ~
8792: ~
8793: ~
8794: ~
8795: ~
8796: ~
8797: ~
8798: ~
8799: ~
879A: ~
879B: ~
879C: ~
879D: ~
879E: ~
879F: ~
87A0:      { 04F 0 ---  04F 0 ---  04F 0 ---  0F8 0 --- }
87A1:      { 0F8 0 ---  04F 0 ---  0F8 0 ---  0F8 0 --- }
87A2:      { 0F8 0 ---  04F 0 ---  04F 0 ---  0F8 0 --- }
87A3:      { 0F8 0 ---  04F 0 ---  0F8 0 ---  0F8 0 --- }
87A4:      { 04F 0 ---  04F 0 ---  0F8 0 ---  04F 0 --- }
87A5:      { 0F8 0 ---  0F8 0 ---  04F 0 ---  04F 0 --- }
87A6:      { 0F8 0 ---  0F8 0 ---  04F 0 ---  04F 0 --- }
87A7:      { 0F8 0 ---  0F8 0 ---  04F 0 ---  04F 0 --- }
87A8:      { 0F8 0 ---  0F8 0 ---  04F 0 ---  0F8 0 --- }
87A9:      { 04F 0 ---  04F 0 ---  04F 0 ---  0F8 0 --- }
87AA:      { 0F8 0 ---  0F8 0 ---  0F8 0 ---  04F 0 --- }
87AB:      { 04F 0 ---  0F8 0 ---  04F 0 ---  0F8 0 --- }
87AC: ~
87AD: ~
87AE: ~
87AF: ~
87B0:      { 04F 0 ---  04F 0 ---  0F8 0 ---  0F8 0 --- }
87B1:      { 04F 0 ---  04F 0 ---  0F8 0 ---  0F8 0 --- }
87B2:      { 04F 0 ---  04F 0 ---  0F8 0 ---  0F8 0 --- }
87B3:      { 04F 0 ---  04F 0 ---  0F8 0 ---  0F8 0 --- }
87B4:      { 04F 0 ---  04F 0 ---  0F8 0 ---  0F8 0 --- }
87B5:      { 04F 0 ---  0F8 0 ---  04F 0 ---  04F 0 --- }
87B6:      { 0F8 0 ---  0F8 0 ---  04F 0 ---  04F 0 --- }
87B7:      { 0F8 0 ---  0F8 0 ---  04F 0 ---  04F 0 --- }
87B8:      { 0F8 0 ---  0F8 0 ---  0F8 0 ---  0F8 0 --- }
87B9:      { 04F 0 ---  04F 0 ---  0F8 0 ---  0F8 0 --- }
87BA:      { 0F8 0 ---  0F8 0 ---  0F8 0 ---  0F8 0 --- }
87BB:      { 04F 0 ---  0F8 0 ---  0F8 0 ---  04F 0 --- }
87BC: ~
87BD: ~
87BE: ~
87BF: ~
87C0:      { 04F 0 ---  0F8 0 ---  04F 0 ---  0F8 0 --- }
87C1:      { 0F8 0 ---  0F8 0 ---  0F8 0 ---  0F8 0 --- }
87C2:      { 0F8 0 ---  0F8 0 ---  04F 0 ---  0F8 0 --- }
87C3:      { 0F8 0 ---  0F8 0 ---  0F8 0 ---  0F8 0 --- }
87C4:      { 04F 0 ---  0F8 0 ---  0F8 0 ---  0F8 0 --- }
87C5:      { 0F8 0 ---  0F8 0 ---  04F 0 ---  0F8 0 --- }
87C6:      { 0F8 0 ---  0F8 0 ---  04F 0 ---  0F8 0 --- }
87C7:      { 04F 0 ---  0F8 0 ---  04F 0 ---  0F8 0 --- }
87C8:      { 0F8 0 ---  0F8 0 ---  0F8 0 ---  0F8 0 --- }
87C9:      { 04F 0 ---  0F8 0 ---  0F8 0 ---  0F8 0 --- }
87CA:      { 0F8 0 ---  0F8 0 ---  04F 0 ---  0F8 0 --- }
87CB:      { 04F 0 ---  0F8 0 ---  0F8 0 ---  0F8 0 --- }
87CC: ~
87CD: ~
87CE: ~
87CF: ~
87D0:      { 04F 0 ---  04F 0 ---  0F8 0 ---  0F8 0 --- }
87D1:      { 04F 0 ---  04F 0 ---  0F8 0 ---  0F8 0 --- }
87D2:      { 04F 0 ---  04F 0 ---  0F8 0 ---  0F8 0 --- }
87D3:      { 04F 0 ---  04F 0 ---  0F8 0 ---  0F8 0 --- }
87D4:      { 04F 0 ---  04F 0 ---  0F8 0 ---  04F 0 --- }
87D5:      { 0F8 0 ---  0F8 0 ---  0F8 0 ---  04F 0 --- }
87D6:      { 04F 0 ---  04F 0 ---  0F8 0 ---  0F8 0 --- }
87D7: ~
87D8: ~
87D9: ~
87DA: ~
87DB: ~
87DC: ~
87DD: ~
87DE: ~
87DF: ~
87E0:      { 0F8 0 ---  0F8 0 ---  04F 0 ---  04F 0 --- }
87E1:      { 0F8 0 ---  0F8 0 ---  0F8 0 ---  0F8 0 --- }
87E2:      { 04F 0 ---  04F 0 ---  0F8 0 ---  0F8 0 --- }
87E3:      { 04F 0 ---  04F 0 ---  0F8 0 ---  0F8 0 --- }
87E4:      { 04F 0 ---  04F 0 ---  0F8 0 ---  0F8 0 --- }
87E5:      { 04F 0 ---  0F8 0 ---  0F8 0 ---  0F8 0 --- }
87E6:      { 04F 0 ---  04F 0 ---  0F8 0 ---  0F8 0 --- }
87E7: ~
87E8: ~
87E9: ~
87EA: ~
87EB: ~
87EC: ~
87ED: ~
87EE: ~
87EF: ~
87F0:      { 0F8 0 ---  0F8 0 ---  04F 0 ---  0F8 0 --- }
87F1:      { 0F8 0 ---  0F8 0 ---  0F8 0 ---  0F8 0 --- }
87F2:      { 04F 0 ---  0F8 0 ---  04F 0 ---  0F8 0 --- }
87F3:      { 04F 0 ---  0F8 0 ---  0F8 0 ---  0F8 0 --- }
87F4:      { 04F 0 ---  0F8 0 ---  0F8 0 ---  0F8 0 --- }
87F5:      { 0F8 0 ---  0F8 0 ---  0F8 0 ---  0F8 0 --- }
87F6:      { 04F 0 ---  0F8 0 ---  0F8 0 ---  0F8 0 --- }
87F7: ~
87F8: ~
87F9: ~
87FA: ~
87FB: ~
87FC: ~
87FD: ~
87FE: ~
87FF: ~
