9900:      { 0F8 0 ---  0F8 0 ---  0F8 0 ---  206 3 --- }
9901:      { 200 3 ---  207 3 ---  201 3 ---  208 3 --- }
9902:      { 202 3 ---  209 3 ---  203 3 ---  20A 3 --- }
9903:      { 204 3 ---  20B 5 ---  205 3 ---  20C 5 --- }
9904:      { 0F8 0 ---  20D 3 ---  0F8 0 ---  0F8 0 --- }
9905:      { 0F8 0 ---  0F8 0 ---  20E 3 ---  216 3 --- }
9906:      { 20F 3 ---  217 3 ---  210 3 ---  218 3 --- }
9907:      { 211 3 ---  219 5 ---  212 3 ---  21A 3 --- }
9908:      { 213 5 ---  21B 5 ---  214 5 ---  21C 5 --- }
9909:      { 215 5 ---  21D 5 ---  0F8 0 ---  0F8 0 --- }
990A:      { 0F8 0 ---  228 3 ---  21E 3 ---  229 3 --- }
990B:      { 21F 3 ---  22A 3 ---  220 5 ---  22B 5 --- }
990C:      { 221 5 ---  22C 5 ---  222 5 ---  22D 5 --- }
990D:      { 223 5 ---  22E 5 ---  224 5 ---  22F 3 --- }
990E:      { 225 5 ---  230 3 ---  226 3 ---  231 3 --- }
990F:      { 226 3 ---  232 3 ---  226 3 ---  232 3 --- }
9910:      { 227 3 ---  233 3 ---  0F8 0 ---  0F8 0 --- }
9911:      { 234 3 ---  240 3 ---  235 3 ---  226 3 -y- }
9912:      { 236 3 ---  226 3 -y-  237 3 ---  241 3 --- }
9913:      { 238 3 ---  242 3 ---  239 5 ---  243 5 --- }
9914:      { 23A 5 ---  244 5 ---  23B 5 ---  245 5 --- }
9915:      { 23C 5 ---  246 5 ---  23D 5 ---  247 3 --- }
9916:      { 23E 3 ---  0F8 0 ---  23F 3 ---  0F8 0 --- }
9917:      { 248 3 ---  249 3 ---  0F8 0 ---  0F8 0 --- }
9918:      { 0F8 0 ---  24A 3 ---  0F8 0 ---  0F8 0 --- }
9919:      { 0F8 0 ---  0F8 0 ---  24B 3 ---  24F 3 --- }
991A:      { 24C 3 ---  250 3 ---  24D 3 ---  251 3 --- }
991B:      { 24E 3 ---  252 3 ---  0F8 0 ---  253 3 --- }
991C:      { 0F8 0 ---  25A 3 ---  0F8 0 ---  25B 3 --- }
991D:      { 0F8 0 ---  0F8 0 ---  0F8 0 ---  25C 3 --- }
991E:      { 254 3 ---  25D 3 ---  255 3 ---  25E 3 --- }
991F:      { 256 3 ---  25F 3 ---  257 3 ---  260 3 --- }
9920:      { 258 3 ---  261 3 ---  259 3 ---  262 3 --- }
9921:      { 0F8 0 ---  0F8 0 ---  0F8 0 ---  24A 3 --- }
9922:      { 0F8 0 ---  0F8 0 ---  248 3 ---  249 3 --- }
9923:      { 0F8 0 ---  263 3 ---  25A 3 ---  264 3 --- }
9924:      { 25B 3 ---  265 3 ---  0F8 0 ---  0F8 0 --- }
9925:      { 0F8 0 ---  0F8 0 ---  0F8 0 ---  26C 3 --- }
9926:      { 0F8 0 ---  26D 3 ---  263 3 ---  26E 3 --- }
9927:      { 264 3 ---  26F 3 ---  265 3 ---  0F9 3 --- }
9928:      { 0F8 0 ---  270 3 ---  266 3 ---  271 3 --- }
9929:      { 267 3 ---  272 3 ---  268 3 ---  273 3 --- }
992A:      { 269 3 ---  274 3 ---  26A 3 ---  0F9 3 --- }
992B:      { 0F9 3 ---  0F9 3 ---  0F9 3 ---  0F9 3 --- }
992C:      { 26B 3 ---  0F9 3 ---  263 3 ---  26E 3 --- }
992D:      { 0F8 0 ---  270 3 ---  0F8 0 ---  275 3 --- }
992E:      { 26C 3 ---  276 3 ---  26D 3 ---  277 3 --- }
992F:      { 24D 3 ---  251 3 ---  24E 3 ---  252 3 --- }
9930:      { 0F8 0 ---  253 3 ---  0F8 0 ---  263 3 --- }
9931:      { 25A 3 ---  264 3 ---  25B 3 ---  265 3 --- }
9932:      { 0F8 0 ---  0F8 0 ---  0F8 0 ---  263 3 --- }
9933:      { 24B 3 ---  24F 3 ---  24C 3 ---  250 3 --- }
9934:      { 0F8 0 ---  253 3 ---  0F8 0 ---  26C 3 --- }
9935:      { 0F8 0 ---  26D 3 ---  0F8 0 ---  275 3 --- }
9936:      { 26E 3 ---  278 3 ---  26F 3 ---  279 3 --- }
9937:      { 0F9 3 ---  0F9 3 ---  270 3 ---  0F9 3 --- }
9938:      { 275 3 ---  27C 3 ---  276 3 ---  27D 3 --- }
9939:      { 277 3 ---  257 3 ---  278 3 ---  258 3 --- }
993A:      { 279 3 ---  0F9 3 ---  0F9 3 ---  0F9 3 --- }
993B:      { 0F9 3 ---  0F9 3 ---  27A 3 ---  0F9 3 --- }
993C:      { 27B 3 ---  0F9 3 ---  257 3 ---  260 3 --- }
993D:      { 258 3 ---  261 3 ---  0F9 3 ---  0F9 3 --- }
993E:      { 0F9 3 ---  0F9 3 ---  278 3 ---  0F9 3 --- }
993F:      { 0F9 3 ---  0F9 3 ---  27C 3 ---  27E 3 --- }
9940:      { 27D 3 ---  0F9 3 ---  257 3 ---  260 3 --- }
9941:      { 257 3 ---  260 3 ---  258 3 ---  261 3 --- }
9942:      { 259 3 ---  262 3 ---  26E 3 ---  278 3 --- }
9943:      { 26F 3 ---  279 3 ---  0F9 3 ---  0F9 3 --- }
9944:      { 270 3 ---  0F9 3 ---  26E 3 ---  278 3 --- }
9945:      { 270 3 ---  0F9 3 ---  254 3 ---  25D 3 --- }
9946:      { 255 3 ---  257 3 ---  256 3 ---  258 3 --- }
9947:      { 259 3 ---  262 3 ---  276 3 ---  27D 3 --- }
9948:      { 277 3 ---  0F9 3 ---  27C 3 ---  27E 3 --- }
9949:      { 27E 3 ---  0F9 3 ---  0F9 3 ---  0F9 3 --- }
994A:      { 260 3 ---  26A 3 ---  261 3 ---  0F9 3 --- }
994B:      { 0F9 3 ---  0F9 3 ---  26A 3 ---  0F9 3 --- }
994C:      { 26A 3 ---  0F9 3 ---  0F9 3 ---  0F9 3 --- }
994D:      { 0F9 3 ---  0F9 3 ---  257 3 ---  260 3 --- }
994E:      { 0F9 3 ---  27F 5 ---  0F9 3 ---  280 5 --- }
994F:      { 0F9 3 ---  281 5 ---  0F9 3 ---  282 5 --- }
9950:      { 0F9 3 ---  281 5 ---  26A 3 ---  282 5 --- }
9951:      { 283 5 ---  287 5 ---  284 5 ---  288 5 --- }
9952:      { 285 5 ---  289 5 ---  286 5 ---  28A 5 --- }
9953:      { 28B 5 ---  0F9 5 ---  28C 5 ---  0F9 5 --- }
9954:      { 28D 5 ---  0F9 5 ---  28E 5 ---  0F9 5 --- }
9955:      { 0F9 5 ---  0F9 5 ---  0F9 5 ---  0F9 5 --- }
9956:      { 0F8 0 ---  0F8 0 ---  0F8 0 ---  0F8 0 --- }
9957: ~
9958: ~
9959: ~
995A: ~
995B: ~
995C: ~
995D: ~
995E: ~
995F: ~
9960: ~
9961: ~
9962: ~
9963: ~
9964: ~
9965: ~
9966: ~
9967: ~
9968: ~
9969: ~
996A: ~
996B: ~
996C: ~
996D: ~
996E: ~
996F: ~
9970: ~
9971: ~
9972: ~
9973: ~
9974: ~
9975: ~
9976: ~
9977: ~
9978: ~
9979: ~
997A: ~
997B: ~
997C: ~
997D: ~
997E: ~
997F: ~
9980: ~
9981: ~
9982: ~
9983: ~
9984: ~
9985: ~
9986: ~
9987: ~
9988: ~
9989: ~
998A: ~
998B: ~
998C: ~
998D: ~
998E: ~
998F: ~
9990: ~
9991: ~
9992: ~
9993: ~
9994: ~
9995: ~
9996: ~
9997: ~
9998: ~
9999: ~
999A: ~
999B: ~
999C: ~
999D: ~
999E: ~
999F: ~
99A0: ~
99A1: ~
99A2: ~
99A3: ~
99A4: ~
99A5: ~
99A6: ~
99A7: ~
99A8: ~
99A9: ~
99AA: ~
99AB: ~
99AC: ~
99AD: ~
99AE: ~
99AF: ~
99B0: ~
99B1: ~
99B2: ~
99B3: ~
99B4: ~
99B5: ~
99B6: ~
99B7: ~
99B8: ~
99B9: ~
99BA: ~
99BB: ~
99BC: ~
99BD: ~
99BE: ~
99BF: ~
99C0: ~
99C1: ~
99C2: ~
99C3: ~
99C4: ~
99C5: ~
99C6: ~
99C7: ~
99C8: ~
99C9: ~
99CA: ~
99CB: ~
99CC: ~
99CD: ~
99CE: ~
99CF: ~
99D0: ~
99D1: ~
99D2: ~
99D3: ~
99D4: ~
99D5: ~
99D6: ~
99D7: ~
99D8: ~
99D9: ~
99DA: ~
99DB: ~
99DC: ~
99DD: ~
99DE: ~
99DF: ~
99E0: ~
99E1: ~
99E2: ~
99E3: ~
99E4: ~
99E5: ~
99E6: ~
99E7: ~
99E8: ~
99E9: ~
99EA: ~
99EB: ~
99EC: ~
99ED: ~
99EE: ~
99EF: ~
99F0: ~
99F1: ~
99F2: ~
99F3: ~
99F4: ~
99F5: ~
99F6: ~
99F7: ~
99F8: ~
99F9: ~
99FA: ~
99FB: ~
99FC: ~
99FD: ~
99FE: ~
99FF: ~
